,Cestovni,Željeznički,Riječni,Pomorski,Zračni,UKUPNO
2013-01-01,57075,1473,0,6,246,58800
2013-01-02,85978,697,0,9,1176,87860
2013-01-03,86218,689,0,148,974,88029
2013-01-04,98113,595,3,20,1114,99845
2013-01-05,126382,735,0,61,753,127931
2013-01-06,99651,779,0,103,1054,101587
2013-01-07,63692,601,0,0,1129,65422
2013-01-08,63148,550,0,44,688,64430
2013-01-09,62144,484,0,5,780,63413
2013-01-10,59332,402,0,5,692,60431
2013-01-11,72395,379,0,2,1015,73791
2013-01-12,78583,456,0,96,675,79810
2013-01-13,63194,352,0,1,1086,64633
2013-01-14,43153,380,0,0,1282,44815
2013-01-15,46485,379,0,56,719,47639
2013-01-16,47221,374,0,2,958,48555
2013-01-17,43483,316,0,0,904,44703
2013-01-18,55087,375,0,0,839,56301
2013-01-19,61785,421,0,130,758,63094
2013-01-20,54791,398,0,0,1207,56396
2013-01-21,51177,410,0,0,1358,52945
2013-01-22,47791,438,0,400,1235,49864
2013-01-23,49262,417,0,47,1192,50918
2013-01-24,52387,413,0,0,1090,53890
2013-01-25,50119,370,0,2,1118,51609
2013-01-26,58758,531,0,147,607,60043
2013-01-27,56531,417,0,0,1058,58006
2013-01-28,48220,385,0,8,1173,49786
2013-01-29,43256,442,0,92,753,44543
2013-01-30,49405,416,0,46,934,50801
2013-01-31,54751,403,0,1,824,55979
2013-02-01,61094,420,0,44,1000,62558
2013-02-02,58735,420,0,103,772,60030
2013-02-03,52177,434,0,0,1318,53929
2013-02-04,54049,413,0,10,1502,55974
2013-02-05,50854,450,0,71,825,52200
2013-02-06,46456,395,0,4,988,47843
2013-02-07,56371,338,0,11,1032,57752
2013-02-08,71641,359,0,2,1261,73263
2013-02-09,62429,431,0,132,852,63844
2013-02-10,62781,503,0,0,1247,64531
2013-02-11,49326,322,1,0,1293,50942
2013-02-12,45725,370,0,80,770,46945
2013-02-13,48282,374,0,53,1021,49730
2013-02-14,52512,439,0,0,905,53856
2013-02-15,59846,500,0,7,1470,61823
2013-02-16,71333,344,0,134,859,72670
2013-02-17,64288,348,0,0,1520,66156
2013-02-18,58274,334,0,2,1483,60093
2013-02-19,45834,295,0,202,852,47183
2013-02-20,49850,338,0,4,1148,51340
2013-02-21,53418,398,0,4,1034,54854
2013-02-22,58742,429,0,49,1676,60896
2013-02-23,56998,358,0,117,868,58341
2013-02-24,58626,425,0,0,1171,60222
2013-02-25,49242,364,0,7,1280,50893
2013-02-26,50274,368,0,158,1061,51861
2013-02-27,54710,344,0,5,1302,56361
2013-02-28,60202,341,0,3,1609,62155
2013-03-01,79956,427,0,0,1581,81964
2013-03-02,68264,427,0,119,958,69768
2013-03-03,82890,417,0,55,1553,84915
2013-03-04,62253,337,0,0,1574,64164
2013-03-05,55682,338,0,144,1151,57315
2013-03-06,54545,260,0,3,1292,56100
2013-03-07,60127,349,0,0,1172,61648
2013-03-08,80578,361,0,62,1612,82613
2013-03-09,69061,371,0,97,1011,70540
2013-03-10,72971,408,0,19,1743,75141
2013-03-11,57704,386,0,0,1478,59568
2013-03-12,56778,374,0,82,1041,58275
2013-03-13,56362,350,2,1,1302,58017
2013-03-14,51478,333,0,376,1474,53661
2013-03-15,75094,366,0,23,1842,77325
2013-03-16,82385,347,0,837,956,84525
2013-03-17,72616,419,0,16,1726,74777
2013-03-18,54866,443,0,0,1721,57030
2013-03-19,55542,341,0,150,423,56456
2013-03-20,61705,352,0,11,1835,63903
2013-03-21,67019,482,0,347,248,68096
2013-03-22,99987,488,0,83,2406,102964
2013-03-23,109815,389,160,4034,2533,116931
2013-03-24,81419,428,0,81,3071,84999
2013-03-25,52878,378,0,0,3410,56666
2013-03-26,61334,389,0,168,2540,64431
2013-03-27,74617,559,0,9,2492,77677
2013-03-28,103783,728,0,504,2377,107392
2013-03-29,146619,929,0,4256,3559,155363
2013-03-30,96402,632,0,6278,2396,105708
2013-03-31,74827,354,0,3946,3005,82132
2013-04-01,111158,447,180,47,3685,115517
2013-04-02,74705,502,0,1348,3102,79657
2013-04-03,67161,434,0,1806,2535,71936
2013-04-04,67368,407,256,247,2800,71078
2013-04-05,86399,470,125,5930,3254,96178
2013-04-06,95153,532,275,6305,3228,105493
2013-04-07,84751,522,0,2974,2444,90691
2013-04-08,56929,445,173,24,3312,60883
2013-04-09,61566,433,0,507,2963,65469
2013-04-10,65589,510,0,349,2836,69284
2013-04-11,65929,552,166,938,2989,70574
2013-04-12,81591,640,0,4725,1847,88803
2013-04-13,101271,543,91,7311,4768,113984
2013-04-14,92818,659,94,2963,2456,98990
2013-04-15,60287,519,285,736,3411,65238
2013-04-16,58256,363,0,1665,3091,63375
2013-04-17,73601,479,63,286,3481,77910
2013-04-18,73905,1181,181,1796,3013,80076
2013-04-19,91811,564,141,3748,4544,100808
2013-04-20,98703,382,0,7591,8904,115580
2013-04-21,101169,497,135,3418,3224,108443
2013-04-22,68014,514,310,1425,3525,73788
2013-04-23,65104,502,0,504,3406,69516
2013-04-24,79732,377,0,1304,4317,85730
2013-04-25,110368,683,465,4794,4044,120354
2013-04-26,131490,716,0,5480,6778,144464
2013-04-27,213437,705,155,9842,11660,235799
2013-04-28,139462,473,159,6042,5634,151770
2013-04-29,87056,676,133,526,4828,93219
2013-04-30,144394,651,0,3325,5016,153386
2013-05-01,194621,781,0,5562,5830,206794
2013-05-02,108542,666,409,6144,5733,121494
2013-05-03,117658,704,238,7127,6612,132339
2013-05-04,145776,703,0,9660,15198,171337
2013-05-05,122100,841,0,7155,8739,138835
2013-05-06,97654,576,281,2274,5569,106354
2013-05-07,78870,682,118,7079,6382,93131
2013-05-08,93103,730,204,1835,6381,102253
2013-05-09,118922,513,0,10442,7485,137362
2013-05-10,104031,591,268,8143,5547,118580
2013-05-11,110952,894,0,7954,14094,133894
2013-05-12,118496,942,0,9986,6387,135811
2013-05-13,76602,651,0,396,5587,83236
2013-05-14,73398,608,158,910,6090,81164
2013-05-15,76447,705,82,870,5273,83377
2013-05-16,89149,538,173,3671,6803,100334
2013-05-17,154199,630,214,10070,7036,172149
2013-05-18,167679,623,179,7757,17319,193557
2013-05-19,120449,1031,0,7890,6921,136291
2013-05-20,93834,783,181,3450,4410,102658
2013-05-21,82706,1005,86,7801,6872,98470
2013-05-22,84677,694,139,3088,6021,94619
2013-05-23,88780,662,138,7703,6579,103862
2013-05-24,120646,716,121,8157,7394,137034
2013-05-25,132517,830,116,11466,18843,163772
2013-05-26,107749,823,0,13375,8493,130440
2013-05-27,79242,729,321,3225,6849,90366
2013-05-28,76620,627,167,1049,7444,85907
2013-05-29,121653,676,289,2904,6889,132411
2013-05-30,122549,518,341,6279,8064,137751
2013-05-31,117469,659,132,11338,7371,136969
2013-06-01,134668,618,128,11961,20378,167753
2013-06-02,135440,811,83,7070,9381,152785
2013-06-03,90422,607,523,4697,7327,103576
2013-06-04,81590,680,103,6038,8093,96504
2013-06-05,81503,708,444,1466,7985,92106
2013-06-06,93845,604,0,5227,5792,105468
2013-06-07,142876,841,0,7287,7994,158998
2013-06-08,142255,692,0,12042,21709,176698
2013-06-09,124145,1055,137,6405,9295,141037
2013-06-10,91423,685,0,4088,7704,103900
2013-06-11,86425,810,0,2711,7925,97871
2013-06-12,88741,859,0,1662,8267,99529
2013-06-13,106178,702,84,1106,9781,117851
2013-06-14,164624,1634,0,14284,8593,189135
2013-06-15,187059,1141,0,13172,24495,225867
2013-06-16,165946,1138,0,12098,10914,190096
2013-06-17,105990,820,0,1955,8678,117443
2013-06-18,99483,753,0,7915,8943,117094
2013-06-19,101681,1102,0,1848,9548,114179
2013-06-20,126833,757,0,6002,10436,144028
2013-06-21,205635,1160,0,7003,9936,223734
2013-06-22,250417,1015,0,14296,25508,291236
2013-06-23,176581,1227,61,12388,11837,202094
2013-06-24,134110,1106,71,4934,9486,149707
2013-06-25,127797,1363,333,4696,11154,145343
2013-06-26,110367,901,35,3968,10704,125975
2013-06-27,124585,1106,275,1489,11882,139337
2013-06-28,178243,1282,0,11944,10741,202210
2013-06-29,251997,1188,225,11697,25873,290980
2013-06-30,199545,1841,165,17698,13373,232622
2013-07-01,147504,1039,181,2909,11309,162942
2013-07-02,112706,1079,337,8876,12711,135709
2013-07-03,115573,945,0,4453,11516,132487
2013-07-04,134953,604,162,4378,13946,154043
2013-07-05,240806,1449,88,10447,11263,264053
2013-07-06,305693,1089,0,10829,27540,345151
2013-07-07,214615,1160,109,11387,13878,241149
2013-07-08,166092,1400,420,5916,12591,186419
2013-07-09,141773,1470,0,2561,13567,159371
2013-07-10,139868,1329,276,4066,12937,158476
2013-07-11,164321,1214,425,2118,13679,181757
2013-07-12,233193,1683,317,10303,11620,257116
2013-07-13,320915,846,0,10311,27410,359482
2013-07-14,250711,1712,0,16558,14037,283018
2013-07-15,175481,1727,156,6140,12080,195584
2013-07-16,138950,1347,0,8795,13438,162530
2013-07-17,157068,1604,131,5509,12589,176901
2013-07-18,174376,1128,179,5404,14473,195560
2013-07-19,241937,1699,161,8289,11537,263623
2013-07-20,417840,1659,206,9823,28285,457813
2013-07-21,302945,1870,0,11569,14513,330897
2013-07-22,212526,1604,6,2744,12195,229075
2013-07-23,135429,1654,155,2913,14772,154923
2013-07-24,174079,1564,0,8341,12516,196500
2013-07-25,222355,1406,140,2515,14949,241365
2013-07-26,298319,3021,0,12107,11315,324762
2013-07-27,430496,1865,149,10896,27339,470745
2013-07-28,307570,2302,0,15900,14243,340015
2013-07-29,202692,1736,139,5741,12248,222556
2013-07-30,182882,2039,0,10734,13553,209208
2013-07-31,191758,1491,0,3064,13093,209406
2013-08-01,268557,1163,0,10250,14940,294910
2013-08-02,337993,2294,248,18344,12038,370917
2013-08-03,488468,1913,0,13894,27705,531980
2013-08-04,322846,1887,285,15591,14827,355436
2013-08-05,245501,1902,0,7058,12277,266738
2013-08-06,217066,2076,198,4140,13012,236492
2013-08-07,181424,1563,0,6681,11893,201561
2013-08-08,187212,1971,0,6506,14350,210039
2013-08-09,287745,2373,3,8423,10870,309414
2013-08-10,512398,1159,170,12814,25783,552324
2013-08-11,338124,2343,149,23474,14444,378534
2013-08-12,217312,1895,303,5513,11269,236292
2013-08-13,209648,1862,101,11736,11483,234830
2013-08-14,264073,2931,149,4227,10904,282284
2013-08-15,293734,1969,0,6239,14513,316455
2013-08-16,320612,1941,303,11970,10783,345609
2013-08-17,479888,2188,125,13538,24255,519994
2013-08-18,339193,1807,0,15264,13270,369534
2013-08-19,221571,1863,327,3977,10248,237986
2013-08-20,168083,1709,76,9806,10982,190656
2013-08-21,183276,1394,158,4781,9752,199361
2013-08-22,211034,1194,188,8690,11462,232568
2013-08-23,335619,1707,97,10217,9308,356948
2013-08-24,424782,1533,0,11842,24142,462299
2013-08-25,266872,1469,118,20004,11615,300078
2013-08-26,185162,912,159,3126,8259,197618
2013-08-27,158597,1871,0,9215,9811,179494
2013-08-28,149877,1621,414,3920,8854,164686
2013-08-29,189990,870,182,8062,10531,209635
2013-08-30,271331,1476,17,12742,9055,294621
2013-08-31,339682,1625,271,11129,24944,377651
2013-09-01,261465,1283,83,11599,12722,287152
2013-09-02,168267,851,154,2657,8393,180322
2013-09-03,133414,1636,281,3617,10083,149031
2013-09-04,139698,891,134,3718,9106,153547
2013-09-05,153461,738,0,4020,10889,169108
2013-09-06,210183,1052,0,13260,9438,233933
2013-09-07,259266,1459,158,12109,26073,299065
2013-09-08,192817,1452,0,12276,11772,218317
2013-09-09,124750,1299,387,4089,8304,138829
2013-09-10,113063,743,120,11886,8932,134744
2013-09-11,122955,714,0,4868,8855,137392
2013-09-12,125619,1113,0,7118,9045,142895
2013-09-13,157627,1198,320,11917,9037,180099
2013-09-14,187113,901,0,10483,23457,221954
2013-09-15,150618,917,169,7164,10993,169861
2013-09-16,105353,971,0,4873,7733,118930
2013-09-17,93170,1024,162,2175,8356,104887
2013-09-18,98002,952,244,8922,7435,115555
2013-09-19,111514,833,0,8999,9269,130615
2013-09-20,143411,867,148,7225,7671,159322
2013-09-21,164351,957,137,9991,20024,195460
2013-09-22,130585,884,1,13032,9229,153731
2013-09-23,99992,947,365,7434,7036,115774
2013-09-24,86626,935,224,4947,7076,99808
2013-09-25,89204,629,0,1876,1742312,1834021
2013-09-26,107932,706,0,4882,7858,121378
2013-09-27,138181,734,154,9581,7961,156611
2013-09-28,150990,725,289,8553,16232,176789
2013-09-29,107562,610,376,13524,8121,130193
2013-09-30,87950,793,323,2025,5736,96827
2013-10-01,84996,915,138,4510,5835,96394
2013-10-02,91677,1148,182,1732,1571,96310
2013-10-03,91766,594,184,2176,9261,103981
2013-10-04,124301,869,99,7088,5297,137654
2013-10-05,134959,679,0,11322,11873,158833
2013-10-06,106868,1119,0,10006,6079,124072
2013-10-07,79348,850,0,4021,4583,88802
2013-10-08,87666,635,0,4628,5429,98358
2013-10-09,81462,638,0,5563,4690,92353
2013-10-10,91212,876,418,1835,5716,100057
2013-10-11,115053,955,204,9441,5551,131204
2013-10-12,118662,597,126,12540,10318,142243
2013-10-13,113538,647,320,8640,5620,128765
2013-10-14,79146,979,188,4242,4567,89122
2013-10-15,73177,752,166,865,4608,79568
2013-10-16,91997,945,0,1471,3572,97985
2013-10-17,100914,481,164,4663,4371,110593
2013-10-18,113651,703,0,10431,4650,129435
2013-10-19,111437,635,82,7774,8808,128736
2013-10-20,107538,529,0,6973,4778,119818
2013-10-21,81140,490,142,4739,3864,90375
2013-10-22,70271,669,0,6185,3760,80885
2013-10-23,74269,574,0,2746,2990,80579
2013-10-24,84987,337,188,3200,3614,92326
2013-10-25,110622,621,168,7420,2931,121762
2013-10-26,119103,858,0,12959,5612,138532
2013-10-27,98186,1323,0,11312,2937,113758
2013-10-28,78952,497,181,4133,2167,85930
2013-10-29,82125,769,155,5700,2055,90804
2013-10-30,124869,877,1,3960,2246,131953
2013-10-31,145869,521,0,4805,2780,153975
2013-11-01,121973,1032,0,11334,1494,135833
2013-11-02,102419,438,0,5587,1379,109823
2013-11-03,142641,1052,0,7127,1994,152814
2013-11-04,72052,549,184,5615,1687,80087
2013-11-05,62695,532,0,2833,1260,67320
2013-11-06,68892,400,151,18,1803,71264
2013-11-07,85740,457,183,438,2139,88957
2013-11-08,87032,455,0,1303,1793,90583
2013-11-09,87842,482,0,3426,1396,93146
2013-11-10,84685,499,3,4671,1801,91659
2013-11-11,62095,478,179,0,1793,64545
2013-11-12,58213,437,0,3,1653,60306
2013-11-13,65755,492,0,0,1422,67669
2013-11-14,74851,555,184,3963,1287,80840
2013-11-15,87457,441,0,997,1770,90665
2013-11-16,82073,467,0,4741,1242,88523
2013-11-17,89829,389,0,4622,1955,96795
2013-11-18,64392,362,332,1023,1430,67539
2013-11-19,64923,565,0,66,1114,66668
2013-11-20,60393,477,0,36,128,61034
2013-11-21,76441,329,176,0,907,77853
2013-11-22,91994,527,0,2826,674,96021
2013-11-23,76147,557,0,6173,1445,84322
2013-11-24,80058,482,0,4792,1560,86892
2013-11-25,68185,465,0,48,1625,70323
2013-11-26,58085,428,0,0,1059,59572
2013-11-27,60017,437,0,19,1101,61574
2013-11-28,62815,387,146,123,1243,64714
2013-11-29,89627,606,0,46,1496,91775
2013-11-30,82368,789,0,291,1076,84524
2013-12-01,75340,572,0,44,1512,77468
2013-12-02,57110,369,0,300,1201,58980
2013-12-03,55044,370,0,65,882,56361
2013-12-04,60838,321,2369,3,1468,64999
2013-12-05,67174,560,1,501,1379,69615
2013-12-06,77800,678,0,39,1978,80495
2013-12-07,76555,461,1,234,916,78167
2013-12-08,72708,531,0,9,1433,74681
2013-12-09,57510,283,0,3,1579,59375
2013-12-10,58920,358,0,135,1161,60574
2013-12-11,61491,456,0,22,1642,63611
2013-12-12,65178,375,0,55,1433,67041
2013-12-13,82583,368,0,4,1442,84397
2013-12-14,76710,517,0,98,1483,78808
2013-12-15,80954,1038,0,3,1566,83561
2013-12-16,61340,328,0,91,1541,63300
2013-12-17,63155,430,0,60,77,63722
2013-12-18,74950,422,0,36,1056,76464
2013-12-19,86565,536,0,92,1934,89127
2013-12-20,137878,726,0,0,1645,140249
2013-12-21,204879,1169,0,203,1873,208124
2013-12-22,115321,1063,0,46,1945,118375
2013-12-23,102662,761,0,0,1898,105321
2013-12-24,85657,555,0,1896,1237,89345
2013-12-25,71772,309,0,0,437,72518
2013-12-26,66924,441,0,5,1248916,1316286
2013-12-27,93670,821,0,0,1073,95564
2013-12-28,99118,1239,0,426,1668,102451
2013-12-29,107282,680,0,7,1634,109603
2013-12-30,96281,1248,0,765,1465,99759
2013-12-31,66439,494,0,299,531,67763
2014-01-01,60080,1428,0,6,399,61913
2014-01-02,94870,1100,0,30,1338,97338
2014-01-03,108644,584,0,9,1442,110679
2014-01-04,125413,653,3,125,684,126878
2014-01-05,146281,505,0,62,1158,148006
2014-01-06,93830,738,0,0,1291,95859
2014-01-07,63625,562,0,51,663,64901
2014-01-08,76516,439,0,1,605,77561
2014-01-09,72573,446,0,0,703,73722
2014-01-10,83686,620,0,0,1166,85472
2014-01-11,91729,626,0,80,1368,93803
2014-01-12,85939,459,0,3,1466,87867
2014-01-13,60446,359,0,2,1364,62171
2014-01-14,57582,403,0,43,1147,59175
2014-01-15,56637,421,0,5,1112,58175
2014-01-16,62035,394,0,2,1036,63467
2014-01-17,79488,433,0,0,1319,81240
2014-01-18,81872,347,0,50,673,82942
2014-01-19,68243,416,2,0,1223,69884
2014-01-20,61700,323,0,0,1290,63313
2014-01-21,59645,397,0,365,714,61121
2014-01-22,62821,453,0,12,1219,64505
2014-01-23,56822,399,0,0,567,57788
2014-01-24,65842,268,0,0,1245,67355
2014-01-25,63185,311,0,48,821,64365
2014-01-26,57484,477,0,9,1107,59077
2014-01-27,54356,378,0,0,1132,55866
2014-01-28,47835,296,0,168,717,49016
2014-01-29,54681,328,0,6,1029,56044
2014-01-30,51077,370,0,0,1079,52526
2014-01-31,63685,474,0,60,1256,65475
2014-02-01,62182,154,0,0,817,63153
2014-02-02,62832,316,0,37,1116,64301
2014-02-03,48440,379,0,49,1265,50133
2014-02-04,48606,158,0,72,568,49404
2014-02-05,54890,258,0,5,998,56151
2014-02-06,59390,191,3,51,945,60580
2014-02-07,74223,286,0,48,1282,75839
2014-02-08,61006,299,0,129,520,61954
2014-02-09,67022,322,0,0,1186,68530
2014-02-10,53603,363,0,0,1011,54977
2014-02-11,54029,280,0,87,1083,55479
2014-02-12,52482,233,0,5,1216,53936
2014-02-13,69185,299,0,2,1293,70779
2014-02-14,83437,467,0,1,1524,85429
2014-02-15,79889,372,0,67,900,81228
2014-02-16,72895,382,0,1,1413,74691
2014-02-17,58866,391,0,38,1641,60936
2014-02-18,56769,292,0,147,969,58177
2014-02-19,61423,384,0,0,1482,63289
2014-02-20,66111,320,0,2,1048,67481
2014-02-21,80014,373,0,95,1363,81845
2014-02-22,74657,258,0,103,843,75861
2014-02-23,74025,252,0,1,1376,75654
2014-02-24,56942,332,0,96,1396,58766
2014-02-25,56756,223,0,102,1058,58139
2014-02-26,60887,293,0,8,1529,62717
2014-02-27,64445,339,0,44,1523,66351
2014-02-28,85621,324,0,3,1391,87339
2014-03-01,83409,382,0,160,1021,84972
2014-03-02,79463,353,0,2,1308,81126
2014-03-03,62518,349,0,5,1528,64400
2014-03-04,60858,380,0,106,1060,62404
2014-03-05,65005,269,0,0,1537,66811
2014-03-06,73800,347,0,0,1352,75499
2014-03-07,92965,370,0,0,1970,95305
2014-03-08,83457,366,0,114,570,84507
2014-03-09,96817,410,0,3,1749,98979
2014-03-10,65255,297,0,90,1511,67153
2014-03-11,60870,363,0,111,1121,62465
2014-03-12,61223,332,0,7,1888,63450
2014-03-13,67849,237,0,11,301,68398
2014-03-14,97771,365,0,44,1425,99605
2014-03-15,88093,402,0,310,1104,89909
2014-03-16,91901,563,0,15,1810,94289
2014-03-17,67422,410,0,8,1496,69336
2014-03-18,63543,578,0,134,1279,65534
2014-03-19,70505,312,171,1,1542,72531
2014-03-20,72148,376,1,126,1563,74214
2014-03-21,95428,365,0,6,1893,97692
2014-03-22,89184,530,0,135,1488,91337
2014-03-23,84758,544,0,5,2106,87413
2014-03-24,62946,351,0,59,1722,65078
2014-03-25,61510,370,0,109,1167,63156
2014-03-26,69399,401,177,13,1646,71636
2014-03-27,73732,326,126,461,1668,76313
2014-03-28,91264,576,0,17,1853,93710
2014-03-29,96517,445,169,359,1072,98562
2014-03-30,98647,742,166,60,2111,101726
2014-03-31,66316,496,0,1532,2126,70470
2014-04-01,64014,426,0,328,3102,67870
2014-04-02,68386,378,306,167,2972,72209
2014-04-03,66772,649,84,198,3334,71037
2014-04-04,101787,462,0,113,3537,105899
2014-04-05,95598,398,318,303,5323,101940
2014-04-06,96763,563,0,2972,3099,103397
2014-04-07,68455,332,0,4294,3734,76815
2014-04-08,65196,550,128,1545,3605,71024
2014-04-09,67480,426,364,124,3221,71615
2014-04-10,87282,517,0,1813,4525,94137
2014-04-11,126752,772,0,4380,4744,136648
2014-04-12,148198,797,180,5851,8767,163793
2014-04-13,116615,552,262,3647,5492,126568
2014-04-14,79578,692,121,698,4026,85115
2014-04-15,84963,817,0,439,4783,91002
2014-04-16,101656,582,0,2922,2895,108055
2014-04-17,142573,559,79,550,5631,149392
2014-04-18,213827,728,0,4695,5528,224778
2014-04-19,127036,784,284,10330,8245,146679
2014-04-20,97837,546,0,3798,3838,106019
2014-04-21,156389,843,83,7061,3973,168349
2014-04-22,108330,812,44,4976,3826,117988
2014-04-23,88910,468,371,472,3755,93976
2014-04-24,99613,852,74,3121,3749,107409
2014-04-25,146024,748,0,6609,5525,158906
2014-04-26,177360,692,29,9108,10558,197747
2014-04-27,119094,504,186,3984,4551,128319
2014-04-28,93722,614,134,1893,4896,101259
2014-04-29,92971,826,212,3880,3672,101561
2014-04-30,195774,852,0,1534,6891,205051
2014-05-01,206489,630,0,4358,7188,218665
2014-05-02,121207,589,0,6126,5436,133358
2014-05-03,143383,465,188,8010,14296,166342
2014-05-04,177448,1147,0,6274,6061,190930
2014-05-05,100259,434,110,4805,5256,110864
2014-05-06,83580,411,85,1770,6121,91967
2014-05-07,81880,428,515,4142,5640,92605
2014-05-08,99824,726,107,4720,3894,109271
2014-05-09,109392,490,0,6069,5918,121869
2014-05-10,122667,596,162,7333,13768,144526
2014-05-11,105189,557,254,3727,6771,116498
2014-05-12,81939,457,2,141,3510,86049
2014-05-13,76318,581,97,979,6119,84094
2014-05-14,77120,706,180,2881,6525,87412
2014-05-15,82258,598,0,693,6995,90544
2014-05-16,110763,603,169,9184,6202,126921
2014-05-17,101550,448,170,7376,13643,123187
2014-05-18,94031,846,384,11827,7235,114323
2014-05-19,77314,660,0,3086,5653,86713
2014-05-20,78550,457,138,5483,6488,91116
2014-05-21,82906,377,180,802,7560,91825
2014-05-22,86739,851,195,5192,6912,99889
2014-05-23,129732,683,160,8347,7116,146038
2014-05-24,140083,525,183,9680,20049,170520
2014-05-25,112710,793,183,6972,7419,128077
2014-05-26,83876,706,200,125,6831,91738
2014-05-27,82125,586,56,1499,7400,91666
2014-05-28,119155,482,728,2340,9726,132431
2014-05-29,148832,690,155,2395,8555,160627
2014-05-30,144457,544,110,6627,7760,159498
2014-05-31,156628,451,134,12216,19245,188674
2014-06-01,144568,541,169,6788,9937,162003
2014-06-02,107648,517,295,6415,7264,122139
2014-06-03,83927,569,142,3543,6086,94267
2014-06-04,90882,530,363,3482,8840,104097
2014-06-05,108665,793,162,2276,10263,122159
2014-06-06,183598,690,264,11921,8799,205272
2014-06-07,243086,559,165,13584,20733,278127
2014-06-08,162639,775,375,6338,10630,180757
2014-06-09,123388,710,284,1542,8358,134282
2014-06-10,100729,841,246,4413,9550,115779
2014-06-11,106929,888,203,2856,10638,121514
2014-06-12,110392,989,0,6340,9746,127467
2014-06-13,152606,784,122,8146,8704,170362
2014-06-14,216077,637,192,8898,22062,247866
2014-06-15,151848,722,85,11446,11406,175507
2014-06-16,114302,740,131,3886,8744,127803
2014-06-17,104504,950,190,3939,9160,118743
2014-06-18,150050,790,607,2035,10724,164206
2014-06-19,177340,648,0,3453,11345,192786
2014-06-20,188650,869,0,8479,9977,207975
2014-06-21,234443,894,0,17620,22612,275569
2014-06-22,202272,1006,300,7391,12361,223330
2014-06-23,119694,983,266,6457,9387,136787
2014-06-24,121653,1091,445,4450,10922,138561
2014-06-25,127775,713,180,3489,12255,144412
2014-06-26,138715,869,203,5376,12771,157934
2014-06-27,179809,1312,101,6451,10765,198438
2014-06-28,256690,1090,269,11013,25424,294486
2014-06-29,200999,1087,297,10416,15482,228281
2014-06-30,137820,1069,87,4976,12551,156503
2014-07-01,132595,1513,157,9285,14654,158204
2014-07-02,126988,1205,315,2273,14139,144920
2014-07-03,146683,868,127,1597,14743,164018
2014-07-04,231459,1408,101,11470,13155,257593
2014-07-05,340154,982,203,11322,27183,379844
2014-07-06,248346,1292,188,8607,15990,274423
2014-07-07,173499,1273,192,3900,12405,191269
2014-07-08,152471,1119,0,4271,15997,173858
2014-07-09,146582,1291,0,3463,15803,167139
2014-07-10,179976,1718,396,4428,17408,203926
2014-07-11,242422,2000,262,9456,12178,266318
2014-07-12,336802,933,0,6661,27273,371669
2014-07-13,231777,1496,0,8282,16445,258000
2014-07-14,202794,1543,107,5509,13462,223415
2014-07-15,167751,1632,112,9739,16394,195628
2014-07-16,169129,1474,369,3362,15458,189792
2014-07-17,194534,1807,265,6045,15891,218542
2014-07-18,293633,2431,0,9344,12408,317816
2014-07-19,402128,1778,79,9806,26697,440488
2014-07-20,309542,1983,185,9257,17605,338572
2014-07-21,220968,2031,0,1357,13345,237701
2014-07-22,164792,1883,90,2388,14806,183959
2014-07-23,173686,1642,127,4277,15177,194909
2014-07-24,202873,1491,228,4243,15975,224810
2014-07-25,316688,2409,0,9594,13262,341953
2014-07-26,453164,2202,622,7462,27979,491429
2014-07-27,281139,1641,0,5975,17482,306237
2014-07-28,193306,1449,198,4341,12654,211948
2014-07-29,184087,2203,0,6060,14984,207334
2014-07-30,203112,1548,187,1698,14167,220712
2014-07-31,247974,2160,307,6450,16349,273240
2014-08-01,386687,2444,0,8470,14469,412070
2014-08-02,537391,1981,0,13910,28238,581520
2014-08-03,392124,2532,170,14762,18354,427942
2014-08-04,225195,2383,172,7085,11899,246734
2014-08-05,206767,1809,350,6497,14398,229821
2014-08-06,214562,1720,291,4529,14906,236008
2014-08-07,229664,1822,2,5551,14866,251905
2014-08-08,345913,2504,0,15790,12484,376691
2014-08-09,473476,1872,95,12283,26277,514003
2014-08-10,360460,1982,0,10063,16784,389289
2014-08-11,247056,1738,165,6776,11467,267202
2014-08-12,217402,2315,426,6346,12402,238891
2014-08-13,204825,1564,183,5771,13151,225494
2014-08-14,310110,1850,93,8615,13554,334222
2014-08-15,340269,2911,213,8009,11424,362826
2014-08-16,433145,1668,183,13302,24564,472862
2014-08-17,352674,1958,274,13744,15892,384542
2014-08-18,262358,2289,414,6772,10940,282773
2014-08-19,198768,2101,0,7319,11842,220030
2014-08-20,199898,1292,110,5560,12344,219204
2014-08-21,221048,1442,0,7504,12818,242812
2014-08-22,267083,2023,0,16169,10511,295786
2014-08-23,411181,1638,140,8098,24277,445334
2014-08-24,287125,1538,125,9179,14744,312711
2014-08-25,209531,1319,0,5453,9056,225359
2014-08-26,168900,1795,227,4136,10673,185731
2014-08-27,181945,1054,847,2224,11318,197388
2014-08-28,214672,1047,0,5304,10513,231536
2014-08-29,268483,1372,0,10530,9650,290035
2014-08-30,365787,921,198,8843,24281,400030
2014-08-31,257492,1123,0,11371,13936,283922
2014-09-01,189144,606,0,10954,8161,208865
2014-09-02,143653,1389,0,4311,12055,161408
2014-09-03,141014,745,154,5179,12566,159658
2014-09-04,151043,707,128,6116,11353,169347
2014-09-05,197151,792,108,11006,9645,218702
2014-09-06,253123,938,273,5783,22864,282981
2014-09-07,192309,1019,0,7359,13455,214142
2014-09-08,139791,578,121,3931,8862,153283
2014-09-09,115725,873,244,12706,10456,140004
2014-09-10,122352,1364,0,1783,11408,136907
2014-09-11,132230,840,37,4552,10663,148322
2014-09-12,176048,1030,165,8666,9611,195520
2014-09-13,188532,769,343,8501,21590,219735
2014-09-14,156282,952,85,9156,11215,177690
2014-09-15,112091,1049,144,613,8232,122129
2014-09-16,104411,850,347,4138,9037,118783
2014-09-17,104861,607,340,4261,10137,120206
2014-09-18,114248,728,4,5796,9185,129961
2014-09-19,154145,829,152,9223,8208,172557
2014-09-20,150539,702,152,11005,20562,182960
2014-09-21,140973,726,191,5958,10483,158331
2014-09-22,102252,515,0,8379,7310,118456
2014-09-23,89021,772,0,8512,7884,106189
2014-09-24,106576,730,2,2795,8397,118500
2014-09-25,108728,566,158,5456,7655,122563
2014-09-26,147669,600,180,9689,7307,165445
2014-09-27,150770,732,338,14905,16765,183510
2014-09-28,128210,723,163,9117,8044,146257
2014-09-29,94894,801,318,5308,6155,107476
2014-09-30,91573,692,0,8130,5943,106338
2014-10-01,95563,921,148,2030,5773,104435
2014-10-02,117724,612,0,4989,7179,130504
2014-10-03,164921,660,125,8833,7083,181622
2014-10-04,132650,684,200,7551,12430,153515
2014-10-05,139684,695,0,6475,7657,154511
2014-10-06,97675,1023,2,3658,5827,108185
2014-10-07,83383,520,0,6298,5990,96191
2014-10-08,95687,476,187,431,5375,102156
2014-10-09,94513,878,561,1929,6111,103992
2014-10-10,133555,638,0,6202,5682,146077
2014-10-11,135676,447,162,7486,9553,153324
2014-10-12,123018,818,0,10133,6456,140425
2014-10-13,79278,619,0,63,4901,84861
2014-10-14,80387,716,167,3004,4951,89225
2014-10-15,84505,391,101,240,4912,90149
2014-10-16,93367,411,1,4899,5208,103886
2014-10-17,115557,441,0,10230,5035,131263
2014-10-18,123974,946,179,7306,8575,140980
2014-10-19,113320,541,424,5803,4503,124591
2014-10-20,77032,542,0,14,3682,81270
2014-10-21,73874,575,147,2390,3446,80432
2014-10-22,81890,664,227,1923,3953,88657
2014-10-23,81974,431,1,2031,3420,87857
2014-10-24,115280,420,76,10593,3906,130275
2014-10-25,126797,566,60,10302,5367,143092
2014-10-26,107624,648,0,6274,3228,117774
2014-10-27,78669,625,58,2785,2290,84427
2014-10-28,74827,804,0,2271,2160,80062
2014-10-29,87169,472,313,144,2554,90652
2014-10-30,126325,543,0,2459,2385,131712
2014-10-31,134356,569,293,7278,2187,144683
2014-11-01,104932,673,0,7406,1495,114506
2014-11-02,118638,548,0,7432,1746,128364
2014-11-03,80421,487,0,6149,1787,88844
2014-11-04,68299,473,0,3492,1261,73525
2014-11-05,72391,520,75,0,2039,75025
2014-11-06,73228,378,0,2,1981,75589
2014-11-07,97936,639,0,6163,2356,107094
2014-11-08,93485,404,186,1037,1432,96544
2014-11-09,81374,534,0,5091,1778,88777
2014-11-10,68778,526,246,1,1738,71289
2014-11-11,69034,514,0,194,1847,71589
2014-11-12,64744,452,0,7,1928,67131
2014-11-13,71841,443,0,10,2048,74342
2014-11-14,96849,789,0,6,2283,99927
2014-11-15,110000,434,0,107,1155,111696
2014-11-16,86911,788,0,3007,1475,92181
2014-11-17,66791,396,0,47,2111,69345
2014-11-18,62017,449,0,95,1355,63916
2014-11-19,64905,367,174,3,1920,67369
2014-11-20,74659,380,0,43,1496,76578
2014-11-21,94812,595,0,4,1249,96660
2014-11-22,84997,609,0,146,1183,86935
2014-11-23,89279,433,0,2985,1513,94210
2014-11-24,64485,363,0,7,1898,66753
2014-11-25,63782,459,0,2123,1607,67971
2014-11-26,65000,245,0,3,1859,67107
2014-11-27,69947,231,0,53,1553,71784
2014-11-28,88549,502,0,2,2009,91062
2014-11-29,82783,323,98,258,1240,84702
2014-11-30,77037,378,0,5150,1922,84487
2014-12-01,63209,285,0,0,1687,65181
2014-12-02,58235,431,0,87,1333,60086
2014-12-03,66201,404,0,64,1282,67951
2014-12-04,66571,645,0,8,1986,69210
2014-12-05,89218,493,0,4,1952,91667
2014-12-06,84131,537,0,118,1027,85813
2014-12-07,75765,398,0,2,1792,77957
2014-12-08,70668,374,0,5,1589,72636
2014-12-09,63127,325,0,53,207,63712
2014-12-10,62368,321,0,3,75,62767
2014-12-11,72870,412,0,5,1925,75212
2014-12-12,82928,300,0,6,2225,85459
2014-12-13,86045,488,0,130,1182,87845
2014-12-14,72074,791,0,2,1549,74416
2014-12-15,60745,483,0,3,1546,62777
2014-12-16,63346,404,0,84,1523,65357
2014-12-17,76270,652,0,34,2346,79302
2014-12-18,89908,345,0,52,2251,92556
2014-12-19,137673,646,0,38,2737,141094
2014-12-20,179996,666,0,90,2281,183033
2014-12-21,128831,737,0,31,2792,132391
2014-12-22,92366,621,0,0,2183,95170
2014-12-23,145447,586,0,187,2065,148285
2014-12-24,150017,718,0,25,1611,152371
2014-12-25,87408,567,0,4,444,88423
2014-12-26,89975,511,0,12,1855,92353
2014-12-27,100265,630,0,2,1321,102218
2014-12-28,79521,713,0,0,1972,82206
2014-12-29,81029,1208,0,7,2320,84564
2014-12-30,101939,1607,0,645,2222,106413
2014-12-31,79170,731,0,0,858,80759
2015-01-01,58015,575,0,0,561,59151
2015-01-02,106714,1350,0,21,1763,109848
2015-01-03,131995,976,0,98,1632,134701
2015-01-04,130215,700,2,3,1791,132711
2015-01-05,106182,649,0,29,1522,108382
2015-01-06,93395,700,0,63,1636,95794
2015-01-07,76463,283,0,42,1600,78388
2015-01-08,92671,535,0,38,1899,95143
2015-01-09,110336,556,0,0,1183,112075
2015-01-10,150720,713,0,104,1085,152622
2015-01-11,113602,473,0,0,1899,115974
2015-01-12,68264,519,0,0,1185,69968
2015-01-13,81214,581,0,61,895,82751
2015-01-14,69682,499,0,14,1243,71438
2015-01-15,66710,462,0,100,1579,68851
2015-01-16,76528,503,0,44,1386,78461
2015-01-17,78047,365,0,43,941,79396
2015-01-18,66490,635,0,0,1356,68481
2015-01-19,51726,412,0,18,1551,53707
2015-01-20,55532,330,0,381,1033,57276
2015-01-21,60348,321,0,1,1263,61933
2015-01-22,61611,270,0,0,1195,63076
2015-01-23,68162,234,0,22,1074,69492
2015-01-24,71724,351,0,35,939,73049
2015-01-25,71107,398,0,0,1287,72792
2015-01-26,53725,411,0,22,1291,55449
2015-01-27,52375,304,0,149,977,53805
2015-01-28,56900,569,0,102,1138,58709
2015-01-29,57996,350,0,0,1104,59450
2015-01-30,66076,536,0,1,1574,68187
2015-01-31,62495,314,0,114,1012,63935
2015-02-01,62391,420,0,0,1747,64558
2015-02-02,53786,315,0,43,1606,55750
2015-02-03,52318,423,0,49,1109,53899
2015-02-04,50835,243,0,0,1188,52266
2015-02-05,50191,357,0,53,1240,51841
2015-02-06,48633,294,0,0,1575,50502
2015-02-07,56257,297,0,43,1077,57674
2015-02-08,57532,381,0,46,1486,59445
2015-02-09,51155,406,0,16,1339,52916
2015-02-10,48900,507,0,47,1541,50995
2015-02-11,55926,399,0,8,1274,57607
2015-02-12,59714,302,0,127,1455,61598
2015-02-13,84359,404,0,9,2122,86894
2015-02-14,83560,409,0,55,1488,85512
2015-02-15,82609,417,0,0,1766,84792
2015-02-16,59657,416,0,20,1890,61983
2015-02-17,63386,280,0,75,1183,64924
2015-02-18,59774,484,0,43,1274,61575
2015-02-19,68218,412,0,42,1420,70092
2015-02-20,80504,402,0,349,1795,83050
2015-02-21,78773,261,0,186,1254,80474
2015-02-22,75981,426,0,0,1908,78315
2015-02-23,57490,462,0,7,1525,59484
2015-02-24,53145,353,0,71,897,54466
2015-02-25,59581,427,3,5,1409,61425
2015-02-26,66201,440,0,0,1600,68241
2015-02-27,84260,487,0,9,1731,86487
2015-02-28,83791,443,0,133,860,85227
2015-03-01,84878,577,0,47,1875,87377
2015-03-02,62585,432,0,2,1280,64299
2015-03-03,59687,241,0,108,1697,61733
2015-03-04,61684,240,0,1,859,62784
2015-03-05,66098,370,0,0,1937,68405
2015-03-06,85582,464,0,0,2286,88332
2015-03-07,79511,572,0,5,781,80869
2015-03-08,85875,703,0,0,1807,88385
2015-03-09,63394,409,0,2,1821,65626
2015-03-10,59553,274,0,147,1405,61379
2015-03-11,63014,240,0,6,2114,65374
2015-03-12,68761,316,0,366,1569,71012
2015-03-13,87392,371,0,59,1930,89752
2015-03-14,112782,350,0,535,1248,114915
2015-03-15,84924,308,0,73,1911,87216
2015-03-16,62510,394,0,352,1557,64813
2015-03-17,59190,347,0,380,1817,61734
2015-03-18,81616,291,145,55,1781,83888
2015-03-19,76379,368,0,63,1915,78725
2015-03-20,90858,393,0,16,2303,93570
2015-03-21,88630,666,0,115,1928,91339
2015-03-22,87287,450,0,44,2729,90510
2015-03-23,63039,426,0,13,2470,65948
2015-03-24,63302,536,0,161,2175,66174
2015-03-25,67982,379,0,132,1585,70078
2015-03-26,95333,336,0,93,2208,97970
2015-03-27,104854,494,0,57,2379,107784
2015-03-28,123988,519,0,149,2967,127623
2015-03-29,107409,412,0,119,5014,112954
2015-03-30,96064,518,0,25,3920,100527
2015-03-31,76066,706,0,179,3652,80603
2015-04-01,99242,611,143,263,4488,104747
2015-04-02,134657,1133,0,242,5652,141684
2015-04-03,326594,1045,221,1103,4066,333029
2015-04-04,138439,719,0,368,4821,144347
2015-04-05,116353,452,0,949,3217,120971
2015-04-06,180302,602,0,3286,3846,188036
2015-04-07,117518,614,314,306,4431,123183
2015-04-08,85200,431,39,95,3227,88992
2015-04-09,90115,477,0,1932,3413,95937
2015-04-10,128945,539,72,353,3445,133354
2015-04-11,132382,460,0,2798,5434,141074
2015-04-12,96169,395,0,164,4189,100917
2015-04-13,88673,771,264,189,2776,92673
2015-04-14,74933,487,258,2781,3697,82156
2015-04-15,80131,694,227,1894,3527,86473
2015-04-16,84879,464,0,6261,3153,94757
2015-04-17,109585,561,528,5285,3525,119484
2015-04-18,107981,476,73,3792,7199,119521
2015-04-19,129972,524,0,2521,4118,137135
2015-04-20,75266,651,498,4036,3456,83907
2015-04-21,73881,449,322,2052,5308,82012
2015-04-22,81409,688,14,7064,4896,94071
2015-04-23,88287,389,0,2219,3766,94661
2015-04-24,124887,508,269,8504,3827,137995
2015-04-25,155086,701,187,3766,10496,170236
2015-04-26,110662,903,0,4562,5466,121593
2015-04-27,90898,527,501,735,4151,96812
2015-04-28,84204,643,186,3219,5382,93634
2015-04-29,121295,630,237,1231,6409,129802
2015-04-30,195512,834,243,3038,7789,207416
2015-05-01,177682,612,363,8941,6516,194114
2015-05-02,131387,635,0,3876,13271,149169
2015-05-03,172935,1033,0,2691,8208,184867
2015-05-04,102142,577,286,4426,4985,112416
2015-05-05,82772,600,0,375,5571,89318
2015-05-06,89429,574,119,10319,6518,106959
2015-05-07,97564,617,120,2593,6643,107537
2015-05-08,128204,747,160,7012,7701,143824
2015-05-09,130839,614,139,5856,12928,150376
2015-05-10,129057,1479,86,6968,8868,146458
2015-05-11,83823,371,312,1333,5886,91725
2015-05-12,86434,544,0,4336,6243,97557
2015-05-13,145910,637,300,1844,7419,156110
2015-05-14,129420,791,190,7290,9682,147373
2015-05-15,123599,452,181,5847,8271,138350
2015-05-16,123321,568,0,8027,13800,145716
2015-05-17,130003,622,0,4132,8114,142871
2015-05-18,85688,745,0,4252,6057,96742
2015-05-19,79401,688,267,3358,5923,89637
2015-05-20,89176,552,148,5378,7766,103020
2015-05-21,89021,450,0,4703,8941,103115
2015-05-22,144139,697,93,4504,8131,157564
2015-05-23,162158,627,229,5558,21452,190024
2015-05-24,128641,628,45,9925,10674,149913
2015-05-25,140650,450,453,664,7525,149742
2015-05-26,88697,532,275,1936,8908,100348
2015-05-27,91355,315,0,2786,8584,103040
2015-05-28,101857,669,0,4949,10873,118348
2015-05-29,152362,1003,404,7308,7618,168695
2015-05-30,189427,693,292,9189,20037,219638
2015-05-31,140486,346,4,6096,10644,157576
2015-06-01,122789,1046,91,6459,8358,138743
2015-06-02,114866,374,192,2524,9550,127506
2015-06-03,161273,701,284,7170,10267,179695
2015-06-04,203520,754,67,11443,11556,227340
2015-06-05,181568,766,104,7737,7585,197760
2015-06-06,196123,303,129,11796,21574,229925
2015-06-07,198027,902,25,11423,11893,222270
2015-06-08,125485,649,260,684,8712,135790
2015-06-09,108917,719,149,4857,9765,124407
2015-06-10,120491,409,402,4208,10119,135629
2015-06-11,120201,724,0,4475,12297,137697
2015-06-12,199569,1271,361,9060,8806,219067
2015-06-13,222515,744,140,8127,23706,255232
2015-06-14,186739,354,127,5593,12009,204822
2015-06-15,126123,149,141,4758,9518,140689
2015-06-16,117772,562,0,2545,9904,130783
2015-06-17,134079,335,219,5608,11322,151563
2015-06-18,137371,939,82,8583,12013,158988
2015-06-19,172860,470,325,6560,10537,190752
2015-06-20,253279,681,134,4749,24948,283791
2015-06-21,208345,1385,0,10712,13793,234235
2015-06-22,153035,915,531,3663,9680,167824
2015-06-23,118574,1407,124,8236,12500,140841
2015-06-24,190127,1047,118,3705,13032,208029
2015-06-25,209067,936,548,8162,12382,231095
2015-06-26,223159,1595,182,8795,9977,243708
2015-06-27,285016,1182,0,8240,29598,324036
2015-06-28,239357,1186,79,6342,15614,262578
2015-06-29,183157,1157,275,6982,11373,202944
2015-06-30,154557,1514,375,2422,13989,172857
2015-07-01,181278,1081,7,8585,15975,206926
2015-07-02,178537,979,303,11736,15756,207311
2015-07-03,276510,1544,112,6487,14187,298840
2015-07-04,348164,1057,0,8946,28769,386936
2015-07-05,284000,2250,258,10919,16396,313823
2015-07-06,204974,1323,319,5677,13020,225313
2015-07-07,171919,1708,2,1108,14500,189237
2015-07-08,174888,1766,151,5703,16332,198840
2015-07-09,171317,1727,333,8477,17577,199431
2015-07-10,271275,1519,283,9891,13763,296731
2015-07-11,413022,1347,0,9549,27957,451875
2015-07-12,322072,2150,128,11726,19094,355170
2015-07-13,217675,1770,85,3882,14419,237831
2015-07-14,191522,2367,0,3321,16414,213624
2015-07-15,208874,1526,304,6878,17370,234952
2015-07-16,247966,1580,0,9532,18038,277116
2015-07-17,333437,1867,128,8675,13150,357257
2015-07-18,468070,2416,297,13137,29453,513373
2015-07-19,372631,2534,0,13382,17940,406487
2015-07-20,265596,2169,180,4036,14270,286251
2015-07-21,216168,2300,0,8665,16561,243694
2015-07-22,216726,1551,0,5387,17057,240721
2015-07-23,240344,2504,119,8496,11659,263122
2015-07-24,339551,248,185,5530,12403,357917
2015-07-25,518306,1830,290,14070,29670,564166
2015-07-26,333735,2543,157,7610,18851,362896
2015-07-27,277365,1423,141,6988,13656,299573
2015-07-28,217551,2026,0,2001,15470,237048
2015-07-29,217170,1575,279,9070,12822,240916
2015-07-30,277859,1806,0,8465,16069,304199
2015-07-31,425337,1890,0,8896,13378,449501
2015-08-01,637947,1571,124,13141,30887,683670
2015-08-02,434402,1706,241,16640,19120,472109
2015-08-03,318627,1991,185,5143,14594,340540
2015-08-04,234921,1850,318,6885,15199,259173
2015-08-05,259541,1579,155,3719,15700,280694
2015-08-06,275977,1776,129,9476,16524,303882
2015-08-07,419337,1962,333,11182,13148,445962
2015-08-08,590254,2260,0,14657,27615,634786
2015-08-09,410387,2361,241,9716,16517,439222
2015-08-10,336398,1914,0,9075,12945,360332
2015-08-11,265018,2060,544,5292,13844,286758
2015-08-12,253219,869,0,8511,14515,277114
2015-08-13,284113,2083,0,10017,14795,311008
2015-08-14,354090,2336,194,8250,12498,377368
2015-08-15,511215,2082,138,15443,26236,555114
2015-08-16,383963,2870,0,15294,16279,418406
2015-08-17,294696,2124,184,8211,11395,316610
2015-08-18,228110,2777,166,3996,12978,248027
2015-08-19,236041,1797,0,5184,13311,256333
2015-08-20,292218,1120,0,10583,14071,317992
2015-08-21,354347,2374,454,12220,11367,380762
2015-08-22,467090,1730,84,11228,25481,505613
2015-08-23,338859,1841,0,7295,15482,363477
2015-08-24,269935,951,357,11067,10282,292592
2015-08-25,216003,1413,125,1993,11415,230949
2015-08-26,210497,1265,146,9739,12189,233836
2015-08-27,240633,1100,0,6794,14214,262741
2015-08-28,331459,1477,106,6871,9655,349568
2015-08-29,404830,1315,0,8279,25098,439522
2015-08-30,317203,1347,0,15572,14585,348707
2015-08-31,215413,1152,284,6201,10448,233498
2015-09-01,184343,1056,0,5534,12024,202957
2015-09-02,157706,1262,132,2509,12616,174225
2015-09-03,179553,1055,423,9972,13567,204570
2015-09-04,230700,1092,182,10359,10732,253065
2015-09-05,279992,1945,107,8840,25704,316588
2015-09-06,189964,1295,0,4506,13653,209418
2015-09-07,161520,907,0,4665,9281,176373
2015-09-08,131893,723,0,4564,11290,148470
2015-09-09,142277,1345,117,5503,10904,160146
2015-09-10,147233,862,267,6920,12427,167709
2015-09-11,203568,1341,86,5550,8346,218891
2015-09-12,212203,1092,277,7180,23823,244575
2015-09-13,179436,849,115,10340,11818,202558
2015-09-14,123077,852,322,873,9123,134247
2015-09-15,116128,751,65,2454,10696,130094
2015-09-16,120039,900,282,2736,10703,134660
2015-09-17,128055,479,137,4636,11422,144729
2015-09-18,168280,136,184,9840,8038,186478
2015-09-19,169818,174,0,8667,23351,202010
2015-09-20,132889,21,183,4851,11484,149428
2015-09-21,107323,14,118,4545,8014,120014
2015-09-22,90623,17,0,7409,8571,106620
2015-09-23,106658,23,84,11833,8673,127271
2015-09-24,99812,16,0,5212,9906,114946
2015-09-25,132972,75,298,9737,7614,150696
2015-09-26,135832,42,279,6823,19312,162288
2015-09-27,138785,21,147,11335,9219,159507
2015-09-28,92768,10,173,5043,7225,105219
2015-09-29,88923,88,0,2951,6953,98915
2015-09-30,95985,13,139,4976,7060,108173
2015-10-01,101760,11,83,5501,9379,116734
2015-10-02,118094,22,361,8208,7095,133780
2015-10-03,131411,148,0,7736,14323,153618
2015-10-04,113575,89,0,4030,8540,126234
2015-10-05,88053,293,115,4263,6379,99103
2015-10-06,76605,222,114,2968,5844,85753
2015-10-07,82808,290,0,4811,5825,93734
2015-10-08,100561,284,0,4322,7684,112851
2015-10-09,116711,447,0,14857,5228,137243
2015-10-10,107845,329,52,6151,11732,126109
2015-10-11,109022,579,0,7057,7132,123790
2015-10-12,84899,414,439,1473,6451,93676
2015-10-13,70851,513,83,3213,4980,79640
2015-10-14,74240,400,419,2114,5655,82828
2015-10-15,84467,267,0,4930,6536,96200
2015-10-16,115803,275,180,8230,4836,129324
2015-10-17,109069,209,394,9756,10573,130001
2015-10-18,106955,112,0,2904,5371,115342
2015-10-19,77784,56,0,4294,5114,87248
2015-10-20,73720,39,91,1278,4108,79236
2015-10-21,74135,43,72,5316,4918,84484
2015-10-22,96579,35,410,4094,4972,106090
2015-10-23,135825,177,231,3298,4063,143594
2015-10-24,127148,27,0,6473,7227,140875
2015-10-25,110815,231,0,4641,3549,119236
2015-10-26,96069,31,283,1341,2923,100647
2015-10-27,77713,185,0,2202,2515,82615
2015-10-28,81139,28,136,38,2430,83771
2015-10-29,86415,47,0,4709,2880,94051
2015-10-30,119648,90,178,3246,2692,125854
2015-10-31,121199,303,0,6660,2497,130659
2015-11-01,108469,300,0,2281,2510,113560
2015-11-02,77820,166,200,2121,2248,82555
2015-11-03,72614,310,152,1141,1737,75954
2015-11-04,75526,325,0,7697,1806,85354
2015-11-05,80632,251,0,3255,2228,86366
2015-11-06,105696,408,135,4762,2032,113033
2015-11-07,100306,236,141,3018,1630,105331
2015-11-08,100872,280,0,5998,1719,108869
2015-11-09,67801,275,0,2156,1768,72000
2015-11-10,67036,180,0,1040,2016,70272
2015-11-11,72567,253,0,1,1863,74684
2015-11-12,76291,366,0,2054,1993,80704
2015-11-13,91881,223,0,4342,1872,98318
2015-11-14,95861,153,0,3676,1274,100964
2015-11-15,86193,280,0,4268,2143,92884
2015-11-16,65694,201,150,14,1784,67843
2015-11-17,80379,236,0,214,1610,82439
2015-11-18,69161,187,0,421,2193,71962
2015-11-19,72408,241,0,2077,1848,76574
2015-11-20,89787,179,0,2440,2088,94494
2015-11-21,78449,209,0,2753,1544,82955
2015-11-22,82770,226,0,1699,1460,86155
2015-11-23,62445,244,0,0,1639,64328
2015-11-24,59541,315,0,927,1203,61986
2015-11-25,66422,191,0,47,1476,68136
2015-11-26,64309,113,0,2209,1586,68217
2015-11-27,86595,234,0,1929,1312,90070
2015-11-28,77814,226,0,955,786,79781
2015-11-29,75000,186,0,3,1518,76707
2015-11-30,64043,171,0,49,1521,65784
2015-12-01,59427,184,0,112,1225,60948
2015-12-02,65106,409,0,13,1188,66716
2015-12-03,63055,218,0,1,998,64272
2015-12-04,94298,230,0,0,1482,96010
2015-12-05,85735,323,0,230,927,87215
2015-12-06,74861,253,0,6,1347,76467
2015-12-07,58067,170,0,2,1236,59475
2015-12-08,65725,156,0,43,1652,67576
2015-12-09,66844,153,0,30,1637,68664
2015-12-10,63691,241,0,28,1112,65072
2015-12-11,81478,196,0,11,1456,83141
2015-12-12,80450,187,0,90,625,81352
2015-12-13,78525,337,0,12,1207,80081
2015-12-14,61563,250,0,5,1311,63129
2015-12-15,65708,213,0,140,1221,67282
2015-12-16,78794,274,0,12,1915,80995
2015-12-17,80626,268,0,0,1213,82107
2015-12-18,131072,385,0,121,1960,133538
2015-12-19,164129,513,0,90,1542,166274
2015-12-20,109070,444,0,7,1975,111496
2015-12-21,94316,310,0,50,2165,96841
2015-12-22,108870,304,0,133,1429,110736
2015-12-23,183741,366,0,0,2418,186525
2015-12-24,160228,340,0,2,1335,161905
2015-12-25,95732,391,0,0,484,96607
2015-12-26,103069,580,0,45,1956,105650
2015-12-27,112157,714,0,23,1995,114889
2015-12-28,96266,371,0,9,2143,98789
2015-12-29,106129,706,0,304,2067,109206
2015-12-30,147554,799,0,3,1967,150323
2015-12-31,88384,624,0,255,685,89948
2016-01-01,69985,542,0,56,590,71173
2016-01-02,131634,496,0,11,1183,133324
2016-01-03,124442,551,0,7,1576,126576
2016-01-04,85761,641,0,41,1232,87675
2016-01-05,94930,426,0,83,1027,96466
2016-01-06,89049,485,0,0,1203,90737
2016-01-07,83679,396,0,5,760,84840
2016-01-08,110032,467,0,5,885,111389
2016-01-09,146250,434,0,83,910,147677
2016-01-10,128612,406,0,2,1279,130299
2016-01-11,77553,449,0,37,1073,79112
2016-01-12,63791,348,0,92,870,65101
2016-01-13,70338,485,0,0,1043,71866
2016-01-14,69517,427,0,0,970,70914
2016-01-15,84272,403,5,7,947,85634
2016-01-16,82787,470,0,68,674,83999
2016-01-17,72028,414,0,2,1261,73705
2016-01-18,56770,362,0,2,1592,58726
2016-01-19,57084,371,0,55,1062,58572
2016-01-20,58422,346,0,3,1064,59835
2016-01-21,62274,400,0,0,1786,64460
2016-01-22,72818,318,0,18,998,74152
2016-01-23,76713,344,0,326,568,77951
2016-01-24,69727,294,0,1,1312,71334
2016-01-25,56809,245,0,1,1304,58359
2016-01-26,53025,440,0,59,1151,54675
2016-01-27,57705,257,3,48,1226,59239
2016-01-28,60447,263,0,24,1002,61736
2016-01-29,79964,441,0,3,1247,81655
2016-01-30,79412,330,0,76,802,80620
2016-01-31,71150,347,0,0,543,72040
2016-02-01,56486,367,0,24,1189,58066
2016-02-02,57319,503,0,57,1148,59027
2016-02-03,59630,385,0,50,1162,61227
2016-02-04,63909,380,0,12,860,65161
2016-02-05,84637,453,0,167,1436,86693
2016-02-06,82703,400,0,89,966,84158
2016-02-07,72342,294,0,41,1298,73975
2016-02-08,65700,90,0,393,1829,68012
2016-02-09,58520,367,0,82,1277,60246
2016-02-10,58627,454,0,4,1627,60712
2016-02-11,64167,299,0,15,1411,65892
2016-02-12,86112,648,0,17,1019,87796
2016-02-13,89063,321,0,51,1095,90530
2016-02-14,77517,279,0,1,1304,79101
2016-02-15,61898,390,0,1,1855,64144
2016-02-16,63241,426,0,81,1470,65218
2016-02-17,60468,477,0,1,1777,62723
2016-02-18,67495,362,0,3,1188,69048
2016-02-19,81857,361,0,2,1279,83499
2016-02-20,85966,465,0,53,1104,87588
2016-02-21,82989,399,0,0,1151,84539
2016-02-22,60053,257,0,47,2092,62449
2016-02-23,60441,312,0,86,1594,62433
2016-02-24,65278,183,0,31,1546,67038
2016-02-25,66221,421,0,12,1604,68258
2016-02-26,84326,380,0,25,1378,86109
2016-02-27,78297,672,0,66,1059,80094
2016-02-28,82021,341,0,16,1478,83856
2016-02-29,62333,402,0,0,1898,64633
2016-03-01,64876,294,0,182,1147,66499
2016-03-02,66956,325,0,23,1480,68784
2016-03-03,70084,305,0,50,1475,71914
2016-03-04,83793,249,0,384,1806,86232
2016-03-05,81297,251,0,84,1473,83105
2016-03-06,85198,318,0,10,1867,87393
2016-03-07,61507,399,0,7,2124,64037
2016-03-08,60126,440,0,437,1721,62724
2016-03-09,68055,251,0,336,2122,70764
2016-03-10,73275,375,0,11,1667,75328
2016-03-11,94165,446,0,47,2199,96857
2016-03-12,90141,364,0,423,1446,92374
2016-03-13,85110,326,0,4,1753,87193
2016-03-14,68008,359,0,66,1959,70392
2016-03-15,62226,409,0,1076,1753,65464
2016-03-16,69964,371,0,16,2108,72459
2016-03-17,77668,312,0,33,1896,79909
2016-03-18,109576,404,0,387,2449,112816
2016-03-19,132432,396,0,991,2189,136008
2016-03-20,102278,303,0,63,3009,105653
2016-03-21,76016,393,0,432,3084,79925
2016-03-22,78792,451,0,111,1964,81318
2016-03-23,88060,541,0,2361,2800,93762
2016-03-24,133354,572,0,2984,2708,139618
2016-03-25,211848,789,0,233,3050,215920
2016-03-26,129856,670,0,3434,2569,136529
2016-03-27,117059,545,0,3067,2567,123238
2016-03-28,149777,529,0,1789,2914,155009
2016-03-29,98174,445,0,662,3648,102929
2016-03-30,79353,408,0,278,2986,83025
2016-03-31,82712,488,146,2930,2328,88604
2016-04-01,110843,453,143,3443,3065,117947
2016-04-02,117081,404,147,4176,4769,126577
2016-04-03,102968,463,114,2954,3691,110190
2016-04-04,73261,319,0,893,3923,78396
2016-04-05,68687,389,109,1539,3660,74384
2016-04-06,70859,488,0,1991,3472,76810
2016-04-07,79758,487,0,3144,2807,86196
2016-04-08,103200,557,45,3181,2968,109951
2016-04-09,102776,392,133,2777,5421,111499
2016-04-10,94892,408,126,5074,4171,104671
2016-04-11,75743,487,194,2653,3784,82861
2016-04-12,71842,438,293,517,3551,76641
2016-04-13,74144,469,133,744,3310,78800
2016-04-14,80389,473,98,3063,3600,87623
2016-04-15,116977,664,702,6112,3658,128113
2016-04-16,113703,506,117,4205,6783,125314
2016-04-17,103443,595,116,2188,4604,110946
2016-04-18,75534,455,55,2564,3801,82409
2016-04-19,5593,3,182,0,0,5778
2016-04-20,80452,355,0,3206,2930,86943
2016-04-21,83369,324,86,2604,4838,91221
2016-04-22,121402,419,101,3205,3891,129018
2016-04-23,116607,457,0,5914,7043,130021
2016-04-24,101469,598,0,2388,5339,109794
2016-04-25,98274,418,0,2094,4524,105310
2016-04-26,99613,559,117,570,4738,105597
2016-04-27,114714,423,318,2055,5495,123005
2016-04-28,128014,633,0,2540,6622,137809
2016-04-29,181828,678,176,3490,6079,192251
2016-04-30,165601,513,0,4934,13176,184224
2016-05-01,105314,561,100,2165,8468,116608
2016-05-02,125179,512,271,401,6013,132376
2016-05-03,102019,477,0,7383,8033,117912
2016-05-04,119165,596,124,3130,8521,131536
2016-05-05,141823,718,101,4035,10837,157514
2016-05-06,126400,586,0,5503,6031,138520
2016-05-07,138334,533,485,3148,13050,155550
2016-05-08,152775,684,0,3598,8500,165557
2016-05-09,90171,580,0,3262,6079,100092
2016-05-10,79397,432,0,229,7374,87432
2016-05-11,86957,454,322,2915,7584,98232
2016-05-12,95037,975,0,12370,9906,118288
2016-05-13,148025,568,110,5182,6786,160671
2016-05-14,153465,616,355,4925,17676,177037
2016-05-15,126529,1154,112,7347,11801,146943
2016-05-16,119991,603,295,225,7430,128544
2016-05-17,93922,642,151,4213,8428,107356
2016-05-18,96327,656,80,4092,9239,110394
2016-05-19,101255,551,27,6689,10432,118954
2016-05-20,143567,683,93,8344,8360,161047
2016-05-21,160731,535,484,6855,19396,188001
2016-05-22,144711,779,0,7828,11720,165038
2016-05-23,99588,478,273,7771,7256,115366
2016-05-24,85750,527,416,4826,10158,101677
2016-05-25,141329,799,0,2307,10270,154705
2016-05-26,172255,689,259,12443,13088,198734
2016-05-27,151518,800,78,5784,7256,165436
2016-05-28,170493,494,0,4344,21737,197068
2016-05-29,153018,724,107,10470,13183,177502
2016-05-30,102379,894,163,95,8832,112363
2016-05-31,90854,569,343,4282,11057,107105
2016-06-01,119098,625,168,3894,11678,135463
2016-06-02,144394,584,100,9265,14140,168483
2016-06-03,164108,679,68,6656,9342,180853
2016-06-04,189350,561,194,3273,21925,215303
2016-06-05,152299,797,295,5001,14147,172539
2016-06-06,120253,720,0,5257,9890,136120
2016-06-07,110400,628,74,1202,10233,122537
2016-06-08,116358,573,873,2776,12032,132612
2016-06-09,121251,766,145,6018,15081,143261
2016-06-10,172499,827,255,8042,9759,191382
2016-06-11,204917,907,0,4378,22856,233058
2016-06-12,157319,775,151,12741,14448,185434
2016-06-13,122352,780,155,412,8494,132193
2016-06-14,109629,1367,268,8727,12220,132211
2016-06-15,130743,786,119,9349,13404,154401
2016-06-16,152807,883,0,5437,14761,173888
2016-06-17,215734,1149,0,11583,10545,239011
2016-06-18,261211,742,344,4092,26089,292478
2016-06-19,208561,1560,257,6188,16790,233356
2016-06-20,147754,886,113,6861,12007,167621
2016-06-21,123382,856,4,1964,13321,139527
2016-06-22,138247,818,265,4348,16550,160228
2016-06-23,174602,1048,203,7072,18030,200955
2016-06-24,244347,1590,554,6794,8508,261793
2016-06-25,309296,1026,362,10041,27870,348595
2016-06-26,231540,1597,0,11427,20294,264858
2016-06-27,170240,1244,394,1136,14479,187493
2016-06-28,142914,1125,488,3632,13323,161482
2016-06-29,147913,954,0,3049,17144,169060
2016-06-30,184166,1333,47,10590,21598,217734
2016-07-01,294609,1641,101,8678,15227,320256
2016-07-02,375749,1318,599,4929,21972,404567
2016-07-03,266894,1752,0,8746,21334,298726
2016-07-04,194557,1368,69,10358,16474,222826
2016-07-05,177144,1665,342,1955,17854,198960
2016-07-06,177777,1213,263,2250,21075,202578
2016-07-07,204338,1410,28,7984,21172,234932
2016-07-08,287732,2319,122,7672,15469,313314
2016-07-09,423367,1473,123,8936,30812,464711
2016-07-10,345900,2650,151,11530,15994,376225
2016-07-11,240731,2219,212,4306,17306,264774
2016-07-12,169591,2794,342,5788,19497,198012
2016-07-13,194376,1703,0,5922,23195,225196
2016-07-14,222155,1844,150,14978,22238,261365
2016-07-15,303757,2568,205,5368,14853,326751
2016-07-16,415029,1920,201,9616,30446,457212
2016-07-17,333058,2242,99,8809,22657,366865
2016-07-18,260859,1938,90,4570,9557,277014
2016-07-19,214667,2622,0,6494,20479,244262
2016-07-20,217196,1851,136,2632,22075,243890
2016-07-21,255103,2062,0,8579,22383,288127
2016-07-22,371882,2612,0,11062,13138,398694
2016-07-23,471733,2150,0,8854,30441,513178
2016-07-24,333878,2852,0,13200,22164,372094
2016-07-25,284131,1970,82,7715,17015,310913
2016-07-26,207879,2319,138,3983,18658,232977
2016-07-27,209338,1822,127,4078,21904,237269
2016-07-28,243862,1798,249,9851,21475,277235
2016-07-29,377675,1767,130,8286,15160,403018
2016-07-30,540480,2393,294,11763,23525,578455
2016-07-31,397330,2742,0,14110,23373,437555
2016-08-01,332656,1628,0,11339,17023,362646
2016-08-02,244352,1807,0,3177,15381,264717
2016-08-03,257471,1578,0,9048,21553,289650
2016-08-04,275614,1947,229,12785,20987,311562
2016-08-05,388125,2235,0,14010,14825,419195
2016-08-06,510729,1392,308,13347,29205,554981
2016-08-07,422353,2331,0,11944,20543,457171
2016-08-08,306148,1951,0,4017,15281,327397
2016-08-09,249814,1746,495,6375,16647,275077
2016-08-10,274002,1256,0,3434,18567,297259
2016-08-11,330698,1391,228,13106,18733,364156
2016-08-12,385002,2297,100,11488,13831,412718
2016-08-13,510359,1658,277,9961,29382,551637
2016-08-14,389737,2263,0,16054,20073,428127
2016-08-15,397535,1614,0,7975,13248,420372
2016-08-16,274549,2053,174,3144,17180,297100
2016-08-17,242288,1903,0,4043,18075,266309
2016-08-18,275267,1762,108,12912,17880,307929
2016-08-19,347104,2446,164,13409,11950,375073
2016-08-20,467241,1979,54,9189,29107,507570
2016-08-21,367444,2107,0,13632,18937,402120
2016-08-22,291041,1573,192,4672,12245,309723
2016-08-23,259768,2046,704,6919,14870,284307
2016-08-24,240717,1498,143,6539,16605,265502
2016-08-25,277272,1253,0,12086,10463,301074
2016-08-26,346506,1530,352,5059,11616,365063
2016-08-27,462261,1143,148,9165,26152,498869
2016-08-28,331624,997,0,14948,16767,364336
2016-08-29,249606,1251,173,7382,10938,269350
2016-08-30,210480,1127,0,2072,12490,226169
2016-08-31,230920,1262,84,3135,15012,250413
2016-09-01,195389,816,202,10295,17964,224666
2016-09-02,243544,1687,137,11829,11868,269065
2016-09-03,301540,1520,0,6228,27228,336516
2016-09-04,271264,963,0,7158,17396,296781
2016-09-05,165361,791,251,7975,11817,186195
2016-09-06,141391,1225,146,3118,12307,158187
2016-09-07,151069,811,241,5657,15644,173422
2016-09-08,149088,601,0,7903,15391,172983
2016-09-09,211907,1034,0,6621,11399,230961
2016-09-10,255602,796,181,6008,25344,287931
2016-09-11,197247,684,0,8299,17421,223651
2016-09-12,144325,812,187,7261,10614,163199
2016-09-13,129892,679,308,5161,12557,148597
2016-09-14,136634,854,34,3614,10686,151822
2016-09-15,144050,678,291,10779,15581,171379
2016-09-16,170436,1073,0,9128,10153,190790
2016-09-17,174351,935,334,10007,23835,209462
2016-09-18,162087,936,0,8007,15633,186663
2016-09-19,139083,818,0,3163,9593,152657
2016-09-20,107207,1011,447,7817,9919,126401
2016-09-21,111785,1103,0,3672,11197,127757
2016-09-22,123350,701,155,6716,13410,144332
2016-09-23,150412,870,102,5649,9468,166501
2016-09-24,186558,949,476,5583,21601,215167
2016-09-25,154388,712,0,12471,8945,176516
2016-09-26,105875,988,290,8717,8674,124544
2016-09-27,113005,699,179,4984,7914,126781
2016-09-28,107979,582,149,2918,10471,122099
2016-09-29,116086,600,0,6828,11705,135219
2016-09-30,154321,1023,136,9254,9506,174240
2016-10-01,134695,670,0,10789,13401,159555
2016-10-02,124638,598,87,8835,11194,145352
2016-10-03,111473,720,101,2341,7558,122193
2016-10-04,85624,555,440,1858,6550,95027
2016-10-05,101316,756,255,4229,8370,114926
2016-10-06,105529,693,0,11203,9302,126727
2016-10-07,124767,525,102,3510,5733,134637
2016-10-08,133638,648,0,7993,14335,156614
2016-10-09,137593,552,0,7501,9472,155118
2016-10-10,81125,644,248,6090,6896,95003
2016-10-11,81669,751,0,4800,6324,93544
2016-10-12,83432,547,693,2046,7232,93950
2016-10-13,100466,420,312,6560,8275,116033
2016-10-14,111528,865,0,7866,5262,125521
2016-10-15,116194,682,0,8932,12767,138575
2016-10-16,121129,607,0,4595,8403,134734
2016-10-17,86717,657,239,3300,6911,97824
2016-10-18,74776,565,73,2628,5676,83718
2016-10-19,82456,438,0,4044,6479,93417
2016-10-20,90741,759,139,6669,8003,106311
2016-10-21,121365,772,0,3332,5137,130606
2016-10-22,119369,601,322,5786,10762,136840
2016-10-23,108293,546,325,3306,6782,119252
2016-10-24,81458,701,0,4120,4964,91243
2016-10-25,65408,539,95,1450,2935,70427
2016-10-26,96139,515,0,223,3704,100581
2016-10-27,91555,494,0,6293,2881,101223
2016-10-28,156528,444,0,3231,4723,164926
2016-10-29,168809,861,178,6342,4789,180979
2016-10-30,120702,629,0,7490,915,129736
2016-10-31,103764,591,0,931,2443,107729
2016-11-01,123278,937,177,3628,1931,129951
2016-11-02,96480,690,142,8622,1385,107319
2016-11-03,80478,498,213,6283,1098,88570
2016-11-04,100487,448,0,5100,1901,107936
2016-11-05,93347,779,188,3518,1148,98980
2016-11-06,84743,649,0,3955,1060,90407
2016-11-07,65563,493,0,1973,860,68889
2016-11-08,68286,409,186,532,1244,70657
2016-11-09,77457,427,0,3,996,78883
2016-11-10,80127,664,0,2808,829,84428
2016-11-11,94739,445,0,3712,280,99176
2016-11-12,89342,427,0,3814,2203,95786
2016-11-13,86506,466,0,4891,1964,93827
2016-11-14,66216,182,0,32,11,66441
2016-11-15,63891,578,0,105,1485,66059
2016-11-16,72143,541,0,1213,1861,75758
2016-11-17,75051,603,142,2230,2196,80222
2016-11-18,93771,572,0,2054,186,96583
2016-11-19,81330,445,0,3378,1504,86657
2016-11-20,77638,412,0,2945,2112,83107
2016-11-21,73355,552,0,0,2084,75991
2016-11-22,67433,411,0,166,1925,69935
2016-11-23,74966,439,0,309,2065,77779
2016-11-24,75350,405,0,2957,2273,80985
2016-11-25,98763,558,0,85,2498,101904
2016-11-26,87973,1059,0,2605,1641,93278
2016-11-27,82928,494,0,4051,1893,89366
2016-11-28,66948,368,0,0,2227,69543
2016-11-29,62849,374,0,1942,1649,66814
2016-11-30,67313,389,0,35,1837,69574
2016-12-01,70809,502,0,109,1899,73319
2016-12-02,126385,487,0,239,2408,129519
2016-12-03,87040,447,0,72,1493,89052
2016-12-04,77108,277,0,3,2194,79582
2016-12-05,63118,568,0,374,1314,65374
2016-12-06,73439,538,0,330,1361,75668
2016-12-07,77123,541,0,9,2201,79874
2016-12-08,84403,420,0,125,1920,86868
2016-12-09,91183,361,0,48,1983,93575
2016-12-10,92102,544,0,1009,1327,94982
2016-12-11,89750,503,0,859,2450,93562
2016-12-12,66233,424,0,1975,1849,70481
2016-12-13,61944,442,0,82,1178,63646
2016-12-14,70690,342,0,5,2255,73292
2016-12-15,76436,600,0,940,2249,80225
2016-12-16,109450,339,0,48,2284,112121
2016-12-17,127940,864,0,138,3232,132174
2016-12-18,102183,670,0,0,2846,105699
2016-12-19,79706,512,0,0,2604,82822
2016-12-20,87195,480,0,140,2634,90449
2016-12-21,95526,396,0,74,1736,97732
2016-12-22,150715,543,0,119,2426,153803
2016-12-23,208870,802,0,41,3008,212721
2016-12-24,174943,714,0,265,2152,178074
2016-12-25,84342,479,0,0,540,85361
2016-12-26,108503,1854,0,24,1977,112358
2016-12-27,107218,1285,0,26,450,108979
2016-12-28,107746,636,0,69,2026,110477
2016-12-29,126336,2814,0,225,2030,131405
2016-12-30,158305,876,0,4,2115,161300
2016-12-31,91044,659,0,363,976,93042
2017-01-01,88874,1238,0,40,690,90842
2017-01-02,117912,1822,0,11,1650,121395
2017-01-03,99822,696,0,0,1621,102139
2017-01-04,104947,521,0,85,1170,106723
2017-01-05,112619,696,0,57,1192,114564
2017-01-06,103275,490,0,0,809,104574
2017-01-07,127739,597,0,32,794,129162
2017-01-08,144980,629,0,14,1219,146842
2017-01-09,93902,808,0,2,1630,96342
2017-01-10,77798,286,0,0,1124,79208
2017-01-11,77771,548,0,149,1200,79668
2017-01-12,78061,345,0,106,1717,80229
2017-01-13,80919,436,0,0,1033,82388
2017-01-14,87046,447,0,62,728,88283
2017-01-15,80127,669,0,12,1229,82037
2017-01-16,58042,523,0,0,1228,59793
2017-01-17,50959,255,0,0,1259,52473
2017-01-18,52919,285,0,0,1478,54682
2017-01-19,65033,411,0,41,1576,67061
2017-01-20,72698,382,0,6,1462,74548
2017-01-21,75107,467,0,129,846,76549
2017-01-22,72877,395,0,0,1576,74848
2017-01-23,58575,353,0,16,1303,60247
2017-01-24,56229,377,0,0,1401,58007
2017-01-25,62771,242,0,68,1104,64185
2017-01-26,62483,258,0,0,1337,64078
2017-01-27,82008,305,0,53,1481,83847
2017-01-28,74728,320,0,108,1096,76252
2017-01-29,70895,375,0,2,1615,72887
2017-01-30,56346,383,0,0,1398,58127
2017-01-31,59825,232,0,9,1436,61502
2017-02-01,57284,382,0,97,1159,58922
2017-02-02,64864,485,0,41,459,65849
2017-02-03,84452,574,0,0,962,85988
2017-02-04,76855,265,0,81,845,78046
2017-02-05,71310,294,0,51,2012,73667
2017-02-06,58601,265,0,0,1285,60151
2017-02-07,60182,282,0,0,987,61451
2017-02-08,67925,322,0,46,1249,69542
2017-02-09,68630,338,0,0,1699,70667
2017-02-10,86859,274,0,0,1968,89101
2017-02-11,82427,465,0,104,958,83954
2017-02-12,80325,321,0,50,1946,82642
2017-02-13,66464,307,0,40,2147,68958
2017-02-14,68483,516,0,15,1778,70792
2017-02-15,73661,377,0,85,1522,75645
2017-02-16,73794,332,0,0,1307,75433
2017-02-17,96949,282,0,0,1569,98800
2017-02-18,92478,622,0,174,1316,94590
2017-02-19,93085,449,0,2,1678,95214
2017-02-20,68082,756,0,94,1356,70288
2017-02-21,66409,363,0,0,1862,68634
2017-02-22,71446,463,0,0,1747,73656
2017-02-23,76617,435,0,54,2062,79168
2017-02-24,95265,386,0,65,2026,97742
2017-02-25,93834,282,0,152,1280,95548
2017-02-26,94912,690,0,38,2077,97717
2017-02-27,73374,637,0,1,1748,75760
2017-02-28,67098,616,6,103,1654,69477
2017-03-01,76158,415,0,152,1810,78535
2017-03-02,77676,464,0,48,1964,80152
2017-03-03,100626,477,0,3,1836,102942
2017-03-04,89519,362,0,182,936,90999
2017-03-05,89792,357,0,381,2300,92830
2017-03-06,66990,510,0,15,2168,69683
2017-03-07,64540,410,0,2,1913,66865
2017-03-08,73899,529,0,155,1772,76355
2017-03-09,77313,360,0,359,1996,80028
2017-03-10,102122,449,0,1,2603,105175
2017-03-11,94729,382,0,186,1008,96305
2017-03-12,98591,352,0,7,2687,101637
2017-03-13,70260,338,0,41,1798,72437
2017-03-14,67157,423,0,849,1957,70386
2017-03-15,71231,334,0,177,1153,72895
2017-03-16,81039,364,0,362,1922,83687
2017-03-17,108603,530,0,20,2125,111278
2017-03-18,97011,399,144,469,1488,99511
2017-03-19,96772,459,0,964,1997,100192
2017-03-20,73600,510,140,902,2166,77318
2017-03-21,68823,576,0,5,1926,71330
2017-03-22,75890,393,1,87,1720,78091
2017-03-23,81846,387,0,8,1683,83924
2017-03-24,98606,572,0,21,2407,101606
2017-03-25,101441,433,180,1026,1529,104609
2017-03-26,88566,354,0,911,1008,90839
2017-03-27,73668,433,0,60,5157,79318
2017-03-28,70314,435,0,15,4353,75117
2017-03-29,76587,363,84,690,1994,79718
2017-03-30,83520,454,0,24,1438,85436
2017-03-31,110251,350,0,948,1994,113543
2017-04-01,118167,335,145,2815,7207,128669
2017-04-02,102002,398,0,963,1914,105277
2017-04-03,80596,442,0,57,1308,82403
2017-04-04,72157,393,180,212,2962,75904
2017-04-05,81142,451,119,2191,5068,88971
2017-04-06,90986,362,0,2283,6344,99975
2017-04-07,132303,431,337,4500,3385,140956
2017-04-08,149327,359,180,5943,9576,165385
2017-04-09,122487,444,0,236,8136,131303
2017-04-10,91115,303,0,69,6206,97693
2017-04-11,89294,318,110,2223,4724,96669
2017-04-12,110795,341,96,1961,6894,120087
2017-04-13,162510,407,0,520,7620,171057
2017-04-14,244312,679,0,5427,5742,256160
2017-04-15,131559,333,0,3370,9073,144335
2017-04-16,118353,289,0,276,4387,123305
2017-04-17,155093,408,510,820,2995,159826
2017-04-18,117106,444,181,3014,6866,127611
2017-04-19,95131,369,141,349,6390,102380
2017-04-20,95237,544,171,4077,4304,104333
2017-04-21,132916,410,256,5257,2473,141312
2017-04-22,161105,454,360,8454,10536,180909
2017-04-23,120113,400,156,575,5203,126447
2017-04-24,97171,217,92,2538,5665,105683
2017-04-25,96805,356,0,2519,6735,106415
2017-04-26,119962,271,151,360,7261,128005
2017-04-27,133087,449,130,1725,8074,143465
2017-04-28,186298,430,398,6972,5051,199149
2017-04-29,220771,682,109,8267,15199,245028
2017-04-30,145473,494,0,1924,9393,157284
2017-05-01,127539,356,271,884,4251,133301
2017-05-02,121504,302,182,2225,6762,130975
2017-05-03,106614,422,0,3900,8073,119009
2017-05-04,99586,276,0,3587,3152,106601
2017-05-05,118699,244,124,7341,3303,129711
2017-05-06,130475,329,323,8852,13637,153616
2017-05-07,111247,449,388,1609,8641,122334
2017-05-08,93672,429,131,1496,3178,98906
2017-05-09,83366,227,0,1099,4383,89075
2017-05-10,91305,294,362,2242,7007,101210
2017-05-11,94869,787,270,3323,9394,108643
2017-05-12,113058,344,0,10117,3135,126654
2017-05-13,119775,423,145,7972,10246,138561
2017-05-14,110777,487,0,1072,10378,122714
2017-05-15,95684,422,54,775,4768,101703
2017-05-16,91600,362,182,2032,5598,99774
2017-05-17,94121,330,139,2934,5402,102926
2017-05-18,100169,390,123,5729,12721,119132
2017-05-19,144033,393,240,5542,8467,158675
2017-05-20,138034,373,545,7481,20388,166821
2017-05-21,128768,418,114,13878,6418,149596
2017-05-22,95946,414,186,4029,5548,106123
2017-05-23,95628,359,166,2689,10203,109045
2017-05-24,139051,316,0,1459,6487,147313
2017-05-25,166987,492,0,4912,6248,178639
2017-05-26,153551,430,211,7824,6216,168232
2017-05-27,150913,417,145,5619,21143,178237
2017-05-28,147533,546,276,1784,12750,162889
2017-05-29,102873,369,99,2403,4264,110008
2017-05-30,93382,393,319,3343,7247,104684
2017-05-31,111834,428,274,1735,10885,125156
2017-06-01,173777,457,153,7558,6549,188494
2017-06-02,263860,593,202,12433,8219,285307
2017-06-03,272721,518,226,8391,17855,299711
2017-06-04,185135,506,0,5677,14431,205749
2017-06-05,155899,697,174,4101,8149,169020
2017-06-06,123222,426,0,954,13037,137639
2017-06-07,123976,444,0,3455,12275,140150
2017-06-08,135872,420,159,9111,6257,151819
2017-06-09,196429,553,0,11134,8299,216415
2017-06-10,245231,616,246,8136,25557,279786
2017-06-11,179877,530,217,3294,8609,192527
2017-06-12,138231,493,343,649,8475,148191
2017-06-13,119341,481,436,4906,8708,133872
2017-06-14,188921,725,0,715,13041,203402
2017-06-15,227693,712,311,7266,14492,250474
2017-06-16,224243,764,0,9404,6350,240761
2017-06-17,229756,779,181,6465,14773,251954
2017-06-18,224169,727,165,5655,16387,247103
2017-06-19,160360,1205,63,4480,9987,176095
2017-06-20,146219,648,100,3463,14676,165106
2017-06-21,146233,511,123,1236,14956,163059
2017-06-22,172400,650,322,6979,17325,197676
2017-06-23,263129,516,0,9493,9533,282671
2017-06-24,328261,989,0,11708,28317,369275
2017-06-25,237746,942,0,4054,19782,262524
2017-06-26,209178,705,216,4122,11363,225584
2017-06-27,152377,786,265,5167,16652,175247
2017-06-28,163812,649,0,391,11890,176742
2017-06-29,183431,1075,3,9313,20013,213835
2017-06-30,262967,1142,153,8717,13948,286927
2017-07-01,375916,898,351,7523,20900,405588
2017-07-02,275212,876,2,6190,14429,296709
2017-07-03,220663,1247,91,2613,16288,240902
2017-07-04,180069,658,257,8024,19120,208128
2017-07-05,203586,932,137,4079,11817,220551
2017-07-06,198472,1059,152,18301,10107,228091
2017-07-07,289459,1174,0,8207,14877,313717
2017-07-08,383462,1096,103,9808,31142,425611
2017-07-09,298878,1441,20,7505,15017,322861
2017-07-10,258792,1428,242,4290,15689,280441
2017-07-11,199533,664,353,8244,20129,228923
2017-07-12,201417,2158,333,1977,21519,227404
2017-07-13,232718,2343,79,5816,13843,254799
2017-07-14,329365,1747,0,10907,16470,358489
2017-07-15,447501,1607,182,8442,18070,475802
2017-07-16,341858,1693,146,8155,22097,373949
2017-07-17,280582,1390,159,1744,18399,302274
2017-07-18,212550,1788,251,9177,21156,244922
2017-07-19,226558,1378,114,2983,21112,252145
2017-07-20,258147,1325,325,4706,19789,284292
2017-07-21,352349,1785,139,9016,12689,375978
2017-07-22,479494,1533,128,7881,22580,511616
2017-07-23,366698,1676,0,7083,22680,398137
2017-07-24,271477,1598,0,1614,22447,297136
2017-07-25,224528,1784,331,6113,15286,248042
2017-07-26,245606,1365,155,4525,21503,273154
2017-07-27,268766,1299,89,12565,21205,303924
2017-07-28,367388,1618,48,11137,15406,395597
2017-07-29,515918,1622,185,10366,22668,550759
2017-07-30,361273,1713,112,10180,22566,395844
2017-07-31,320733,1458,50,6483,17998,346722
2017-08-01,267064,1741,0,9862,21736,300403
2017-08-02,240607,1431,0,4259,21596,267893
2017-08-03,274424,1609,143,9741,12433,298350
2017-08-04,401459,1707,71,8443,15603,427283
2017-08-05,479118,1779,164,17639,23323,522023
2017-08-06,370707,1858,0,6833,14346,393744
2017-08-07,339428,1486,0,2639,15540,359093
2017-08-08,250451,1232,182,10285,18652,280802
2017-08-09,291830,1325,261,2802,12868,309086
2017-08-10,274655,1597,0,13787,11039,301078
2017-08-11,366426,1486,106,10769,13072,391859
2017-08-12,512864,1960,197,9976,32101,557098
2017-08-13,366547,1415,0,10870,20633,399465
2017-08-14,339707,1670,251,3912,9924,355464
2017-08-15,271698,1462,86,3915,18345,295506
2017-08-16,262792,2101,2,5417,18700,289012
2017-08-17,256359,1492,126,8360,18438,284775
2017-08-18,331212,1686,0,10622,10329,353849
2017-08-19,408925,1363,375,10559,30598,451820
2017-08-20,343020,1313,0,7948,19380,371661
2017-08-21,290226,1111,261,4602,12860,309060
2017-08-22,221713,1233,479,7191,11637,242253
2017-08-23,217592,1146,270,5287,17341,241636
2017-08-24,248573,1000,87,10204,17427,277291
2017-08-25,315055,1385,178,9639,12584,338841
2017-08-26,396151,1081,178,5354,21340,424104
2017-08-27,305002,705,0,7913,16834,330454
2017-08-28,264121,1051,0,4740,10643,280555
2017-08-29,195026,935,124,3203,14687,213975
2017-08-30,207012,929,147,5064,15416,228568
2017-08-31,227673,721,168,8312,15906,252780
2017-09-01,225635,972,321,6063,10596,243587
2017-09-02,271564,754,0,9526,29431,311275
2017-09-03,241666,890,0,4318,18232,265106
2017-09-04,174435,651,286,1636,10363,187371
2017-09-05,151737,927,467,5176,10186,168493
2017-09-06,141378,618,502,3426,14348,160272
2017-09-07,151433,663,81,8010,16331,176518
2017-09-08,214321,687,558,8022,9524,233112
2017-09-09,221480,746,181,11789,19116,253312
2017-09-10,185849,676,0,6322,16182,209029
2017-09-11,137994,594,693,5017,8673,152971
2017-09-12,121238,560,0,3873,13049,138720
2017-09-13,110024,451,158,1722,8021,120376
2017-09-14,123581,559,49,6783,15308,146280
2017-09-15,164804,784,153,5441,8604,179786
2017-09-16,178804,529,206,13863,26901,220303
2017-09-17,156474,518,105,5502,9198,171797
2017-09-18,121296,559,256,1973,8068,132152
2017-09-19,103245,510,305,3839,11825,119724
2017-09-20,113942,365,0,1170,11919,127396
2017-09-21,127075,438,452,6441,13011,147417
2017-09-22,157315,611,416,6663,7566,172571
2017-09-23,154533,561,178,5989,16136,177397
2017-09-24,136867,497,145,10421,12778,160708
2017-09-25,106801,664,148,3358,5965,116936
2017-09-26,98958,405,225,5795,6055,111438
2017-09-27,106877,409,0,2136,8737,118159
2017-09-28,116740,516,170,8880,11435,137741
2017-09-29,167394,606,114,9064,6392,183570
2017-09-30,161897,507,0,12113,14370,188887
2017-10-01,141982,468,85,4132,11353,158020
2017-10-02,99873,448,115,5693,5347,111476
2017-10-03,99409,312,182,3900,7430,111233
2017-10-04,96188,343,0,1299,3863,101693
2017-10-05,100058,307,0,6558,4626,111549
2017-10-06,126430,550,477,7828,4851,140136
2017-10-07,141784,414,185,6166,14301,162850
2017-10-08,125172,442,318,6004,4848,136784
2017-10-09,93158,410,0,4635,3461,101664
2017-10-10,89821,523,0,4306,5815,100465
2017-10-11,94945,418,431,2684,5975,104453
2017-10-12,101641,274,0,7906,3910,113731
2017-10-13,130142,358,0,9874,3957,144331
2017-10-14,135814,413,250,8427,12044,156948
2017-10-15,131961,305,0,5594,8129,145989
2017-10-16,91209,284,438,2407,3723,98061
2017-10-17,80407,308,313,4035,6076,91139
2017-10-18,91579,267,258,4575,4856,101535
2017-10-19,101002,221,0,4448,7717,113388
2017-10-20,129271,611,0,8555,3331,141768
2017-10-21,128989,333,333,8093,12948,150696
2017-10-22,113916,329,0,2826,7284,124355
2017-10-23,88631,272,0,3936,3822,96661
2017-10-24,79869,343,166,3039,3008,86425
2017-10-25,100460,325,145,79,3215,104224
2017-10-26,126537,273,0,4014,5230,136054
2017-10-27,142006,464,69,5513,2878,150930
2017-10-28,160885,608,260,5138,4628,171519
2017-10-29,145939,434,0,1896,2636,150905
2017-10-30,113187,280,6,4643,1286,119402
2017-10-31,113915,335,183,714,1843,116990
2017-11-01,113888,445,0,422,1464,116219
2017-11-02,101851,315,0,3603,1902,107671
2017-11-03,111270,492,0,6899,1590,120251
2017-11-04,118925,273,310,2884,1604,123996
2017-11-05,110803,442,0,11,1271,112527
2017-11-06,70029,289,0,730,1116,72164
2017-11-07,74240,254,162,0,1912,76568
2017-11-08,77136,166,0,4042,721,82065
2017-11-09,86459,323,0,3191,1434,91407
2017-11-10,105481,312,0,7986,1168,114947
2017-11-11,104818,211,0,2596,1075,108700
2017-11-12,90367,187,0,685,1085,92324
2017-11-13,67045,318,148,1281,870,69662
2017-11-14,68406,200,179,3,1280,70068
2017-11-15,74399,232,166,0,749,75546
2017-11-16,76921,203,0,65,911,78100
2017-11-17,96989,330,0,2393,826,100538
2017-11-18,93625,221,0,2500,586,96932
2017-11-19,91060,226,0,6,868,92160
2017-11-20,72114,149,0,22,822,73107
2017-11-21,73477,235,0,633,656,75001
2017-11-22,69929,250,0,1041,704,71924
2017-11-23,78429,201,0,9,802,79441
2017-11-24,105261,225,0,2460,701,108647
2017-11-25,94143,213,0,2733,626,97715
2017-11-26,85894,194,0,640,637,87365
2017-11-27,70026,225,1,43,553,70848
2017-11-28,67359,157,0,57,945,68518
2017-11-29,67466,201,0,93,569,68329
2017-11-30,70148,212,0,9,927,71296
2017-12-01,97439,328,0,134,666,98567
2017-12-02,86331,100,0,142,614,87187
2017-12-03,83196,205,0,2,801,84204
2017-12-04,67097,233,0,61,661,68052
2017-12-05,64977,155,0,0,904,66036
2017-12-06,72309,181,0,133,706,73329
2017-12-07,89162,163,0,48,761,90134
2017-12-08,101109,331,0,2627,570,104637
2017-12-09,87208,1148,0,38,622,89016
2017-12-10,86226,881,0,2,736,87845
2017-12-11,67205,180,0,0,524,67909
2017-12-12,66391,212,0,16,583,67202
2017-12-13,72582,214,0,87,580,73463
2017-12-14,75504,329,0,144,832,76809
2017-12-15,107651,302,0,2385,1481,111819
2017-12-16,119115,1180,0,106,450,120851
2017-12-17,100202,455,0,4,572,101233
2017-12-18,82844,354,0,0,992,84190
2017-12-19,91711,230,0,46,692,92679
2017-12-20,103973,252,0,86,514,104825
2017-12-21,142228,395,0,0,965,143588
2017-12-22,205835,586,0,2642,1072,210135
2017-12-23,243710,1498,0,264,966,246438
2017-12-24,110758,410,0,3,637,111808
2017-12-25,82644,267,0,45,193,83149
2017-12-26,116483,1145,0,3,873,118504
2017-12-27,112874,811,0,132,785,114602
2017-12-28,113018,513,0,17,1180,114728
2017-12-29,144457,1968,0,2763,1267,150455
2017-12-30,159337,1645,0,623,968,162573
2017-12-31,78133,445,0,0,533,79111
2018-01-01,90918,455,0,0,428,91801
2018-01-02,137416,993,0,6,850,139265
2018-01-03,113478,592,0,82,546,114698
2018-01-04,115718,370,0,52,634,116774
2018-01-05,151830,311,0,2736,714,155591
2018-01-06,160368,322,0,129,548,161367
2018-01-07,123618,353,0,0,805,124776
2018-01-08,114914,309,0,0,645,115868
2018-01-09,94399,305,0,15,908,95627
2018-01-10,93830,253,0,96,485,94664
2018-01-11,83974,183,0,3,792,84952
2018-01-12,108425,297,0,2,841,109565
2018-01-13,132864,699,0,53,651,134267
2018-01-14,102919,354,0,0,547,103820
2018-01-15,51686,78,0,47,687,52498
2018-01-16,39416,221,0,0,696,40333
2018-01-17,56195,209,0,67,467,56938
2018-01-18,58814,164,0,0,457,59435
2018-01-19,67493,163,0,3,574,68233
2018-01-20,64202,256,0,39,525,65022
2018-01-21,73496,287,0,0,821,74604
2018-01-22,52846,212,0,0,622,53680
2018-01-23,40413,148,0,9,542,41112
2018-01-24,45008,225,0,59,519,45811
2018-01-25,46879,172,0,25,494,47570
2018-01-26,64160,200,0,5,669,65034
2018-01-27,63271,258,0,62,316,63907
2018-01-28,60488,192,0,7,620,61307
2018-01-29,44194,189,0,26,529,44938
2018-01-30,49763,182,0,2,505,50452
2018-01-31,48371,135,0,84,541,49131
2018-02-01,50007,237,0,0,509,50753
2018-02-02,59518,196,0,0,715,60429
2018-02-03,56671,263,0,111,323,57368
2018-02-04,62314,286,0,2,756,63358
2018-02-05,43194,158,0,0,543,43895
2018-02-06,45130,179,0,4,787,46100
2018-02-07,39668,194,0,119,539,40520
2018-02-08,48127,209,0,0,665,49001
2018-02-09,55961,231,0,0,892,57084
2018-02-10,71751,202,0,126,916,72995
2018-02-11,73951,196,0,30,781,74958
2018-02-12,44060,156,0,0,863,45079
2018-02-13,40578,169,0,2,918,41667
2018-02-14,53747,158,0,113,901,54919
2018-02-15,58156,214,0,79,618,59067
2018-02-16,68012,202,0,42,936,69192
2018-02-17,73465,206,0,162,732,74565
2018-02-18,76445,180,0,0,837,77462
2018-02-19,53987,225,0,8,830,55050
2018-02-20,51222,195,0,35,1079,52531
2018-02-21,48292,149,0,104,878,49423
2018-02-22,53572,214,0,0,1012,54798
2018-02-23,62504,258,0,0,931,63693
2018-02-24,63765,493,0,137,828,65223
2018-02-25,60186,232,0,0,1011,61429
2018-02-26,46020,285,0,9,792,47106
2018-02-27,34415,48,0,1,627,35091
2018-02-28,43921,196,0,55,1140,45312
2018-03-01,47441,209,0,37,1110,48797
2018-03-02,56057,233,0,3,916,57209
2018-03-03,59119,60,0,138,812,60129
2018-03-04,64616,251,0,7,1252,66126
2018-03-05,49021,204,0,35,872,50132
2018-03-06,48343,181,0,0,1172,49696
2018-03-07,52997,193,0,173,917,54280
2018-03-08,54817,269,0,24,797,55907
2018-03-09,75658,237,0,28,894,76817
2018-03-10,75275,187,0,103,796,76361
2018-03-11,78638,190,0,6,1038,79872
2018-03-12,51180,173,0,24,1060,52437
2018-03-13,47385,171,0,3,1208,48767
2018-03-14,57296,202,0,99,1045,58642
2018-03-15,67228,309,0,48,1086,68671
2018-03-16,88865,286,0,4,970,90125
2018-03-17,78556,203,0,1084,939,80782
2018-03-18,75224,275,329,23,1131,76982
2018-03-19,60160,187,0,7,1142,61496
2018-03-20,55301,163,0,1274,1540,58278
2018-03-21,61233,272,0,118,1272,62895
2018-03-22,65043,266,0,937,1221,67467
2018-03-23,100940,273,0,1347,1494,104054
2018-03-24,123044,419,0,2711,2587,128761
2018-03-25,101304,437,0,1386,3953,107080
2018-03-26,70334,264,0,45,3152,73795
2018-03-27,74702,287,0,2299,3589,80877
2018-03-28,90093,283,304,205,4355,95240
2018-03-29,126522,428,2,647,5345,132944
2018-03-30,200434,433,0,3005,4351,208223
2018-03-31,114270,472,0,1798,5770,122310
2018-04-01,107373,202,327,87,4224,112213
2018-04-02,153752,370,0,931,3622,158675
2018-04-03,110598,286,185,746,3871,115686
2018-04-04,90754,292,100,1317,3781,96244
2018-04-05,95764,312,0,1242,4028,101346
2018-04-06,126790,362,102,2766,3457,133477
2018-04-07,136059,279,157,2877,5193,144565
2018-04-08,111050,237,140,4264,1794,117485
2018-04-09,92974,377,0,932,3811,98094
2018-04-10,76741,251,249,181,3748,81170
2018-04-11,77202,278,249,381,4336,82446
2018-04-12,82138,223,75,4693,2602,89731
2018-04-13,112087,323,386,284,3144,116224
2018-04-14,112608,253,0,4700,6190,123751
2018-04-15,103303,253,185,1993,5188,110922
2018-04-16,79041,290,246,408,2653,82638
2018-04-17,68777,252,183,2199,3919,75330
2018-04-18,72667,213,154,88,5558,78680
2018-04-19,82938,430,152,5262,4991,93773
2018-04-20,114090,392,284,172,2819,117757
2018-04-21,119483,252,258,5262,6658,131913
2018-04-22,109062,562,154,2041,6840,118659
2018-04-23,81218,477,110,3100,4612,89517
2018-04-24,83797,307,179,4749,5462,94494
2018-04-25,91307,207,322,258,6457,98551
2018-04-26,134821,541,368,8131,6762,150623
2018-04-27,232299,710,318,4917,4863,243107
2018-04-28,236631,507,228,3711,9316,250393
2018-04-29,164991,434,182,1263,9655,176525
2018-04-30,136672,350,284,1259,6071,144636
2018-05-01,137184,510,0,5469,5563,148726
2018-05-02,126146,393,306,3557,4760,135162
2018-05-03,99004,450,0,10537,8821,118812
2018-05-04,125752,266,320,1119,7373,134830
2018-05-05,137497,276,0,10126,12276,160175
2018-05-06,125710,578,173,1891,12806,141158
2018-05-07,90197,337,0,49,6654,97237
2018-05-08,94004,185,0,8218,9387,111794
2018-05-09,117224,299,400,1654,6666,126243
2018-05-10,134420,507,0,6980,12312,154219
2018-05-11,120582,589,165,6534,6801,134671
2018-05-12,123635,253,260,5038,18405,147591
2018-05-13,127265,385,250,2321,6727,136948
2018-05-14,88195,459,396,260,8275,97585
2018-05-15,79439,273,165,1074,9950,90901
2018-05-16,87661,283,278,5698,10449,104369
2018-05-17,101862,293,158,5048,7218,114579
2018-05-18,156663,444,0,8831,8865,174803
2018-05-19,190366,455,530,3898,24045,219294
2018-05-20,142392,457,122,4005,14584,161560
2018-05-21,131537,313,361,799,7207,140217
2018-05-22,97976,321,296,5189,7344,111126
2018-05-23,97182,454,343,1504,11260,110743
2018-05-24,101640,363,427,7678,13898,124006
2018-05-25,148034,598,324,8753,8609,166318
2018-05-26,156156,453,84,7243,22675,186611
2018-05-27,138380,532,185,6487,14728,160312
2018-05-28,105153,430,343,651,8761,115338
2018-05-29,89355,284,114,5777,12815,108345
2018-05-30,141492,375,339,1684,13461,157351
2018-05-31,175977,337,389,10922,14480,202105
2018-06-01,193092,363,207,4738,10816,209216
2018-06-02,200660,475,135,13523,19492,234285
2018-06-03,176568,581,483,5390,10615,193637
2018-06-04,132251,385,0,3173,10843,146652
2018-06-05,101706,193,443,4994,13835,121171
2018-06-06,109357,291,335,3436,15009,128428
2018-06-07,126822,509,148,10658,9621,147758
2018-06-08,168345,576,324,5697,10573,185515
2018-06-09,157797,539,523,6520,25900,191279
2018-06-10,175491,531,182,6533,18302,201039
2018-06-11,118905,384,266,490,10863,130908
2018-06-12,106875,401,409,4044,14277,126006
2018-06-13,119979,401,807,1998,11605,134790
2018-06-14,159512,538,160,10574,17076,187860
2018-06-15,208670,550,108,7199,12055,228582
2018-06-16,252031,840,125,14080,28783,295859
2018-06-17,218088,386,0,8130,19540,246144
2018-06-18,158201,514,254,2628,10840,172437
2018-06-19,122748,490,0,8630,15380,147248
2018-06-20,152253,538,524,2464,18037,173816
2018-06-21,161884,606,147,10239,19176,192052
2018-06-22,252570,721,416,3695,12517,269919
2018-06-23,347160,836,226,9772,20612,378606
2018-06-24,217115,594,405,8713,22288,249115
2018-06-25,198478,767,0,667,17469,217381
2018-06-26,155107,569,122,3741,19111,178650
2018-06-27,168550,546,480,4969,16642,191187
2018-06-28,161631,670,238,10180,14662,187381
2018-06-29,259486,821,0,5047,18047,283401
2018-06-30,346382,979,135,11740,33000,392236
2018-07-01,279827,1149,0,5948,25171,312095
2018-07-02,205212,609,258,6089,15203,227371
2018-07-03,169903,778,133,6828,21177,198819
2018-07-04,170552,1026,182,4740,17777,194277
2018-07-05,208609,2257,370,12562,25638,249436
2018-07-06,282543,1016,155,10560,19579,313853
2018-07-07,368375,931,0,8004,31444,408754
2018-07-08,299198,1309,349,9944,26803,337603
2018-07-09,244912,1027,163,4666,20539,271307
2018-07-10,188640,860,270,6304,15421,211495
2018-07-11,183803,1300,0,5091,24122,214316
2018-07-12,220376,1214,239,11049,23511,256389
2018-07-13,308291,1229,330,8800,19123,337773
2018-07-14,451216,1685,0,14481,26003,493385
2018-07-15,355607,1838,0,8325,25369,391139
2018-07-16,265038,1877,439,1125,20512,288991
2018-07-17,225315,976,163,11933,22751,261138
2018-07-18,217236,1551,190,3953,18578,241508
2018-07-19,232085,1737,510,7820,23222,265374
2018-07-20,353073,1776,151,7110,19935,382045
2018-07-21,469450,1350,133,13389,33583,517905
2018-07-22,374385,1819,189,7357,17472,401222
2018-07-23,283912,1684,321,2302,20564,308783
2018-07-24,217487,1354,122,4643,23284,246890
2018-07-25,215838,1390,225,5345,23987,246785
2018-07-26,256811,1471,729,12341,16352,287704
2018-07-27,364541,2409,145,8083,22993,398171
2018-07-28,483400,1390,0,11124,33661,529575
2018-07-29,373193,1625,0,11255,14578,400651
2018-07-30,290211,1223,143,2441,6208,300226
2018-07-31,246941,1041,0,10356,15848,274186
2018-08-01,263349,1401,181,7593,24751,297275
2018-08-02,257902,1127,319,13466,17031,289845
2018-08-03,213153,1126,0,5985,18860,239124
2018-08-04,517055,1260,114,14913,33895,567237
2018-08-05,372661,2120,186,10022,24885,409874
2018-08-06,331090,897,147,2599,19022,353755
2018-08-07,242820,1091,0,6348,14068,264327
2018-08-08,239970,1049,0,4677,20469,266165
2018-08-09,267977,1479,0,13195,22782,305433
2018-08-10,379633,1238,151,11252,17250,409524
2018-08-11,409727,1690,170,23564,22011,457162
2018-08-12,357324,1497,0,12969,23678,395468
2018-08-13,295198,1589,263,3128,17269,317447
2018-08-14,263446,1048,238,9364,19313,293409
2018-08-15,274294,958,186,6700,14948,297086
2018-08-16,274414,1134,128,14567,13770,304013
2018-08-17,336271,1100,0,8143,17017,362531
2018-08-18,410416,1314,159,14663,31496,458048
2018-08-19,353725,826,182,7996,14931,377660
2018-08-20,286068,1050,0,3393,12641,303152
2018-08-21,207893,1103,0,9606,18907,237509
2018-08-22,215790,972,71,4405,18518,239756
2018-08-23,259632,460,113,13720,13545,287470
2018-08-24,292101,765,0,5365,10913,309144
2018-08-25,363428,1034,120,11936,31871,408389
2018-08-26,295173,1016,0,7055,20292,323536
2018-08-27,226970,689,90,3946,13221,244916
2018-08-28,185525,652,152,9163,15336,210828
2018-08-29,194600,906,203,3438,16745,215892
2018-08-30,203932,612,158,13804,11464,229970
2018-08-31,262465,877,0,4906,14147,282395
2018-09-01,289190,1030,295,9330,22465,322310
2018-09-02,264279,900,188,5084,20887,291338
2018-09-03,189309,1267,124,2562,9643,202905
2018-09-04,149433,761,0,4444,10436,165074
2018-09-05,148109,483,253,2180,12707,163732
2018-09-06,159867,1267,84,10597,17894,189709
2018-09-07,202507,756,0,10733,12371,226367
2018-09-08,228494,1236,277,12693,21245,263945
2018-09-09,213039,458,220,3424,12202,229343
2018-09-10,149965,495,0,590,11598,162648
2018-09-11,123720,533,89,9089,14838,148269
2018-09-12,120507,507,323,3322,15501,140160
2018-09-13,135963,503,353,9416,10776,157011
2018-09-14,195280,703,150,4647,12386,213166
2018-09-15,201060,637,138,8005,27612,237452
2018-09-16,175117,611,248,3097,17414,196487
2018-09-17,127863,340,330,755,8410,137698
2018-09-18,116976,433,176,5954,13614,137153
2018-09-19,131627,423,308,3080,14139,149577
2018-09-20,142265,655,0,9985,9068,161973
2018-09-21,171430,516,161,18782,9025,199914
2018-09-22,195042,601,0,11133,26074,232850
2018-09-23,137744,614,0,2237,16214,156809
2018-09-24,152433,1041,0,8851,54546,216871
2018-09-25,99606,302,213,3822,10198,114141
2018-09-26,107454,539,329,7460,14620,130402
2018-09-27,127871,344,149,8458,13417,150239
2018-09-28,157199,658,300,10389,9844,178390
2018-09-29,165862,360,0,8413,16410,191045
2018-09-30,137867,417,357,10180,15415,164236
2018-10-01,101972,339,227,3587,8326,114451
2018-10-02,78525,549,0,4215,8695,91984
2018-10-03,97944,327,79,4306,10088,112744
2018-10-04,101815,467,283,10148,11815,124528
2018-10-05,129984,382,137,5529,6855,142887
2018-10-06,120933,438,207,9735,12699,144012
2018-10-07,120562,254,297,2683,12107,135903
2018-10-08,101109,435,197,1433,6054,109228
2018-10-09,88347,264,158,4831,6994,100594
2018-10-10,93156,265,551,4678,6700,105350
2018-10-11,99927,271,340,5587,9833,115958
2018-10-12,129296,561,162,5654,5612,141285
2018-10-13,137312,227,101,9315,15368,162323
2018-10-14,126464,285,341,5269,10364,142723
2018-10-15,87963,329,198,2887,5578,96955
2018-10-16,60924,333,0,8033,6715,76005
2018-10-17,102043,272,61,6775,5955,115106
2018-10-18,88887,336,128,6424,9300,105075
2018-10-19,128268,365,292,4894,5791,139610
2018-10-20,132208,600,0,9289,12418,154515
2018-10-21,115239,318,0,416,4608,120581
2018-10-22,85099,200,0,2515,3990,91804
2018-10-23,78772,333,0,7743,5131,91979
2018-10-24,89060,320,305,6001,2792,98478
2018-10-25,112847,218,128,7257,5148,125598
2018-10-26,128893,463,0,2767,1878,134001
2018-10-27,128645,372,0,5393,5729,140139
2018-10-28,118266,329,156,1316,3232,123299
2018-10-29,82651,252,0,3450,1798,88151
2018-10-30,106694,455,0,1241,1708,110098
2018-10-31,136861,394,0,8464,1728,147447
2018-11-01,101252,447,0,2914,1725,106338
2018-11-02,105455,433,0,4955,1627,112470
2018-11-03,112770,454,0,4846,1820,119890
2018-11-04,139725,329,0,1274,1618,142946
2018-11-05,78372,444,0,2,1664,80482
2018-11-06,62372,199,0,12,1158,63741
2018-11-07,67191,189,184,1469,1420,70453
2018-11-08,74069,198,0,8,1177,75452
2018-11-09,101348,346,0,3262,1372,106328
2018-11-10,90443,188,0,2445,1156,94232
2018-11-11,85997,189,185,2074,1116,89561
2018-11-12,68713,230,0,1973,1182,72098
2018-11-13,70318,221,0,36,907,71482
2018-11-14,73750,306,0,155,921,75132
2018-11-15,75673,132,5,0,1052,76862
2018-11-16,102577,235,0,3569,1061,107442
2018-11-17,88953,278,0,7277,865,97373
2018-11-18,87714,60,0,2849,980,91603
2018-11-19,65401,154,0,49,1057,66661
2018-11-20,57929,164,0,675,856,59624
2018-11-21,62507,250,189,182,795,63923
2018-11-22,73051,179,0,12,929,74171
2018-11-23,97270,82,0,2608,928,100888
2018-11-24,89549,207,0,2517,909,93182
2018-11-25,86958,327,0,2769,899,90953
2018-11-26,68719,197,0,0,1053,69969
2018-11-27,59211,80,0,44,790,60125
2018-11-28,64978,179,0,83,823,66063
2018-11-29,69406,209,0,16,1077,70708
2018-11-30,96057,232,0,2391,1174,99854
2018-12-01,83102,780,0,139,803,84824
2018-12-02,81867,261,0,2109,769,85006
2018-12-03,61385,161,0,21,1106,62673
2018-12-04,64431,161,0,14,738,65344
2018-12-05,63852,301,0,187,933,65273
2018-12-06,67329,321,0,2,980,68632
2018-12-07,95103,451,0,2454,1302,99310
2018-12-08,97538,946,0,96,805,99385
2018-12-09,81980,640,0,3,779,83402
2018-12-10,62923,304,0,50,883,64160
2018-12-11,62298,305,0,0,580,63183
2018-12-12,67333,228,0,136,728,68425
2018-12-13,68412,231,0,6,699,69348
2018-12-14,84642,690,0,2342,906,88580
2018-12-15,98046,2453,0,79,767,101345
2018-12-16,89163,1759,0,20,777,91719
2018-12-17,67381,212,0,0,838,68431
2018-12-18,70940,258,0,45,579,71822
2018-12-19,87245,316,0,70,466,88097
2018-12-20,117642,409,0,2,750,118803
2018-12-21,195448,645,0,2587,1018,199698
2018-12-22,271070,888,0,229,897,273084
2018-12-23,164432,1742,0,2,944,167120
2018-12-24,92998,652,0,32,777,94459
2018-12-25,71215,290,0,97,324,71926
2018-12-26,105346,259,0,0,875,106480
2018-12-27,112644,1085,0,6,1228,114963
2018-12-28,133541,1167,0,2733,1059,138500
2018-12-29,152735,1639,0,527,1470,156371
2018-12-30,132731,639,0,0,1215,134585
2018-12-31,75616,761,0,81,450,76908
2019-01-01,62892,102,0,31,276,63301
2019-01-02,127853,1069,0,9,1118,130049
2019-01-03,121955,371,0,3,791,123120
2019-01-04,135873,286,0,2624,922,139705
2019-01-05,184421,349,0,67,670,185507
2019-01-06,116110,390,0,0,804,117304
2019-01-07,83418,262,0,0,743,84423
2019-01-08,92357,407,0,13,508,93285
2019-01-09,79315,295,0,76,867,80553
2019-01-10,73146,243,0,0,693,74082
2019-01-11,87903,271,0,1,780,88955
2019-01-12,113192,288,0,57,477,114014
2019-01-13,86590,285,0,8,703,87586
2019-01-14,66196,198,0,1,1273,67668
2019-01-15,61729,144,0,0,573,62446
2019-01-16,61776,288,0,58,924,63046
2019-01-17,64738,194,0,44,643,65619
2019-01-18,91301,274,0,18,707,92300
2019-01-19,77188,130,0,43,594,77955
2019-01-20,73401,179,0,2,836,74418
2019-01-21,61669,195,0,11,873,62748
2019-01-22,73226,145,80,4307,10748,88506
2019-01-23,50462,192,0,40,931,51625
2019-01-24,56861,38,0,12,775,57686
2019-01-25,71155,195,0,45,688,72083
2019-01-26,69700,132,0,54,352,70238
2019-01-27,66254,145,0,8,801,67208
2019-01-28,54852,136,0,23,836,55847
2019-01-29,51137,136,0,21,613,51907
2019-01-30,54884,183,0,96,920,56083
2019-01-31,58684,185,0,9,533,59411
2019-02-01,80081,268,0,104,1162,81615
2019-02-02,72334,218,0,52,428,73032
2019-02-03,77545,157,0,1,654,78357
2019-02-04,57730,85,0,0,875,58690
2019-02-05,54736,322,0,14,634,55706
2019-02-06,61948,152,0,46,654,62800
2019-02-07,79053,129,0,1,1190,80373
2019-02-08,89055,169,0,37,1061,90322
2019-02-09,81763,241,0,682,787,83473
2019-02-10,88104,182,0,0,963,89249
2019-02-11,58679,217,0,99,1096,60091
2019-02-12,55932,176,0,6,927,57041
2019-02-13,61407,164,0,51,901,62523
2019-02-14,71840,206,0,0,1359,73405
2019-02-15,96623,245,0,102,1327,98297
2019-02-16,90664,225,0,59,1077,92025
2019-02-17,95892,217,0,55,735,96899
2019-02-18,68079,231,0,6,827,69143
2019-02-19,56645,217,0,4,885,57751
2019-02-20,65842,216,0,286,777,67121
2019-02-21,71571,206,0,0,749,72526
2019-02-22,79047,194,0,90,1270,80601
2019-02-23,86563,155,0,85,1307,88110
2019-02-24,86814,219,0,2,1306,88341
2019-02-25,66428,169,0,0,925,67522
2019-02-26,58064,191,0,0,1030,59285
2019-02-27,61980,311,0,218,1277,63786
2019-02-28,76828,179,0,13,971,77991
2019-03-01,105953,304,0,5,1309,107571
2019-03-02,99504,250,0,79,815,100648
2019-03-03,97992,267,0,0,1718,99977
2019-03-04,67965,198,0,2,1453,69618
2019-03-05,60559,234,0,8,1357,62158
2019-03-06,66785,181,0,4568,1428,72962
2019-03-07,72349,165,0,49,1822,74385
2019-03-08,99888,214,0,8,1527,101637
2019-03-09,92805,252,0,3392,728,97177
2019-03-10,98395,346,0,49,869,99659
2019-03-11,62982,194,123,77,1692,65068
2019-03-12,59499,195,0,24,1006,60724
2019-03-13,63471,151,0,318,1565,65505
2019-03-14,75593,253,0,7,1859,77712
2019-03-15,99545,256,151,57,1813,101822
2019-03-16,94868,290,0,149,1328,96635
2019-03-17,97747,374,142,34,839,99136
2019-03-18,70095,192,0,0,1631,71918
2019-03-19,64892,146,0,24,1445,66507
2019-03-20,67939,170,179,321,1602,70211
2019-03-21,76282,320,0,8,1201,77811
2019-03-22,97988,292,6,12,1974,100272
2019-03-23,94757,228,0,1250,1360,97595
2019-03-24,98945,262,137,54,1793,101191
2019-03-25,70428,195,8,9,1227,71867
2019-03-26,61379,221,174,2141,1286,65201
2019-03-27,68215,186,0,324,1861,70586
2019-03-28,76400,227,0,915,2341,79883
2019-03-29,108881,497,366,2570,1522,113836
2019-03-30,101463,229,174,2732,1567,106165
2019-03-31,107557,365,0,2054,4424,114400
2019-04-01,74289,230,151,38,4665,79373
2019-04-02,67736,270,170,125,4965,73266
2019-04-03,73329,246,366,4247,4662,82850
2019-04-04,79048,183,149,2474,5957,87811
2019-04-05,106344,364,434,2211,3160,112513
2019-04-06,100951,296,6,4892,8791,114936
2019-04-07,103785,320,138,2075,5955,112273
2019-04-08,74041,227,322,71,5216,79877
2019-04-09,69306,298,324,4462,3558,77948
2019-04-10,75206,223,0,3622,6236,85287
2019-04-11,85360,281,40,5061,7155,97897
2019-04-12,134574,267,481,40,6120,141482
2019-04-13,164182,474,346,2920,7483,175405
2019-04-14,136308,373,36,509,8900,146126
2019-04-15,89555,351,123,4059,6427,100515
2019-04-16,91524,303,0,1340,7320,100487
2019-04-17,122909,236,0,391,7641,131177
2019-04-18,177653,405,147,4499,6748,189452
2019-04-19,276292,616,310,2884,4414,284516
2019-04-20,176221,463,0,7341,7458,191483
2019-04-21,143924,509,309,2795,8609,156146
2019-04-22,172163,382,614,5064,4925,183148
2019-04-23,122078,300,130,568,7795,130871
2019-04-24,106795,304,285,5653,7060,120097
2019-04-25,132312,322,167,6060,9244,148105
2019-04-26,190834,422,280,2832,6438,200806
2019-04-27,215926,455,432,9637,15104,241554
2019-04-28,144824,477,75,3498,9629,158503
2019-04-29,133979,469,210,2654,7768,145080
2019-04-30,194685,390,142,4704,10004,209925
2019-05-01,189315,338,172,4118,10652,204595
2019-05-02,134377,417,160,7052,12362,154368
2019-05-03,136262,370,360,6044,7940,150976
2019-05-04,160832,328,316,6771,19479,187726
2019-05-05,157972,649,0,2397,13128,174146
2019-05-06,100193,281,185,3027,7393,111079
2019-05-07,90872,384,140,3479,10892,105767
2019-05-08,90423,417,550,3160,6739,101289
2019-05-09,91783,468,384,6415,16920,115970
2019-05-10,120817,364,178,7240,7417,136016
2019-05-11,119802,371,309,6827,19541,146850
2019-05-12,105874,325,206,4624,7522,118551
2019-05-13,85828,515,75,337,8065,94820
2019-05-14,74428,230,245,6388,10732,92023
2019-05-15,83651,311,321,3847,7583,95713
2019-05-16,92409,302,344,9467,7593,110115
2019-05-17,131245,582,655,9094,8439,150015
2019-05-18,121907,384,313,4411,22581,149596
2019-05-19,120713,730,294,10482,14337,146556
2019-05-20,94447,300,315,4443,8866,108371
2019-05-21,88377,309,156,5882,12746,107470
2019-05-22,95263,237,137,8009,11682,115328
2019-05-23,101497,340,42,12026,9773,123678
2019-05-24,141705,341,805,11632,7403,161886
2019-05-25,152277,374,370,11079,26818,190918
2019-05-26,121163,341,184,3855,17025,142568
2019-05-27,89760,299,453,2924,6372,99808
2019-05-28,88532,319,322,3427,10407,103007
2019-05-29,131390,282,163,3009,13118,147962
2019-05-30,172597,378,437,7532,17421,198365
2019-05-31,152071,405,908,6912,11947,172243
2019-06-01,179920,505,480,6440,20599,207944
2019-06-02,156556,393,614,7264,18021,182848
2019-06-03,121880,320,653,338,12044,135235
2019-06-04,102650,400,0,4211,15852,123113
2019-06-05,120543,296,251,1423,15321,137834
2019-06-06,146265,404,293,10233,18233,175428
2019-06-07,241207,646,183,13800,14172,270008
2019-06-08,264601,569,140,6968,30239,302517
2019-06-09,210364,1674,213,5371,20203,237825
2019-06-10,172506,508,326,5198,13619,192157
2019-06-11,125405,332,0,7597,12332,145666
2019-06-12,128437,407,153,3163,16525,148685
2019-06-13,147376,700,301,13626,19026,181029
2019-06-14,214840,687,184,7431,14757,237899
2019-06-15,276920,682,106,8279,30336,316323
2019-06-16,200967,548,256,7701,21288,230760
2019-06-17,156345,569,251,2305,14520,173990
2019-06-18,143664,473,148,3298,18505,166088
2019-06-19,187525,431,335,2251,18942,209484
2019-06-20,228232,593,162,9436,20806,259229
2019-06-21,252995,993,400,11064,12899,278351
2019-06-22,323042,604,315,12219,30489,366669
2019-06-23,251623,732,0,4986,23733,281074
2019-06-24,201812,644,487,3002,18095,224040
2019-06-25,170838,896,240,6674,21248,199896
2019-06-26,156762,736,393,7830,13911,179632
2019-06-27,165281,581,450,12659,22759,201730
2019-06-28,253314,639,180,10484,20311,284928
2019-06-29,325875,876,322,15559,34198,376830
2019-06-30,274221,1003,0,14549,27486,317259
2019-07-01,220617,646,493,5829,15855,243440
2019-07-02,175751,756,113,8044,22715,207379
2019-07-03,184747,847,160,2762,23786,212302
2019-07-04,205177,877,295,10712,25298,242359
2019-07-05,279729,942,184,10012,21463,312330
2019-07-06,360726,812,320,13305,35662,410825
2019-07-07,256751,879,0,4367,25965,287962
2019-07-08,228704,1228,722,4103,21447,256204
2019-07-09,176070,930,426,9910,17434,204770
2019-07-10,202152,960,238,3320,25098,231768
2019-07-11,189399,3186,438,13031,26587,232641
2019-07-12,322421,1400,529,7821,21239,353410
2019-07-13,414836,1232,158,6507,27033,449766
2019-07-14,329519,1477,0,8737,28172,367905
2019-07-15,280046,1548,180,4689,22406,308869
2019-07-16,202933,843,370,6616,24695,235457
2019-07-17,205720,1168,0,3401,18160,228449
2019-07-18,249961,1874,183,7449,26804,286271
2019-07-19,365558,1560,610,8283,21310,397321
2019-07-20,451718,1322,370,16463,35976,505849
2019-07-21,334773,1350,92,4878,27753,368846
2019-07-22,281713,1680,175,2174,22570,308312
2019-07-23,200805,977,0,9868,25046,236696
2019-07-24,221479,1003,140,4514,24465,251601
2019-07-25,247112,1023,161,12235,26133,286664
2019-07-26,364352,1482,643,7181,20834,394492
2019-07-27,380815,835,385,10747,34966,427748
2019-07-28,350452,2274,0,5669,25964,384359
2019-07-29,280389,1035,142,10448,22083,314097
2019-07-30,235957,1447,0,5999,24096,267499
2019-07-31,247984,1294,103,7112,24200,280693
2019-08-01,307190,1174,70,15291,25979,349704
2019-08-02,403719,1292,304,10169,20579,436063
2019-08-03,466824,1242,0,8342,39857,516265
2019-08-04,362273,1882,0,12222,26941,403318
2019-08-05,318111,1359,451,4902,21523,346346
2019-08-06,200927,2403,0,7878,22780,233988
2019-08-07,253585,2345,145,6032,23120,285227
2019-08-08,280357,1043,165,11992,24285,317842
2019-08-09,356575,1439,652,9060,19173,386899
2019-08-10,479740,1227,11,16663,34649,532290
2019-08-11,358713,1373,105,12380,18930,391501
2019-08-12,302390,1567,333,7338,19597,331225
2019-08-13,254889,1391,277,7915,22041,286513
2019-08-14,332891,1626,164,3217,21737,359635
2019-08-15,342997,1342,157,13368,15913,373777
2019-08-16,356499,1665,184,11919,13782,384049
2019-08-17,464747,1347,249,15581,25595,507519
2019-08-18,408477,1194,0,7797,24607,442075
2019-08-19,293986,1062,295,5770,18578,319691
2019-08-20,215488,884,122,5312,5499,227305
2019-08-21,231736,1017,379,2888,19205,255225
2019-08-22,251361,661,317,13906,22062,288307
2019-08-23,337413,1261,498,5810,17647,362629
2019-08-24,356165,1296,510,9658,23146,390775
2019-08-25,318740,830,318,10190,15486,345564
2019-08-26,247190,585,320,5692,15181,268968
2019-08-27,209923,757,85,6302,17237,234304
2019-08-28,212878,764,156,3020,12482,229300
2019-08-29,222261,564,570,12033,20002,255430
2019-08-30,278472,1005,179,8048,12043,299747
2019-08-31,341486,908,0,6088,24706,373188
2019-09-01,260040,806,134,5823,24038,290841
2019-09-02,179486,491,366,3222,14698,198263
2019-09-03,158114,593,486,6661,17053,182907
2019-09-04,163767,572,311,4116,12557,181323
2019-09-05,161689,552,339,12840,20052,195472
2019-09-06,214846,702,787,5511,14532,236378
2019-09-07,216295,636,124,7830,32050,256935
2019-09-08,204075,502,333,7759,14218,226887
2019-09-09,162704,527,514,2422,13635,179802
2019-09-10,135729,478,155,8415,16613,161390
2019-09-11,129492,426,272,6378,16334,152902
2019-09-12,142333,546,364,8381,19069,170693
2019-09-13,206097,616,411,8711,15016,230851
2019-09-14,193984,542,510,12678,30869,238583
2019-09-15,182686,1099,297,4565,20704,209351
2019-09-16,146180,479,318,996,8722,156695
2019-09-17,116413,608,133,3828,15111,136093
2019-09-18,118215,353,261,3455,15391,137675
2019-09-19,130566,1019,274,7485,18315,157659
2019-09-20,178674,394,469,3956,10469,193962
2019-09-21,180601,503,328,8721,29042,219195
2019-09-22,153900,425,238,7996,18801,181360
2019-09-23,105391,401,184,2228,10178,118382
2019-09-24,100285,354,337,5605,12716,119297
2019-09-25,104320,415,281,4036,8789,117841
2019-09-26,121660,372,504,12311,15628,150475
2019-09-27,139160,550,186,3308,10754,153958
2019-09-28,151369,349,405,10315,18124,180562
2019-09-29,143281,438,154,5751,15942,165566
2019-09-30,104598,318,338,5020,9324,119598
2019-10-01,92284,342,174,4420,11613,108833
2019-10-02,93064,525,79,681,6038,100387
2019-10-03,123704,487,492,12406,14651,151740
2019-10-04,139858,543,616,7517,9626,158160
2019-10-05,131078,344,231,8708,14637,154998
2019-10-06,137782,486,244,7915,13930,160357
2019-10-07,98621,218,292,2881,7864,109876
2019-10-08,90734,414,440,7510,9064,108162
2019-10-09,83926,250,124,4970,5362,94632
2019-10-10,104134,324,459,7484,6669,119070
2019-10-11,151774,398,398,7227,7329,167126
2019-10-12,134455,575,108,13951,18982,168071
2019-10-13,128816,584,390,11990,12718,154498
2019-10-14,92645,337,476,3058,4720,101236
2019-10-15,81797,358,0,7064,8781,98000
2019-10-16,89730,415,165,1338,7479,99127
2019-10-17,97922,279,756,8035,6241,113233
2019-10-18,133933,511,335,4408,6680,145867
2019-10-19,128325,312,160,11278,16008,156083
2019-10-20,125224,713,0,8093,9827,143857
2019-10-21,88322,457,296,5685,4745,99505
2019-10-22,80675,351,95,4797,3325,89243
2019-10-23,87019,263,0,1293,4082,92657
2019-10-24,97938,319,291,10904,7022,116474
2019-10-25,156019,469,176,3269,5043,164976
2019-10-26,150761,604,0,6199,4468,162032
2019-10-27,123868,351,98,9515,1810,135642
2019-10-28,91350,358,489,5174,2305,99676
2019-10-29,85930,251,0,4809,1920,92910
2019-10-30,119630,314,132,5313,1586,126975
2019-10-31,163409,362,322,2821,1925,168839
2019-11-01,121412,392,0,1069,1222,124095
2019-11-02,109442,395,0,5244,1996,117077
2019-11-03,148302,313,0,5399,937,154951
2019-11-04,88672,266,176,5593,1752,96459
2019-11-05,72673,395,149,4590,1659,79466
2019-11-06,73001,214,0,830,1596,75641
2019-11-07,73442,443,143,4138,989,79155
2019-11-08,108279,328,181,2037,1085,111910
2019-11-09,94621,299,0,3823,1219,99962
2019-11-10,89510,279,0,4131,719,94639
2019-11-11,69345,407,172,2159,1112,73195
2019-11-12,60197,207,7,4534,1131,66076
2019-11-13,68417,203,0,59,1131,69810
2019-11-14,71035,421,0,2151,1298,74905
2019-11-15,94006,212,142,2079,892,97331
2019-11-16,88004,287,0,2688,1181,92160
2019-11-17,88450,262,0,17,1237,89966
2019-11-18,68472,175,186,11,1279,70123
2019-11-19,59633,171,0,643,677,61124
2019-11-20,68314,227,0,1983,1047,71571
2019-11-21,79706,352,0,2038,1391,83487
2019-11-22,94457,150,0,2038,1143,97788
2019-11-23,89655,273,0,2585,590,93103
2019-11-24,94153,223,0,2,1074,95452
2019-11-25,73102,144,0,734,1161,75141
2019-11-26,64187,320,0,1,1060,65568
2019-11-27,65049,175,0,57,790,66071
2019-11-28,74966,162,0,12,1201,76341
2019-11-29,104316,189,0,146,1300,105951
2019-11-30,86207,797,0,2985,1054,91043
2019-12-01,89008,366,0,14,624,90012
2019-12-02,64413,203,0,47,997,65660
2019-12-03,60827,170,0,7,930,61934
2019-12-04,63452,202,0,137,874,64665
2019-12-05,70174,220,0,892,693,71979
2019-12-06,97268,385,0,40,1207,98900
2019-12-07,99609,686,0,101,1141,101537
2019-12-08,84892,396,0,411,907,86606
2019-12-09,61361,277,0,0,547,62185
2019-12-10,56827,341,0,4,734,57906
2019-12-11,65716,215,0,75,583,66589
2019-12-12,63682,228,0,97,674,64681
2019-12-13,93945,331,0,30,778,95084
2019-12-14,109802,3080,0,73,677,113632
2019-12-15,96607,959,0,54,743,98363
2019-12-16,67956,245,0,0,763,68964
2019-12-17,71297,487,0,2059,669,74512
2019-12-18,90895,621,0,45,735,92296
2019-12-19,114449,365,0,0,709,115523
2019-12-20,213235,434,0,2719,1001,217389
2019-12-21,254401,1338,0,151,657,256547
2019-12-22,135346,793,0,0,1037,137176
2019-12-23,138413,451,0,46,710,139620
2019-12-24,109228,357,0,122,725,110432
2019-12-25,81033,298,0,26,359,81716
2019-12-26,103037,2682,0,2261,821,108801
2019-12-27,132225,1700,0,2849,1065,137839
2019-12-28,131273,1701,0,367,810,134151
2019-12-29,133425,1941,0,8,774,136148
2019-12-30,127694,1131,0,12,860,129697
2019-12-31,88712,382,0,341,698,90133
2020-01-01,75373,28,0,0,950,76351
2020-01-02,130506,1097,0,52,921,132576
2020-01-03,152020,506,140,28,701,153395
2020-01-04,174799,388,0,2788,955,178930
2020-01-05,170395,295,0,0,689,171379
2020-01-06,105968,351,0,0,639,106958
2020-01-07,77202,206,0,19,666,78093
2020-01-08,99401,223,0,74,655,100353
2020-01-09,77144,221,0,36,502,77903
2020-01-10,93513,210,0,7,501,94231
2020-01-11,116810,335,0,69,427,117641
2020-01-12,108624,278,0,0,583,109485
2020-01-13,62278,178,0,26,529,63011
2020-01-14,62021,175,0,0,411,62607
2020-01-15,66735,179,0,81,461,67456
2020-01-16,71569,135,0,43,580,72327
2020-01-17,85859,250,0,11,472,86592
2020-01-18,81681,212,0,53,392,82338
2020-01-19,77444,205,0,0,492,78141
2020-01-20,62382,155,0,34,434,63005
2020-01-21,59238,181,0,0,466,59885
2020-01-22,61412,201,0,68,536,62217
2020-01-23,62353,185,0,0,557,63095
2020-01-24,82931,166,0,27,579,83703
2020-01-25,72444,179,0,62,611,73296
2020-01-26,73377,257,0,2,641,74277
2020-01-27,57295,242,0,48,536,58121
2020-01-28,54627,158,0,51,655,55491
2020-01-29,55041,134,0,37,503,55715
2020-01-30,60908,166,0,47,629,61750
2020-01-31,88197,196,0,41,183,88617
2020-02-01,82977,196,0,596,470,84239
2020-02-02,78275,249,0,1,497,79022
2020-02-03,58099,193,0,2,824,59118
2020-02-04,53309,229,0,47,682,54267
2020-02-05,53452,202,0,79,638,54371
2020-02-06,55899,164,0,65,965,57093
2020-02-07,79850,222,0,32,653,80757
2020-02-08,82418,217,0,51,387,83073
2020-02-09,87452,227,0,57,892,88628
2020-02-10,58984,172,0,0,844,60000
2020-02-11,57222,208,0,8,907,58345
2020-02-12,60798,238,0,117,549,61702
2020-02-13,66530,259,0,3,958,67750
2020-02-14,97975,257,0,118,1198,99548
2020-02-15,87217,315,0,159,772,88463
2020-02-16,92354,264,0,0,609,93227
2020-02-17,72802,271,0,4,1165,74242
2020-02-18,60622,162,18,3,996,61801
2020-02-19,63490,214,0,111,498,64313
2020-02-20,68792,192,0,51,657,69692
2020-02-21,95749,356,0,0,1274,97379
2020-02-22,92830,205,0,70,679,93784
2020-02-23,102444,225,0,5,1305,103979
2020-02-24,68543,247,0,4,708,69502
2020-02-25,57480,195,0,1,1113,58789
2020-02-26,51698,138,0,110,647,52593
2020-02-27,68377,166,3,69,1060,69675
2020-02-28,90867,277,0,42,1117,92303
2020-02-29,70067,188,0,110,967,71332
2020-03-01,81161,238,0,0,1362,82761
2020-03-02,59626,181,0,0,1140,60947
2020-03-03,48988,39,0,2,519,49548
2020-03-04,53655,170,0,84,792,54701
2020-03-05,57770,197,0,106,965,59038
2020-03-06,84367,146,0,0,996,85509
2020-03-07,66891,122,0,34,414,67461
2020-03-08,74506,184,0,70,1076,75836
2020-03-09,56503,178,130,0,943,57754
2020-03-10,50168,147,0,45,809,51169
2020-03-11,51668,116,0,47,455,52286
2020-03-12,49806,111,0,19,673,50609
2020-03-13,45511,115,0,38,431,46095
2020-03-14,29864,96,0,9,296,30265
2020-03-15,27548,86,0,0,273,27907
2020-03-16,15952,1,0,36,283,16272
2020-03-17,13249,0,0,28,262,13539
2020-03-18,12751,0,0,0,267,13018
2020-03-19,9467,0,0,0,169,9636
2020-03-20,7768,0,0,1,133,7902
2020-03-21,4554,0,0,31,72,4657
2020-03-22,3393,0,0,3,147,3543
2020-03-23,6718,0,0,0,77,6795
2020-03-24,6176,0,0,30,57,6263
2020-03-25,6222,0,0,0,93,6315
2020-03-26,6548,0,0,0,55,6603
2020-03-27,6328,0,0,0,70,6398
2020-03-28,3259,0,0,45,92,3396
2020-03-29,3161,0,0,0,0,3161
2020-03-30,6382,0,0,0,11,6393
2020-03-31,6671,0,0,0,21,6692
2020-04-01,6673,0,0,0,30,6703
2020-04-02,6140,0,0,0,0,6140
2020-04-03,6444,0,0,0,0,6444
2020-04-04,3753,0,0,1,0,3754
2020-04-05,3424,0,0,14,0,3438
2020-04-06,6270,0,0,24,0,6294
2020-04-07,6843,0,0,0,0,6843
2020-04-08,6551,0,0,2,0,6553
2020-04-09,6090,0,0,0,2,6092
2020-04-10,4743,0,0,33,0,4776
2020-04-11,2090,0,0,0,0,2090
2020-04-12,1619,0,0,23,0,1642
2020-04-13,3825,0,0,59,0,3884
2020-04-14,6237,0,0,40,0,6277
2020-04-15,6513,0,0,0,0,6513
2020-04-16,6695,0,0,0,0,6695
2020-04-17,6092,0,0,0,0,6092
2020-04-18,3449,0,0,17,0,3466
2020-04-19,2418,0,0,0,0,2418
2020-04-20,6347,0,0,1,9,6357
2020-04-21,7454,0,0,17,0,7471
2020-04-22,7190,0,0,49,0,7239
2020-04-23,7608,0,0,0,0,7608
2020-04-24,6910,0,0,0,2,6912
2020-04-25,4303,0,0,0,0,4303
2020-04-26,3420,0,0,0,0,3420
2020-04-27,6752,0,0,1,0,6753
2020-04-28,8315,0,0,15,2,8332
2020-04-29,8453,0,0,17,0,8470
2020-04-30,7766,0,0,0,0,7766
2020-05-01,4028,0,0,0,0,4028
2020-05-02,3260,0,0,0,53,3313
2020-05-03,4122,0,0,0,3,4125
2020-05-04,9222,0,0,0,1,9223
2020-05-05,8968,0,0,0,0,8968
2020-05-06,8752,0,0,7,4,8763
2020-05-07,8731,0,0,18,0,8749
2020-05-08,9583,0,0,10,0,9593
2020-05-09,5941,0,0,51,0,5992
2020-05-10,5147,0,0,8,0,5155
2020-05-11,9915,0,0,1,3,9919
2020-05-12,11030,0,0,0,0,11030
2020-05-13,12723,0,0,3,2,12728
2020-05-14,12679,0,0,20,0,12699
2020-05-15,18776,0,0,4,20,18800
2020-05-16,14387,0,0,12,5,14404
2020-05-17,11274,0,0,1,7,11282
2020-05-18,16676,0,0,21,1,16698
2020-05-19,16856,0,0,14,0,16870
2020-05-20,22910,0,0,2,26,22938
2020-05-21,33361,0,0,8,21,33390
2020-05-22,40141,0,0,13,35,40189
2020-05-23,23449,0,0,16,22,23487
2020-05-24,24422,0,0,11,20,24453
2020-05-25,33230,0,0,1136,16,34382
2020-05-26,27960,0,0,1,19,27980
2020-05-27,28187,0,0,17,23,28227
2020-05-28,34880,0,0,189,16,35085
2020-05-29,53875,0,0,13,132,54020
2020-05-30,46377,0,0,84,100,46561
2020-05-31,44559,0,0,33,101,44693
2020-06-01,48009,0,0,16,40,48065
2020-06-02,37606,0,0,38,109,37753
2020-06-03,41440,0,0,18,28,41486
2020-06-04,49580,0,0,6,181,49767
2020-06-05,68799,0,0,2,118,68919
2020-06-06,65427,0,0,47,341,65815
2020-06-07,60548,0,0,49,203,60800
2020-06-08,44007,0,0,49,35,44091
2020-06-09,42654,0,0,29,106,42789
2020-06-10,52798,0,0,30,155,52983
2020-06-11,66507,0,0,14,194,66715
2020-06-12,99444,0,0,168,134,99746
2020-06-13,76536,2,0,113,306,76957
2020-06-14,85134,0,0,38,233,85405
2020-06-15,65565,0,0,79,339,65983
2020-06-16,52868,0,0,41,298,53207
2020-06-17,62667,0,0,65,354,63086
2020-06-18,74225,0,0,43,484,74752
2020-06-19,105740,0,0,100,436,106276
2020-06-20,114543,0,0,172,2170,116885
2020-06-21,67918,0,0,159,807,68884
2020-06-22,70696,31,0,206,683,71616
2020-06-23,61017,22,0,316,501,61856
2020-06-24,95447,92,0,215,964,96718
2020-06-25,99645,46,0,192,541,100424
2020-06-26,108414,42,0,351,738,109545
2020-06-27,103264,50,0,425,2929,106668
2020-06-28,91466,38,0,301,1400,93205
2020-06-29,71817,152,0,112,628,72709
2020-06-30,61802,150,0,282,920,63154
2020-07-01,85233,440,0,119,1924,87716
2020-07-02,87529,85,0,282,1940,89836
2020-07-03,126861,128,0,195,2594,129778
2020-07-04,136862,669,0,617,6635,144783
2020-07-05,122659,539,0,390,5333,128921
2020-07-06,88350,115,0,229,2807,91501
2020-07-07,71952,86,0,260,2126,74424
2020-07-08,75569,709,0,182,2745,79205
2020-07-09,94029,239,0,331,2826,97425
2020-07-10,117668,126,0,453,4168,122415
2020-07-11,146173,607,0,409,6600,153789
2020-07-12,119801,744,0,259,6042,126846
2020-07-13,102696,713,0,250,3335,106994
2020-07-14,74739,611,0,440,3063,78853
2020-07-15,75726,587,0,205,2827,79345
2020-07-16,92840,372,90,438,4336,98076
2020-07-17,133061,226,0,391,5030,138708
2020-07-18,169820,657,0,893,9658,181028
2020-07-19,146636,773,0,564,6240,154213
2020-07-20,119362,713,0,368,4634,125077
2020-07-21,85421,946,0,432,4230,91029
2020-07-22,79323,743,0,224,4332,84622
2020-07-23,105580,601,77,383,5040,111681
2020-07-24,140477,661,96,344,5247,146825
2020-07-25,175328,683,86,1086,8685,185868
2020-07-26,133086,593,0,852,7099,141630
2020-07-27,116523,624,0,405,3447,120999
2020-07-28,99520,626,0,544,4733,105423
2020-07-29,97974,670,0,250,4734,103628
2020-07-30,113299,467,0,557,5082,119405
2020-07-31,141088,784,120,474,5882,148348
2020-08-01,213231,802,0,1623,13637,229293
2020-08-02,160268,626,0,732,8003,169629
2020-08-03,125986,698,1,325,5616,132626
2020-08-04,105311,680,0,495,6581,113067
2020-08-05,114514,724,0,196,6214,121648
2020-08-06,123004,645,0,816,7049,131514
2020-08-07,147601,683,133,935,7089,156441
2020-08-08,201546,762,0,2290,13902,218500
2020-08-09,165368,800,0,1623,10484,178275
2020-08-10,148804,124,0,804,5682,155414
2020-08-11,101072,523,0,901,6143,108639
2020-08-12,115345,718,0,329,6549,122941
2020-08-13,126379,610,0,1007,6651,134647
2020-08-14,159997,667,113,355,7140,168272
2020-08-15,190841,860,0,724,14006,206431
2020-08-16,140938,811,0,486,10566,152801
2020-08-17,113090,668,0,178,5110,119046
2020-08-18,87277,603,0,193,5878,93951
2020-08-19,105982,656,0,116,6347,113101
2020-08-20,99521,720,0,162,6124,106527
2020-08-21,92659,410,116,114,4754,98053
2020-08-22,131819,588,0,302,10049,142758
2020-08-23,92581,662,0,114,5338,98695
2020-08-24,70293,721,1,151,2557,73723
2020-08-25,56781,436,0,76,2776,60069
2020-08-26,64028,502,0,64,2711,67305
2020-08-27,67053,319,0,95,3063,70530
2020-08-28,75505,585,118,101,2218,78527
2020-08-29,89999,416,0,186,6861,97462
2020-08-30,72234,629,67,65,3051,76046
2020-08-31,58417,436,0,86,1440,60379
2020-09-01,50210,347,0,65,1610,52232
2020-09-02,50787,285,0,41,1953,53066
2020-09-03,50575,50,116,167,2213,53121
2020-09-04,68254,64,94,98,2221,70731
2020-09-05,72113,572,0,166,4625,77476
2020-09-06,58379,78,0,57,2748,61262
2020-09-07,46620,32,0,49,1341,48042
2020-09-08,40215,46,0,83,1261,41605
2020-09-09,43984,350,0,76,692,45102
2020-09-10,45732,36,73,89,1806,47736
2020-09-11,61740,57,111,98,1657,63663
2020-09-12,63868,477,83,118,5141,69687
2020-09-13,55647,52,0,20,1771,57490
2020-09-14,42685,385,0,23,1111,44204
2020-09-15,40741,61,0,26,1359,42187
2020-09-16,41851,242,0,139,1025,43257
2020-09-17,45577,44,225,56,841,46743
2020-09-18,56725,42,73,125,1190,58155
2020-09-19,54151,631,163,72,4157,59174
2020-09-20,47015,35,0,54,1723,48827
2020-09-21,38805,260,0,34,545,39644
2020-09-22,38198,24,0,44,620,38886
2020-09-23,36037,192,0,54,856,37139
2020-09-24,36817,35,0,4,744,37600
2020-09-25,49084,56,0,42,675,49857
2020-09-26,41715,180,48,61,2671,44675
2020-09-27,43148,60,0,5,1110,44323
2020-09-28,34550,97,0,2,543,35192
2020-09-29,38324,77,0,16,308,38725
2020-09-30,41280,53,0,85,481,41899
2020-10-01,44194,52,0,27,451,44724
2020-10-02,56762,58,0,55,651,57526
2020-10-03,55020,207,0,35,1579,56841
2020-10-04,53950,39,0,4,842,54835
2020-10-05,41983,39,0,13,663,42698
2020-10-06,38308,53,62,32,295,38750
2020-10-07,42146,57,0,70,380,42653
2020-10-08,48470,43,0,19,338,48870
2020-10-09,71179,34,0,66,417,71696
2020-10-10,57653,35,0,61,1780,59529
2020-10-11,61657,58,0,16,553,62284
2020-10-12,40884,32,0,36,386,41338
2020-10-13,38848,37,0,11,208,39104
2020-10-14,38732,32,0,37,355,39156
2020-10-15,44531,31,0,3,168,44733
2020-10-16,58269,32,0,65,540,58906
2020-10-17,56409,43,0,47,1369,57868
2020-10-18,56181,27,0,28,504,56740
2020-10-19,41001,44,0,28,248,41321
2020-10-20,34428,30,0,10,192,34660
2020-10-21,36472,23,0,55,339,36889
2020-10-22,40657,45,0,61,120,40883
2020-10-23,58458,52,0,35,575,59120
2020-10-24,45814,23,0,29,703,46569
2020-10-25,43770,35,0,24,246,44075
2020-10-26,38319,23,0,42,129,38513
2020-10-27,30736,25,0,8,5,30774
2020-10-28,33683,20,0,40,131,33874
2020-10-29,34658,25,0,2,37,34722
2020-10-30,44476,26,0,33,362,44897
2020-10-31,40541,35,0,44,158,40778
2020-11-01,41888,28,0,5,185,42106
2020-11-02,34487,22,0,2,178,34689
2020-11-03,28315,38,0,8,19,28380
2020-11-04,33013,20,0,36,138,33207
2020-11-05,32072,29,0,0,42,32143
2020-11-06,42631,25,0,12,174,42842
2020-11-07,30691,20,0,31,141,30883
2020-11-08,34708,28,0,24,10,34770
2020-11-09,28458,15,0,5,110,28588
2020-11-10,27779,28,0,0,8,27815
2020-11-11,29424,28,0,72,137,29661
2020-11-12,32184,29,0,0,20,32233
2020-11-13,43190,30,0,9,210,43439
2020-11-14,29213,25,0,36,81,29355
2020-11-15,35417,14,0,1,275,35707
2020-11-16,25898,28,0,28,144,26098
2020-11-17,23813,23,0,6,9,23851
2020-11-18,23614,19,0,18,190,23841
2020-11-19,26512,14,0,42,25,26593
2020-11-20,30260,43,0,34,145,30482
2020-11-21,22593,96,0,23,48,22760
2020-11-22,23297,27,0,8,119,23451
2020-11-23,24538,17,0,17,136,24708
2020-11-24,25652,41,0,4,0,25697
2020-11-25,25665,21,0,26,119,25831
2020-11-26,25896,38,0,55,24,26013
2020-11-27,31164,16,0,0,197,31377
2020-11-28,22986,8,0,20,44,23058
2020-11-29,23830,19,0,2,87,23938
2020-11-30,26318,39,0,97,131,26585
2020-12-01,22044,17,0,1,36,22098
2020-12-02,20695,9,0,11,156,20871
2020-12-03,21191,35,0,0,8,21234
2020-12-04,25992,26,0,0,166,26184
2020-12-05,18370,18,0,18,28,18434
2020-12-06,19991,8,0,0,63,20062
2020-12-07,22009,14,0,2,89,22114
2020-12-08,21723,21,0,0,2,21746
2020-12-09,22880,8,0,65,190,23143
2020-12-10,24652,9,0,0,14,24675
2020-12-11,29622,28,0,0,139,29789
2020-12-12,23865,25,0,22,51,23963
2020-12-13,23002,10,0,0,88,23100
2020-12-14,22411,13,0,0,85,22509
2020-12-15,24225,25,0,1,1,24252
2020-12-16,29349,32,0,19,95,29495
2020-12-17,35101,12,0,14,18,35145
2020-12-18,48175,13,0,0,125,48313
2020-12-19,63525,59,0,57,92,63733
2020-12-20,38211,34,0,1,151,38397
2020-12-21,30367,26,0,49,105,30547
2020-12-22,29292,35,0,25,20,29372
2020-12-23,50122,34,20,67,165,50408
2020-12-24,44081,7,0,37,3,44128
2020-12-25,28059,7,0,0,77,28143
2020-12-26,16598,17,0,0,28,16643
2020-12-27,18120,11,0,28,158,18317
2020-12-28,19769,7,0,0,66,19842
2020-12-29,22299,16,0,34,3,22352
2020-12-30,28922,14,0,21,64,29021
2020-12-31,23011,7,0,0,2,23020
2021-01-01,27413,6,0,0,0,27419
2021-01-02,41132,10,0,78,230,41450
2021-01-03,43213,46,0,12,151,43422
2021-01-04,35987,10,0,0,125,36122
2021-01-05,35077,14,0,3,28,35122
2021-01-06,31888,13,0,43,95,32039
2021-01-07,34117,28,0,0,81,34226
2021-01-08,42714,16,0,32,114,42876
2021-01-09,43729,17,0,8,41,43795
2021-01-10,50835,10,0,0,320,51165
2021-01-11,32160,12,0,22,113,32307
2021-01-12,25943,12,0,31,27,26013
2021-01-13,26417,11,0,132,118,26678
2021-01-14,24478,6,0,45,22,24551
2021-01-15,26679,9,0,106,185,26979
2021-01-16,24987,13,0,131,35,25166
2021-01-17,25389,10,0,48,109,25556
2021-01-18,21491,13,0,74,121,21699
2021-01-19,23376,4,0,8,11,23399
2021-01-20,23658,9,0,18,109,23794
2021-01-21,26658,14,0,0,0,26672
2021-01-22,27213,12,0,7,86,27318
2021-01-23,26788,7,0,17,13,26825
2021-01-24,28792,8,0,1,170,28971
2021-01-25,24646,5,0,0,120,24771
2021-01-26,23143,5,0,0,0,23148
2021-01-27,25880,16,0,19,159,26074
2021-01-28,27840,16,0,0,19,27875
2021-01-29,30957,12,0,0,141,31110
2021-01-30,26872,11,0,23,24,26930
2021-01-31,26505,5,0,2,147,26659
2021-02-01,22874,13,0,0,112,22999
2021-02-02,25126,4,0,0,0,25130
2021-02-03,25644,4,0,28,170,25846
2021-02-04,26570,28,0,2,9,26609
2021-02-05,33164,8,0,21,146,33339
2021-02-06,29126,10,0,36,18,29190
2021-02-07,27431,13,0,0,140,27584
2021-02-08,28588,3,0,0,124,28715
2021-02-09,25717,10,0,0,0,25727
2021-02-10,27766,9,0,22,116,27913
2021-02-11,29610,7,0,2,20,29639
2021-02-12,35079,8,0,0,222,35309
2021-02-13,29810,7,0,27,75,29919
2021-02-14,30147,6,0,12,220,30385
2021-02-15,26713,12,0,9,209,26943
2021-02-16,27512,9,0,1,2,27524
2021-02-17,27206,6,0,17,120,27349
2021-02-18,29011,12,0,20,29,29072
2021-02-19,40459,12,0,0,184,40655
2021-02-20,35159,13,0,25,41,35238
2021-02-21,39563,11,0,2,134,39710
2021-02-22,31668,7,0,0,149,31824
2021-02-23,27088,9,0,0,0,27097
2021-02-24,30546,18,0,37,165,30766
2021-02-25,32039,10,0,0,28,32077
2021-02-26,39149,16,0,0,218,39383
2021-02-27,34868,9,0,34,67,34978
2021-02-28,38091,12,0,2,176,38281
2021-03-01,31807,14,0,7,126,31954
2021-03-02,30302,12,0,0,28,30342
2021-03-03,30167,19,0,25,170,30381
2021-03-04,34597,9,0,0,22,34628
2021-03-05,34942,20,0,2,198,35162
2021-03-06,32205,15,0,29,79,32328
2021-03-07,37305,8,0,2,170,37485
2021-03-08,29111,7,0,0,190,29308
2021-03-09,27559,16,0,2,45,27622
2021-03-10,30641,9,0,15,218,30883
2021-03-11,24442,6,0,6,93,24547
2021-03-12,34482,17,0,6,258,34763
2021-03-13,23953,7,0,72,125,24157
2021-03-14,23549,15,0,4,250,23818
2021-03-15,23290,9,0,28,219,23546
2021-03-16,27549,7,0,22,61,27639
2021-03-17,27790,6,0,27,228,28051
2021-03-18,29061,15,0,0,109,29185
2021-03-19,37129,19,0,10,230,37388
2021-03-20,31613,16,0,90,104,31823
2021-03-21,31900,6,0,3,161,32070
2021-03-22,26725,9,0,0,211,26945
2021-03-23,25569,16,0,9,34,25628
2021-03-24,29706,14,0,27,224,29971
2021-03-25,31527,22,0,6,374,31929
2021-03-26,49180,20,0,13,203,49416
2021-03-27,50320,30,0,39,280,50669
2021-03-28,36482,12,0,30,408,36932
2021-03-29,26564,17,0,1,219,26801
2021-03-30,31091,19,0,58,71,31239
2021-03-31,39010,30,0,55,297,39392
2021-04-01,52143,22,0,10,432,52607
2021-04-02,50129,30,0,22,396,50577
2021-04-03,30774,12,0,35,724,31545
2021-04-04,31036,9,0,4,266,31315
2021-04-05,41562,6,0,0,487,42055
2021-04-06,33300,8,0,0,42,33350
2021-04-07,31171,12,0,25,194,31402
2021-04-08,31139,15,0,2,258,31414
2021-04-09,40596,3,0,4,179,40782
2021-04-10,41957,18,0,29,540,42544
2021-04-11,34596,16,0,13,392,35017
2021-04-12,25728,10,0,0,328,26066
2021-04-13,26356,17,0,0,229,26602
2021-04-14,29322,14,0,40,397,29773
2021-04-15,32281,23,0,17,424,32745
2021-04-16,42031,22,0,2,286,42341
2021-04-17,35623,13,0,36,322,35994
2021-04-18,34028,15,0,0,319,34362
2021-04-19,28643,14,0,2,363,29022
2021-04-20,27582,17,0,6,95,27700
2021-04-21,32242,15,0,60,185,32502
2021-04-22,33190,24,0,41,413,33668
2021-04-23,59457,14,0,8,364,59843
2021-04-24,53402,15,0,103,470,53990
2021-04-25,41817,13,0,29,484,42343
2021-04-26,32602,18,0,19,532,33171
2021-04-27,33263,16,0,12,65,33356
2021-04-28,39228,21,0,61,564,39874
2021-04-29,51244,28,0,11,391,51674
2021-04-30,66691,19,0,13,875,67598
2021-05-01,48217,14,0,59,1256,49546
2021-05-02,37896,16,0,0,770,38682
2021-05-03,41914,18,0,18,322,42272
2021-05-04,34611,15,0,55,63,34744
2021-05-05,38184,27,0,108,606,38925
2021-05-06,37744,23,0,47,519,38333
2021-05-07,58825,45,0,11,765,59646
2021-05-08,61044,33,0,83,1330,62490
2021-05-09,53297,14,0,24,846,54181
2021-05-10,36453,21,0,13,552,37039
2021-05-11,41614,24,0,67,26,41731
2021-05-12,60011,34,0,146,853,61044
2021-05-13,62067,39,0,65,882,63053
2021-05-14,53942,34,0,41,613,54630
2021-05-15,64747,36,0,122,1037,65942
2021-05-16,83466,22,0,24,1012,84524
2021-05-17,44825,12,0,12,606,45455
2021-05-18,39852,32,0,38,197,40119
2021-05-19,43823,35,0,50,596,44504
2021-05-20,51503,35,0,33,822,52393
2021-05-21,82324,47,0,29,1239,83639
2021-05-22,88280,25,0,101,2566,90972
2021-05-23,64885,33,0,50,1220,66188
2021-05-24,53443,16,0,35,948,54442
2021-05-25,45777,20,0,147,386,46330
2021-05-26,48944,39,0,101,738,49822
2021-05-27,53542,32,0,57,1288,54919
2021-05-28,74638,44,0,80,1705,76467
2021-05-29,83522,263,0,241,3033,87059
2021-05-30,66035,40,0,40,1502,67617
2021-05-31,46841,213,0,26,853,47933
2021-06-01,47223,47,0,55,1517,48842
2021-06-02,84133,208,108,618,1800,86867
2021-06-03,83741,46,216,519,2989,87511
2021-06-04,78377,43,130,1174,2563,82287
2021-06-05,97218,341,200,2328,4503,104590
2021-06-06,91380,33,606,2241,3218,97478
2021-06-07,56619,219,0,63,1637,58538
2021-06-08,53308,41,0,45,1700,55094
2021-06-09,59375,236,0,127,1665,61403
2021-06-10,74757,48,0,30,2999,77834
2021-06-11,107304,43,0,1271,3354,111972
2021-06-12,107580,370,0,225,6192,114367
2021-06-13,90633,35,0,144,3971,94783
2021-06-14,68380,378,0,837,2257,71852
2021-06-15,63167,41,0,221,2098,65527
2021-06-16,74353,339,0,324,2632,77648
2021-06-17,86990,31,0,77,3851,90949
2021-06-18,137545,63,8,1875,3973,143464
2021-06-19,147373,637,0,268,9133,157411
2021-06-20,122861,50,0,123,4884,127918
2021-06-21,84785,471,0,733,3280,89269
2021-06-22,74466,40,0,321,3273,78100
2021-06-23,94024,536,0,204,3755,98519
2021-06-24,156923,64,0,305,5315,162607
2021-06-25,157396,90,146,2041,5965,165638
2021-06-26,178418,694,0,1572,11175,191859
2021-06-27,142298,74,0,281,6838,149491
2021-06-28,93175,562,0,878,4591,99206
2021-06-29,81302,82,0,319,4823,86526
2021-06-30,99754,674,0,220,4709,105357
2021-07-01,138468,168,0,299,8810,147745
2021-07-02,191747,583,0,3413,8857,204600
2021-07-03,210246,920,0,2127,16953,230246
2021-07-04,188784,667,0,325,11279,201055
2021-07-05,128996,636,0,1079,8102,138813
2021-07-06,87043,637,0,881,6371,94932
2021-07-07,91444,922,0,359,7745,100470
2021-07-08,126484,566,236,674,8145,136105
2021-07-09,179445,691,0,2250,10791,193177
2021-07-10,242019,734,0,2821,15155,260729
2021-07-11,167886,644,241,740,12365,181876
2021-07-12,155814,728,0,1301,9193,167036
2021-07-13,122200,745,0,639,8820,132404
2021-07-14,138023,787,110,343,9083,148346
2021-07-15,147766,654,213,1267,10983,160883
2021-07-16,228190,816,0,1739,12680,243425
2021-07-17,261108,878,133,2321,20087,284527
2021-07-18,217115,745,0,1124,14903,233887
2021-07-19,184754,631,113,2566,12046,200110
2021-07-20,145534,781,0,1170,11411,158896
2021-07-21,144863,703,0,1349,11135,158050
2021-07-22,164029,593,229,1043,13257,179151
2021-07-23,252914,676,0,4025,14533,272148
2021-07-24,315229,930,0,2862,22878,341899
2021-07-25,266062,761,0,908,18865,286596
2021-07-26,178054,858,103,3036,10868,192919
2021-07-27,163540,689,0,1001,12463,177693
2021-07-28,152828,708,83,756,11269,165644
2021-07-29,187399,665,150,1118,13066,202398
2021-07-30,310780,1000,0,2848,15731,330359
2021-07-31,411478,911,0,3942,24310,440641
2021-08-01,342779,747,0,1385,19198,364109
2021-08-02,231901,776,0,4071,15621,252369
2021-08-03,179290,932,0,1631,11967,193820
2021-08-04,176061,1035,0,307,14175,191578
2021-08-05,219847,685,360,1841,14955,237688
2021-08-06,292467,943,58,5613,15733,314814
2021-08-07,349037,947,0,5786,20560,376330
2021-08-08,304035,838,0,2176,19824,326873
2021-08-09,257945,1250,202,4940,13883,278220
2021-08-10,194496,824,126,2119,13825,211390
2021-08-11,195223,816,70,1330,13619,211058
2021-08-12,230023,726,152,1776,15270,247947
2021-08-13,274673,845,59,6081,14376,296034
2021-08-14,379499,1039,0,5442,25767,411747
2021-08-15,309091,694,0,2158,19708,331651
2021-08-16,256109,830,109,3964,14968,275980
2021-08-17,185236,983,0,1367,12785,200371
2021-08-18,192203,714,119,757,13497,207290
2021-08-19,222328,736,191,1786,14942,239983
2021-08-20,268430,906,131,6019,14910,290396
2021-08-21,339195,915,2,3998,21512,365622
2021-08-22,291490,1047,181,1201,18686,312605
2021-08-23,234228,828,81,3418,11245,249800
2021-08-24,187812,790,86,1011,11920,201619
2021-08-25,180529,703,4,1007,11269,193512
2021-08-26,207368,582,353,1008,13511,222822
2021-08-27,243160,1420,66,6575,11992,263213
2021-08-28,270314,432,0,3640,19796,294182
2021-08-29,225092,531,0,1732,15073,242428
2021-08-30,185814,405,305,3825,9804,200153
2021-08-31,151466,689,92,702,10110,163059
2021-09-01,143911,563,124,227,11538,156363
2021-09-02,147517,178,345,1690,12479,162209
2021-09-03,191283,262,443,5663,12751,210402
2021-09-04,194327,659,131,3262,20618,218997
2021-09-05,182045,245,0,218,15274,197782
2021-09-06,137912,589,0,3972,9115,151588
2021-09-07,106727,211,208,1936,9564,118646
2021-09-08,109506,654,177,1154,8987,120478
2021-09-09,128055,142,336,779,11570,140882
2021-09-10,164175,347,372,6771,11246,182911
2021-09-11,176973,743,0,3486,21287,202489
2021-09-12,149640,156,54,829,11226,161905
2021-09-13,107095,503,124,4182,8684,120588
2021-09-14,87362,123,145,688,8659,96977
2021-09-15,93055,518,123,2756,8950,105402
2021-09-16,92410,139,830,632,8364,102375
2021-09-17,121064,153,216,5562,10283,137278
2021-09-18,119811,827,139,3063,19120,142960
2021-09-19,107960,140,0,765,10930,119795
2021-09-20,87212,190,89,2629,7172,97292
2021-09-21,70133,169,148,1156,7239,78845
2021-09-22,80177,301,62,997,6541,88078
2021-09-23,82506,164,253,1876,8600,93399
2021-09-24,122537,87,125,4321,9112,136182
2021-09-25,113197,465,363,3755,16828,134608
2021-09-26,99736,164,0,478,7895,108273
2021-09-27,65157,203,97,1330,5153,71940
2021-09-28,64914,79,0,801,5338,71132
2021-09-29,67140,122,133,168,4895,72458
2021-09-30,70318,58,279,1343,5883,77881
2021-10-01,95951,195,146,4077,7280,107649
2021-10-02,101130,57,104,3114,11724,116129
2021-10-03,84808,118,0,2892,5903,93721
2021-10-04,66041,64,135,10,3366,69616
2021-10-05,49312,143,184,517,4069,54225
2021-10-06,54400,49,178,2696,3484,60807
2021-10-07,62880,30,119,494,5222,68745
2021-10-08,86905,61,90,2755,5998,95809
2021-10-09,80177,200,99,2591,11579,94646
2021-10-10,77407,58,0,108,6043,83616
2021-10-11,58651,18,101,55,4233,63058
2021-10-12,52583,59,55,359,3929,56985
2021-10-13,51210,29,0,316,3195,54750
2021-10-14,56272,69,410,27,4588,61366
2021-10-15,90722,61,562,1331,5538,98214
2021-10-16,79472,201,96,6545,10857,97171
2021-10-17,77464,80,4,2546,5563,85657
2021-10-18,55594,91,104,1594,4078,61461
2021-10-19,50651,100,168,380,3642,54941
2021-10-20,55271,136,61,1332,2888,59688
2021-10-21,60794,85,0,2058,4334,67271
2021-10-22,96819,118,189,2129,4389,103644
2021-10-23,97583,91,135,2467,9166,109442
2021-10-24,84047,86,231,1748,5218,91330
2021-10-25,61416,49,110,481,2881,64937
2021-10-26,62194,44,0,1046,2365,65649
2021-10-27,72323,64,0,2740,1387,76514
2021-10-28,73298,48,116,449,2028,75939
2021-10-29,104398,133,291,627,2046,107495
2021-10-30,86292,84,0,3763,2599,92738
2021-10-31,71685,47,0,1339,1273,74344
2021-11-01,86328,78,54,396,1004,87860
2021-11-02,60478,38,45,2645,1430,64636
2021-11-03,47484,49,0,107,706,48346
2021-11-04,55765,93,122,3,896,56879
2021-11-05,65294,72,73,668,750,66857
2021-11-06,60219,192,127,2890,991,64419
2021-11-07,56027,69,0,1924,1276,59296
2021-11-08,44134,69,66,730,930,45929
2021-11-09,37491,52,0,1643,515,39701
2021-11-10,44619,58,0,960,673,46310
2021-11-11,51705,32,0,1203,1034,53974
2021-11-12,61646,202,47,123,730,62748
2021-11-13,51303,65,0,94,1000,52462
2021-11-14,57296,28,0,986,1091,59401
2021-11-15,39449,22,104,11,732,40318
2021-11-16,39539,53,75,0,454,40121
2021-11-17,45876,40,0,120,575,46611
2021-11-18,45268,50,0,469,821,46608
2021-11-19,61986,42,0,3,658,62689
2021-11-20,48912,48,0,54,635,49649
2021-11-21,60225,37,0,954,578,61794
2021-11-22,45352,54,0,33,1049,46488
2021-11-23,38927,46,0,4,355,39332
2021-11-24,43966,39,0,53,653,44711
2021-11-25,49297,38,0,1,852,50188
2021-11-26,53050,60,65,2,549,53726
2021-11-27,41591,66,0,37,808,42502
2021-11-28,53686,41,0,611,552,54890
2021-11-29,41019,20,0,8,946,41993
2021-11-30,36429,29,0,31,629,37118
2021-12-01,36552,27,0,46,588,37213
2021-12-02,39824,59,0,9,1058,40950
2021-12-03,56440,32,0,0,682,57154
2021-12-04,47288,150,0,62,1052,48552
2021-12-05,42839,40,0,4,896,43779
2021-12-06,37756,65,0,2,798,38621
2021-12-07,39661,33,0,7,449,40150
2021-12-08,39532,39,0,59,478,40108
2021-12-09,33727,23,0,13,928,34691
2021-12-10,52954,62,0,0,683,53699
2021-12-11,49900,60,0,86,949,50995
2021-12-12,50990,74,0,0,751,51815
2021-12-13,35483,17,0,4,1008,36512
2021-12-14,39610,55,0,2,452,40119
2021-12-15,48698,26,0,52,808,49584
2021-12-16,46931,43,0,2,997,47973
2021-12-17,69656,45,0,5,874,70580
2021-12-18,83532,294,0,40,845,84711
2021-12-19,63833,148,0,0,948,64929
2021-12-20,52513,65,0,0,912,53490
2021-12-21,53082,88,0,17,570,53757
2021-12-22,83875,153,0,60,676,84764
2021-12-23,138476,114,0,2,1142,139734
2021-12-24,117776,103,0,67,706,118652
2021-12-25,61832,132,0,0,341,62305
2021-12-26,62529,72,0,0,1139,63740
2021-12-27,62386,278,0,3,1101,63768
2021-12-28,60146,167,0,7,1086,61406
2021-12-29,63198,133,0,87,898,64316
2021-12-30,91782,223,0,26,958,92989
2021-12-31,56594,181,0,41,436,57252
2022-01-01,71329,40,0,8,578,71955
2022-01-02,92768,87,0,0,1006,93861
2022-01-03,68477,62,0,0,896,69435
2022-01-04,60801,50,0,2,607,61460
2022-01-05,69364,32,0,50,532,69978
2022-01-06,71777,39,0,0,484,72300
2022-01-07,86030,49,0,1,560,86640
2022-01-08,124662,35,0,29,727,125453
2022-01-09,123360,39,0,3,805,124207
2022-01-10,68039,25,0,8,686,68758
2022-01-11,45200,32,0,0,332,45564
2022-01-12,45610,41,0,50,426,46127
2022-01-13,44460,48,0,6,514,45028
2022-01-14,59598,57,0,15,620,60290
2022-01-15,57811,43,0,24,584,58462
2022-01-16,55784,25,0,0,633,56442
2022-01-17,40696,48,0,3,684,41431
2022-01-18,35521,30,0,8,381,35940
2022-01-19,39037,23,0,36,469,39565
2022-01-20,39972,27,0,2,537,40538
2022-01-21,50729,77,0,0,733,51539
2022-01-22,47048,7,0,31,567,47653
2022-01-23,50502,76,0,0,560,51138
2022-01-24,38050,19,0,7,549,38625
2022-01-25,34413,62,0,10,303,34788
2022-01-26,37329,9,0,42,427,37807
2022-01-27,38480,67,0,0,587,39134
2022-01-28,52731,22,0,11,691,53455
2022-01-29,45245,28,0,43,554,45870
2022-01-30,51528,16,0,0,559,52103
2022-01-31,35753,18,0,485,531,36787
2022-02-01,35479,22,0,2,363,35866
2022-02-02,36749,67,0,39,454,37309
2022-02-03,44080,46,0,0,683,44809
2022-02-04,57032,54,0,21,564,57671
2022-02-05,59955,59,0,32,590,60636
2022-02-06,52272,51,0,13,629,52965
2022-02-07,43968,56,0,0,719,44743
2022-02-08,48485,65,0,0,387,48937
2022-02-09,42764,66,0,35,410,43275
2022-02-10,44397,54,0,1,799,45251
2022-02-11,58144,82,0,0,957,59183
2022-02-12,59072,61,0,21,789,59943
2022-02-13,63814,118,0,8,884,64824
2022-02-14,41856,43,0,0,803,42702
2022-02-15,42008,35,0,8,500,42551
2022-02-16,42023,24,0,57,468,42572
2022-02-17,51808,71,0,9,743,52631
2022-02-18,68243,70,0,2,863,69178
2022-02-19,62357,38,0,43,865,63303
2022-02-20,70058,48,0,2,1070,71178
2022-02-21,48747,39,0,632,966,50384
2022-02-22,43773,46,0,4,635,44458
2022-02-23,50754,20,0,668,815,52257
2022-02-24,56406,27,0,11,919,57363
2022-02-25,77293,34,0,0,1032,78359
2022-02-26,76035,83,0,64,982,77164
2022-02-27,78361,22,0,0,947,79330
2022-02-28,50406,33,0,3,800,51242
2022-03-01,46929,15,0,4,645,47593
2022-03-02,47944,41,0,59,607,48651
2022-03-03,56175,32,0,3,1138,57348
2022-03-04,68674,38,0,13,752,69477
2022-03-05,71822,21,0,54,1007,72904
2022-03-06,72137,49,0,4,1136,73326
2022-03-07,47710,60,0,51,943,48764
2022-03-08,39043,56,0,0,785,39884
2022-03-09,42173,57,0,46,720,42996
2022-03-10,51714,57,0,568,1138,53477
2022-03-11,73423,17,0,5,926,74371
2022-03-12,62191,19,0,40,823,63073
2022-03-13,71779,52,0,25,1032,72888
2022-03-14,46043,92,0,518,835,47488
2022-03-15,46201,61,0,515,777,47554
2022-03-16,49960,92,0,197,837,51086
2022-03-17,58030,74,0,26,1219,59349
2022-03-18,73439,111,106,519,884,75059
2022-03-19,67799,102,0,559,922,69382
2022-03-20,74467,47,0,54,1158,75726
2022-03-21,51195,72,0,15,939,52221
2022-03-22,46023,73,0,13,699,46808
2022-03-23,50243,65,86,53,873,51320
2022-03-24,53156,57,0,5,1202,54420
2022-03-25,86167,43,230,590,951,87981
2022-03-26,71110,68,117,588,1243,73126
2022-03-27,75372,27,0,26,3272,78697
2022-03-28,47694,41,97,12,2313,50157
2022-03-29,44482,67,0,569,2526,47644
2022-03-30,47167,96,0,976,2579,50818
2022-03-31,55330,54,0,257,3093,58734
2022-04-01,64807,84,85,264,3032,68272
2022-04-02,61875,63,67,90,4339,66434
2022-04-03,70841,81,74,10,4305,75311
2022-04-04,53884,53,58,13,3008,57016
2022-04-05,45330,53,114,33,3079,48609
2022-04-06,54544,47,0,90,2392,57073
2022-04-07,60382,48,225,531,4217,65403
2022-04-08,87198,32,58,308,3793,91389
2022-04-09,93736,60,0,2204,9347,105347
2022-04-10,94033,87,0,549,8217,102886
2022-04-11,64114,76,105,3665,3972,71932
2022-04-12,64167,42,0,3722,3577,71508
2022-04-13,74098,78,69,1484,5586,81315
2022-04-14,123148,96,100,3289,5946,132579
2022-04-15,200845,129,200,2995,5613,209782
2022-04-16,116898,52,191,3006,9310,129457
2022-04-17,102401,122,0,760,5976,109259
2022-04-18,141765,51,85,789,3946,146636
2022-04-19,87226,99,124,49,4174,91672
2022-04-20,68910,57,90,129,4285,73471
2022-04-21,80520,99,280,3305,4905,89109
2022-04-22,114935,36,344,18,3198,118531
2022-04-23,125295,73,134,1573,9240,136315
2022-04-24,86478,25,98,1897,6572,95070
2022-04-25,94425,101,153,1787,4180,100646
2022-04-26,96550,66,69,1774,4381,102840
2022-04-27,116613,95,107,2084,5427,124326
2022-04-28,108389,39,192,2326,7057,118003
2022-04-29,141734,93,122,2254,4363,148566
2022-04-30,142930,91,217,3687,11483,158408
2022-05-01,100609,114,105,4320,9806,114954
2022-05-02,89868,51,0,1720,5423,97062
2022-05-03,83587,49,157,3585,5760,93138
2022-05-04,71881,49,112,1984,6480,80506
2022-05-05,80425,36,360,1828,8176,90825
2022-05-06,97896,56,91,988,6413,105444
2022-05-07,98109,62,103,2127,10670,111071
2022-05-08,120776,56,96,1972,9302,132202
2022-05-09,80287,105,181,1324,5098,86995
2022-05-10,64887,42,118,3836,6231,75114
2022-05-11,66485,65,130,4423,7566,78669
2022-05-12,79021,161,106,2823,9759,91870
2022-05-13,109565,218,423,2660,7320,120186
2022-05-14,102396,92,233,1430,16032,120183
2022-05-15,103835,93,202,5621,11737,121488
2022-05-16,72943,114,106,1727,6226,81116
2022-05-17,66565,91,0,1665,6608,74929
2022-05-18,71741,144,276,2334,8594,83089
2022-05-19,79623,146,301,3810,9326,93206
2022-05-20,103347,179,296,168,8115,112105
2022-05-21,126905,216,0,4294,22009,153424
2022-05-22,121908,258,306,2123,14720,139315
2022-05-23,80779,140,320,5249,7728,94216
2022-05-24,73901,180,0,3866,9728,87675
2022-05-25,116412,123,172,5900,11945,134552
2022-05-26,146242,93,186,2261,14735,163517
2022-05-27,115044,57,763,4312,9212,129388
2022-05-28,107171,117,198,2856,17644,127986
2022-05-29,122374,109,122,274,15301,138180
2022-05-30,86302,91,214,2380,7735,96722
2022-05-31,76444,128,269,956,10302,88099
2022-06-01,107289,111,180,1305,13355,122240
2022-06-02,142637,67,173,4717,14738,162332
2022-06-03,225989,67,194,4647,11304,242201
2022-06-04,246843,546,195,6833,24768,279185
2022-06-05,175681,210,200,6106,15103,197300
2022-06-06,133667,369,205,4602,9745,148588
2022-06-07,102815,56,115,6832,14345,124163
2022-06-08,103943,481,179,6478,12339,123420
2022-06-09,124337,42,0,660,12443,137482
2022-06-10,194859,25,591,4111,13135,212721
2022-06-11,225259,594,79,5112,25727,256771
2022-06-12,208014,152,158,3426,18676,230426
2022-06-13,123155,580,280,4215,9044,137274
2022-06-14,106151,89,90,3328,13799,123457
2022-06-15,170185,502,88,1912,13787,186474
2022-06-16,222481,168,355,5278,16954,245236
2022-06-17,207301,258,197,593,12761,221110
2022-06-18,252871,73,199,7759,21580,282482
2022-06-19,240410,133,146,1696,18815,261200
2022-06-20,164866,545,140,6429,13799,185779
2022-06-21,123534,131,214,6877,14657,145413
2022-06-22,124953,708,131,6353,15331,147476
2022-06-23,158804,68,135,5038,17558,181603
2022-06-24,222328,116,502,4788,16426,244160
2022-06-25,290736,803,246,3367,28052,323204
2022-06-26,232661,234,135,3679,22209,258918
2022-06-27,192403,533,286,4401,18437,216060
2022-06-28,130912,100,546,6393,18737,156688
2022-06-29,136438,553,342,3857,18556,159746
2022-06-30,167368,580,254,5381,18049,191632
2022-07-01,266852,1061,115,5848,20837,294713
2022-07-02,245039,994,254,11368,30752,288407
2022-07-03,243805,780,169,4497,25744,274995
2022-07-04,173634,699,127,5818,19432,199710
2022-07-05,131985,816,79,3129,19223,155232
2022-07-06,152703,1040,90,6284,20303,180420
2022-07-07,196197,2445,97,3198,22225,224162
2022-07-08,263178,876,424,3701,20046,288225
2022-07-09,298013,1110,68,5879,32000,337070
2022-07-10,262159,1137,0,2626,26563,292485
2022-07-11,238757,1357,123,6772,18542,265551
2022-07-12,153482,1017,252,7133,20758,182642
2022-07-13,169874,1114,110,3942,21275,196315
2022-07-14,193481,891,304,6214,21345,222235
2022-07-15,298856,1298,398,4789,21093,326434
2022-07-16,394229,1212,131,12068,31720,439360
2022-07-17,341272,1161,0,7361,25883,375677
2022-07-18,265775,1325,141,7331,19654,294226
2022-07-19,173631,1114,57,9238,22066,206106
2022-07-20,183007,678,0,8303,22858,214846
2022-07-21,218432,624,138,3902,23327,246423
2022-07-22,296864,1445,198,7040,21674,327221
2022-07-23,434669,1327,130,5941,32828,474895
2022-07-24,315688,1309,65,3024,28261,348347
2022-07-25,256133,796,132,6061,17516,280638
2022-07-26,205542,884,106,1714,22566,230812
2022-07-27,212528,1212,46,3519,20995,238300
2022-07-28,238194,919,132,7160,26141,272546
2022-07-29,374031,819,137,5033,24458,404478
2022-07-30,425065,1564,285,11608,36728,475250
2022-07-31,381903,1218,136,7496,31709,422462
2022-08-01,304303,1288,201,10420,24779,340991
2022-08-02,203614,962,200,5715,27652,238143
2022-08-03,224887,1226,0,7448,25289,258850
2022-08-04,263634,1245,70,4171,25147,294267
2022-08-05,325150,1833,152,4272,24715,356122
2022-08-06,431577,1424,90,12456,36049,481596
2022-08-07,325948,949,96,8519,29884,365396
2022-08-08,303637,1148,87,11660,22318,338850
2022-08-09,212901,1111,158,11140,24653,249963
2022-08-10,227767,921,67,1667,24046,254468
2022-08-11,242931,1108,150,7402,23826,275417
2022-08-12,357544,1705,162,3058,23042,385511
2022-08-13,416806,1326,0,16754,34174,469060
2022-08-14,351414,1268,0,6175,28907,387764
2022-08-15,319337,1383,134,11261,20789,352904
2022-08-16,217554,1672,80,4499,24146,247951
2022-08-17,227447,1378,226,8277,20773,258101
2022-08-18,238641,727,0,6539,23284,269191
2022-08-19,320452,1173,109,6356,18682,346772
2022-08-20,361317,1501,79,10492,32876,406265
2022-08-21,316087,1263,67,2377,28563,348357
2022-08-22,261850,961,231,8932,19816,291790
2022-08-23,196404,1172,0,1358,21873,220807
2022-08-24,218453,1423,0,3672,19311,242859
2022-08-25,256650,681,0,7598,21677,286606
2022-08-26,273424,1130,128,5266,21373,301321
2022-08-27,336705,974,429,15101,26579,379788
2022-08-28,281760,993,0,7215,23317,313285
2022-08-29,235187,614,162,10778,15828,262569
2022-08-30,180652,912,129,5957,17606,205256
2022-08-31,73226,145,80,4307,10748,88506
2022-09-01,179213,878,0,3321,21241,204653
2022-09-02,220688,669,235,3198,21016,245806
2022-09-03,273935,1118,213,7123,33617,316006
2022-09-04,239723,270,145,2739,25819,268696
2022-09-05,159223,646,207,4335,16889,181300
2022-09-06,126609,302,372,5404,19375,152062
2022-09-07,112849,998,321,1722,17169,133059
2022-09-08,139040,154,495,5908,18786,164383
2022-09-09,176016,692,111,962,19953,197734
2022-09-10,209008,799,178,8377,30857,249219
2022-09-11,181108,394,116,3266,23013,207897
2022-09-12,125599,678,167,3166,14941,144551
2022-09-13,98062,337,88,3938,17883,120308
2022-09-14,104448,632,201,6731,17074,129086
2022-09-15,104743,243,201,2162,19270,126619
2022-09-16,148285,534,303,4132,13808,167062
2022-09-17,148225,672,213,4966,28984,183060
2022-09-18,156641,368,0,902,22486,180397
2022-09-19,111922,729,148,2273,12308,127380
2022-09-20,96878,370,143,3851,16390,117632
2022-09-21,98830,494,485,2997,15961,118767
2022-09-22,112650,282,216,5983,16893,136024
2022-09-23,141112,290,111,3123,16548,161184
2022-09-24,127103,507,237,11255,25053,164155
2022-09-25,121323,364,0,5149,16391,143227
2022-09-26,92979,257,125,3016,11348,107725
2022-09-27,77692,105,139,4811,12324,95071
2022-09-28,82706,149,0,5267,12284,100406
2022-09-29,89171,208,90,3987,15315,108771
2022-09-30,120801,307,516,3451,12471,137546
2022-10-01,114846,112,429,6205,21404,142996
2022-10-02,115372,215,98,3102,14851,133638
2022-10-03,85035,202,363,5206,7649,98455
2022-10-04,68881,285,353,3314,10645,83478
2022-10-05,68716,302,172,2707,7814,79711
2022-10-06,82134,134,538,3764,11954,98524
2022-10-07,111005,191,253,3184,11054,125687
2022-10-08,106289,354,53,7614,17757,132067
2022-10-09,96928,190,64,2958,11203,111343
2022-10-10,66947,471,146,6492,8963,83019
2022-10-11,61104,66,262,8780,8433,78645
2022-10-12,66283,167,243,6986,7682,81361
2022-10-13,79758,186,96,3086,10128,93254
2022-10-14,108028,741,293,2502,9492,121056
2022-10-15,106197,606,168,5777,15746,128494
2022-10-16,106568,130,93,3262,11298,121351
2022-10-17,71042,139,254,3036,6874,81345
2022-10-18,60580,550,147,231,8478,69986
2022-10-19,68416,202,360,1493,6649,77120
2022-10-20,73226,145,80,4307,10748,88506
2022-10-21,99931,144,203,486,9036,109800
2022-10-22,96364,299,280,7734,15099,119776
2022-10-23,94798,141,0,3811,10579,109329
2022-10-24,64402,153,283,1326,7935,74099
2022-10-25,64346,102,251,2702,6437,73838
2022-10-26,86282,121,0,3568,5313,95284
2022-10-27,84225,222,0,2431,6920,93798
2022-10-28,143568,482,182,2082,5042,151356
2022-10-29,151064,186,75,4904,5720,161949
2022-10-30,106400,192,0,4021,2463,113076
2022-10-31,100390,245,141,2651,3460,106887
2022-11-01,119680,205,0,48,2567,122500
2022-11-02,85808,95,0,130,2270,88303
2022-11-03,67413,240,116,1254,1946,70969
2022-11-04,80015,100,126,2753,1508,84502
