,Cestovni,Željeznički,Riječni,Pomorski,Zračni,UKUPNO
2013-01-01,65594,1216,0,218,2126,69154
2013-01-02,95781,890,0,506,2296,99473
2013-01-03,80689,699,0,716,2000,84104
2013-01-04,107390,760,3,504,3062,111719
2013-01-05,139630,745,0,11,1511,141897
2013-01-06,117451,583,0,215,1949,120198
2013-01-07,64035,571,0,0,1677,66283
2013-01-08,69060,589,0,1,1145,70795
2013-01-09,54498,513,0,7,1109,56127
2013-01-10,58284,386,0,97,1072,59839
2013-01-11,63894,479,0,0,1432,65805
2013-01-12,71185,442,0,5,837,72469
2013-01-13,70812,468,0,113,1112,72505
2013-01-14,44019,410,0,0,954,45383
2013-01-15,47408,455,0,1,764,48628
2013-01-16,48614,408,0,2,1034,50058
2013-01-17,44653,351,0,62,805,45871
2013-01-18,56012,402,0,46,1018,57478
2013-01-19,58890,475,0,0,859,60224
2013-01-20,60832,427,0,77,1426,62762
2013-01-21,54248,422,0,0,591,55261
2013-01-22,47913,425,0,0,730,49068
2013-01-23,46665,416,0,4,910,47995
2013-01-24,50912,442,0,84,918,52356
2013-01-25,50427,375,0,49,1190,52041
2013-01-26,57218,459,0,1,852,58530
2013-01-27,60576,473,0,69,1755,62873
2013-01-28,46028,457,0,4,1452,47941
2013-01-29,43983,436,0,2,715,45136
2013-01-30,49738,392,0,46,967,51143
2013-01-31,55356,396,0,58,897,56707
2013-02-01,59415,434,0,0,1171,61020
2013-02-02,57570,407,0,1,658,58636
2013-02-03,59116,450,0,137,1201,60904
2013-02-04,51391,461,0,1,898,52751
2013-02-05,50154,437,0,2,830,51423
2013-02-06,45068,438,0,1,1000,46507
2013-02-07,52810,339,0,72,1149,54370
2013-02-08,60727,409,0,51,1292,62479
2013-02-09,63872,410,0,7,791,65080
2013-02-10,73074,589,0,73,1256,74992
2013-02-11,49980,316,0,49,956,51301
2013-02-12,44340,386,0,0,511,45237
2013-02-13,47957,405,0,0,931,49293
2013-02-14,47923,602,0,43,1063,49631
2013-02-15,52065,425,0,113,1396,53999
2013-02-16,62701,383,0,2,983,64069
2013-02-17,75172,422,0,93,1574,77261
2013-02-18,54244,321,0,0,1119,55684
2013-02-19,47514,337,0,7,809,48667
2013-02-20,48025,373,0,55,1224,49677
2013-02-21,52819,379,0,108,1195,54501
2013-02-22,53755,463,0,12,1728,55958
2013-02-23,51292,391,0,0,883,52566
2013-02-24,57830,409,0,56,1831,60126
2013-02-25,52123,373,0,0,1167,53663
2013-02-26,47399,378,0,0,779,48556
2013-02-27,54044,351,0,9,1041,55445
2013-02-28,59741,364,0,98,1122,61325
2013-03-01,71910,388,0,47,1522,73867
2013-03-02,66584,366,0,7,1098,68055
2013-03-03,85549,404,0,190,1922,88065
2013-03-04,60667,344,0,49,1209,62269
2013-03-05,53103,370,0,0,772,54245
2013-03-06,54564,267,0,0,1322,56153
2013-03-07,56135,379,0,162,1336,58012
2013-03-08,67517,354,0,51,1778,69700
2013-03-09,66444,362,0,10,922,67738
2013-03-10,83169,382,0,129,1864,85544
2013-03-11,57030,330,0,1,1371,58732
2013-03-12,53813,400,0,146,987,55346
2013-03-13,53690,352,0,9,1307,55358
2013-03-14,47257,397,2,90,1708,49454
2013-03-15,66329,361,0,6,1856,68552
2013-03-16,74515,324,0,31,1207,76077
2013-03-17,87623,468,0,256,2087,90434
2013-03-18,55137,377,0,0,1418,56932
2013-03-19,56080,326,0,948,326,57680
2013-03-20,57827,338,0,11,1358,59534
2013-03-21,58889,558,0,122,198,59767
2013-03-22,81326,514,0,22,1980,83842
2013-03-23,91911,412,160,3852,1605,97940
2013-03-24,84255,380,0,257,2062,86954
2013-03-25,50425,425,0,0,1559,52409
2013-03-26,53642,478,0,207,1441,55768
2013-03-27,71008,506,0,74,1713,73301
2013-03-28,87687,532,0,273,1391,89883
2013-03-29,115346,708,0,3949,1804,121807
2013-03-30,82423,574,0,5247,1633,89877
2013-03-31,76936,358,0,3187,2969,83450
2013-04-01,134117,496,180,1280,3810,139883
2013-04-02,95220,529,0,1888,3351,100988
2013-04-03,66951,503,0,1964,2372,71790
2013-04-04,65308,365,256,425,2252,68606
2013-04-05,76086,462,125,6124,3264,86061
2013-04-06,99291,600,275,6055,3946,110167
2013-04-07,103905,561,0,3013,4046,111525
2013-04-08,58673,414,173,300,3757,63317
2013-04-09,57087,443,0,89,3012,60631
2013-04-10,63973,437,0,147,2568,67125
2013-04-11,64406,533,166,966,2488,68559
2013-04-12,72050,568,0,5286,1650,79554
2013-04-13,84656,471,91,6916,4116,96250
2013-04-14,117672,863,94,2807,3521,124957
2013-04-15,63751,531,285,1019,3323,68909
2013-04-16,54699,495,0,197,3053,58444
2013-04-17,65782,420,64,1587,2592,70445
2013-04-18,71064,430,181,1928,1296,74899
2013-04-19,74507,402,141,3995,3484,82529
2013-04-20,88656,437,0,6734,5071,100898
2013-04-21,122633,566,135,3601,4233,131168
2013-04-22,68181,518,310,1798,3343,74150
2013-04-23,63375,404,0,357,3078,67214
2013-04-24,69630,461,0,854,3279,74224
2013-04-25,89947,575,465,3302,3070,97359
2013-04-26,98854,583,0,5880,5007,110324
2013-04-27,142877,812,155,7481,8730,160055
2013-04-28,136898,587,159,8942,4626,151212
2013-04-29,92665,554,133,539,4190,98081
2013-04-30,110908,542,0,1877,3582,116909
2013-05-01,135944,650,0,2493,3660,142747
2013-05-02,125101,434,325,8710,3180,137750
2013-05-03,113835,479,320,7822,3912,126368
2013-05-04,192651,645,0,10049,11359,214704
2013-05-05,204193,842,0,8092,7460,220587
2013-05-06,97533,563,281,2592,5407,106376
2013-05-07,74412,552,118,5362,4627,85071
2013-05-08,72774,606,204,2795,4683,81062
2013-05-09,97923,424,0,9825,5017,113189
2013-05-10,91042,522,268,7501,5930,105263
2013-05-11,104863,899,0,7109,14974,127845
2013-05-12,164804,875,0,11386,9117,186182
2013-05-13,78984,555,0,574,6890,87003
2013-05-14,69343,498,158,1169,5591,76759
2013-05-15,71960,666,82,1159,4411,78278
2013-05-16,83030,584,173,4014,5087,92888
2013-05-17,103648,530,214,9969,5000,119361
2013-05-18,106508,580,288,7032,13298,127706
2013-05-19,115210,1018,0,8100,7547,131875
2013-05-20,118759,682,181,3331,4733,127686
2013-05-21,90649,612,86,6653,6839,104839
2013-05-22,80296,601,139,3990,5574,90600
2013-05-23,81693,548,138,7734,4890,95003
2013-05-24,106920,560,121,7976,5553,121130
2013-05-25,112146,917,116,11232,16046,140457
2013-05-26,118345,761,0,10259,8714,138079
2013-05-27,79605,708,321,6494,6268,93396
2013-05-28,75681,593,69,1156,7195,84694
2013-05-29,92195,618,214,2683,6751,102461
2013-05-30,112614,437,341,6185,5689,125266
2013-05-31,110065,593,132,10521,6214,127525
2013-06-01,128455,610,131,10428,17805,157429
2013-06-02,180195,721,243,7290,9570,198019
2013-06-03,91618,718,523,5419,6988,105266
2013-06-04,83061,601,103,3515,6757,94037
2013-06-05,77268,617,444,4759,6227,89315
2013-06-06,82669,605,0,4119,4148,91541
2013-06-07,100611,621,0,7163,5608,114003
2013-06-08,122841,784,84,10097,18540,152346
2013-06-09,163898,733,0,7006,10395,182032
2013-06-10,88297,612,0,3262,7434,99605
2013-06-11,78695,675,0,4525,6739,90634
2013-06-12,77169,642,0,965,6697,85473
2013-06-13,88876,676,0,1465,7013,98030
2013-06-14,117326,724,0,14665,6447,139162
2013-06-15,139813,819,0,11664,20858,173154
2013-06-16,198428,947,0,12786,10447,222608
2013-06-17,100264,924,0,2199,7282,110669
2013-06-18,91398,746,0,7170,7439,106753
2013-06-19,94460,960,0,2917,7555,105892
2013-06-20,107001,807,0,5779,7361,120948
2013-06-21,142242,803,0,6958,8437,158440
2013-06-22,188611,1201,0,12702,22265,224779
2013-06-23,190954,1192,61,11614,11388,215209
2013-06-24,125345,862,0,5012,7638,138857
2013-06-25,135118,909,336,4331,8599,149293
2013-06-26,112025,859,103,4368,8663,126018
2013-06-27,115243,970,275,2004,9536,128028
2013-06-28,145159,775,0,12208,8241,166383
2013-06-29,205066,1115,225,9500,24205,240111
2013-06-30,228298,1496,165,16552,12192,258703
2013-07-01,123826,1022,181,2244,8693,135966
2013-07-02,107099,587,337,7525,9466,125014
2013-07-03,107259,783,0,5924,9786,123752
2013-07-04,119505,899,160,4706,9653,134923
2013-07-05,173211,1003,3,10751,8634,193602
2013-07-06,254136,677,87,9814,24377,289091
2013-07-07,255384,1353,109,12249,13614,282709
2013-07-08,156476,1114,418,5564,10392,173964
2013-07-09,133624,871,0,2219,10962,147676
2013-07-10,133987,1210,112,2983,10798,149090
2013-07-11,154061,1369,423,2428,11822,170103
2013-07-12,178242,834,317,10635,10534,200562
2013-07-13,271984,996,0,9598,25327,307905
2013-07-14,285811,1806,0,16271,14438,318326
2013-07-15,156867,1272,288,7311,11838,177576
2013-07-16,136188,856,0,6587,12409,156040
2013-07-17,157907,1416,131,6601,11781,177836
2013-07-18,164771,1189,179,5218,12718,184075
2013-07-19,197655,1377,163,7843,10566,217604
2013-07-20,330665,1268,351,8133,26354,366771
2013-07-21,339757,2097,0,11056,14003,366913
2013-07-22,192083,1071,3,2717,12152,208026
2013-07-23,126438,927,157,3022,13379,143923
2013-07-24,171223,1166,0,7706,12953,193048
2013-07-25,218080,1605,140,1941,14175,235941
2013-07-26,261584,1693,0,11751,10928,285956
2013-07-27,368805,1926,149,9237,27634,407751
2013-07-28,346449,2527,0,15752,15638,380366
2013-07-29,210506,1414,139,6523,12784,231366
2013-07-30,182846,1135,0,8185,13800,205966
2013-07-31,189947,1778,0,3907,13489,209121
2013-08-01,229717,1374,0,7450,14561,253102
2013-08-02,330600,1679,123,17306,11147,360855
2013-08-03,436100,2079,0,10033,27258,475470
2013-08-04,368243,2488,285,10337,15161,396514
2013-08-05,217563,1555,0,9543,12580,241241
2013-08-06,212045,1629,198,4268,14546,232686
2013-08-07,186374,1548,0,6431,13400,207753
2013-08-08,193457,2031,0,5805,14971,216264
2013-08-09,282357,1184,1,8198,12223,303963
2013-08-10,432757,1602,170,9742,27675,471946
2013-08-11,352829,2425,149,19702,17286,392391
2013-08-12,202364,1317,306,4251,13586,221824
2013-08-13,192970,1218,100,8395,14159,216842
2013-08-14,244652,1567,149,4168,13642,264178
2013-08-15,257729,2127,0,6007,17509,283372
2013-08-16,304896,1618,147,12095,12427,331183
2013-08-17,437895,2022,274,15712,28168,484071
2013-08-18,433566,1824,0,16939,15910,468239
2013-08-19,235409,1809,327,6593,12823,256961
2013-08-20,189997,1903,76,10579,13508,216063
2013-08-21,180507,1471,158,5138,13285,200559
2013-08-22,208646,1446,188,11239,13538,235057
2013-08-23,285569,1192,96,12878,11914,311649
2013-08-24,428957,1806,0,16634,27152,474549
2013-08-25,374129,1717,118,22842,15427,414233
2013-08-26,187616,1153,319,3978,11942,205008
2013-08-27,165332,1814,0,10064,13956,191166
2013-08-28,159374,1334,414,5589,12597,179308
2013-08-29,188349,1218,182,9206,13616,212571
2013-08-30,252389,1057,0,14134,11451,279031
2013-08-31,346657,2200,271,10933,27723,387784
2013-09-01,365526,1680,83,12040,15248,394577
2013-09-02,174720,1134,154,3726,10096,189830
2013-09-03,133018,1856,281,3487,10502,149144
2013-09-04,138357,1194,135,4143,10460,154289
2013-09-05,158452,621,0,3879,10678,173630
2013-09-06,190338,865,0,13897,9226,214326
2013-09-07,252025,1918,158,11732,24461,290294
2013-09-08,279276,1664,0,14450,13609,308999
2013-09-09,1140792,1023,389,4841,9440,1156485
2013-09-10,124501,800,120,10678,9889,145988
2013-09-11,127502,769,0,5861,10390,144522
2013-09-12,120644,1245,0,5580,9700,137169
2013-09-13,145470,1066,437,12667,9285,168925
2013-09-14,193162,1316,0,10160,25965,230603
2013-09-15,207158,1068,169,8713,14104,231212
2013-09-16,109163,913,0,5650,10018,125744
2013-09-17,100822,1038,301,2292,9876,114329
2013-09-18,103649,750,244,7751,8687,121081
2013-09-19,113516,892,0,7000,10305,131713
2013-09-20,134542,954,148,9723,8846,154213
2013-09-21,178885,989,137,9555,25119,214685
2013-09-22,175401,846,0,13576,13295,203118
2013-09-23,105272,824,257,5719,9410,121482
2013-09-24,90791,1022,224,5691,9411,107139
2013-09-25,94286,642,0,2917,7619,105464
2013-09-26,110345,895,0,5362,9842,126444
2013-09-27,138550,833,0,10278,8877,158538
2013-09-28,156356,982,137,8044,21756,187275
2013-09-29,153057,864,376,12222,13209,179728
2013-09-30,97129,577,323,2000,8777,108806
2013-10-01,88457,815,138,2664,7964,100038
2013-10-02,89230,1045,182,2721,2377,95555
2013-10-03,100864,775,184,3517,11117,116457
2013-10-04,124609,756,99,7403,7432,140299
2013-10-05,148713,870,0,10911,17766,178260
2013-10-06,135249,1145,0,10600,10341,157335
2013-10-07,86285,695,150,4723,7626,99479
2013-10-08,80205,741,0,3668,7042,91656
2013-10-09,87858,615,0,7058,5106,100637
2013-10-10,86802,814,418,599,6156,94789
2013-10-11,109009,801,204,9560,5552,125126
2013-10-12,122381,945,125,12193,14042,149686
2013-10-13,146211,729,320,9205,9090,165555
2013-10-14,79593,806,188,4376,7310,92273
2013-10-15,69857,698,167,624,6113,77459
2013-10-16,89683,666,0,1606,4889,96844
2013-10-17,94892,610,164,4890,5789,106345
2013-10-18,96786,531,0,10280,5156,112753
2013-10-19,111739,691,82,7239,10796,130547
2013-10-20,137128,569,0,7542,8275,153514
2013-10-21,83994,476,142,2260,6047,92919
2013-10-22,70298,898,0,7842,6109,85147
2013-10-23,75957,562,0,3730,4139,84388
2013-10-24,84709,457,188,3420,5305,94079
2013-10-25,101744,560,167,6908,4445,113824
2013-10-26,110608,969,0,11959,9762,133298
2013-10-27,115837,778,1,11604,5402,133622
2013-10-28,81252,411,181,4725,2840,89409
2013-10-29,82303,621,155,6133,2645,91857
2013-10-30,107002,1120,0,3833,2394,114349
2013-10-31,119651,1264,0,4019,3457,128391
2013-11-01,109959,943,0,11006,2005,123913
2013-11-02,120845,568,0,5511,3622,130546
2013-11-03,199086,1208,0,8854,5045,214193
2013-11-04,78510,488,185,2761,2748,84692
2013-11-05,64881,640,0,5487,1966,72974
2013-11-06,69934,507,151,17,2280,72889
2013-11-07,79116,471,183,248,1941,81959
2013-11-08,81457,629,0,1309,2201,85596
2013-11-09,88979,442,0,3336,1761,94518
2013-11-10,100760,507,0,4669,2612,108548
2013-11-11,62322,525,179,0,2153,65179
2013-11-12,59307,420,0,201,1765,61693
2013-11-13,66841,373,3,2,2299,69518
2013-11-14,72695,416,184,3307,1716,78318
2013-11-15,80486,623,0,1655,1810,84574
2013-11-16,80572,607,0,3222,1530,85931
2013-11-17,99496,536,0,6273,2235,108540
2013-11-18,66614,435,332,1024,1590,69995
2013-11-19,62790,620,0,6,1498,64914
2013-11-20,62826,475,0,39,169,63509
2013-11-21,72390,392,176,71,1269,74298
2013-11-22,83460,435,0,2827,657,87379
2013-11-23,73837,522,0,6008,1170,81537
2013-11-24,85861,488,0,4872,1970,93191
2013-11-25,72302,381,0,8,1665,74356
2013-11-26,56895,460,0,0,976,58331
2013-11-27,57249,379,0,48,1208,58884
2013-11-28,61549,438,146,174,1417,63724
2013-11-29,80577,537,0,54,1832,83000
2013-11-30,82794,650,0,0,1084,84528
2013-12-01,88676,653,0,89,2077,91495
2013-12-02,61426,452,0,296,1528,63702
2013-12-03,56743,307,0,4,1585,58639
2013-12-04,61772,268,2556,29,1705,66330
2013-12-05,63744,551,0,512,1529,66336
2013-12-06,73155,503,0,6,1978,75642
2013-12-07,73565,543,1,9,1345,75463
2013-12-08,84216,624,0,289,2153,87282
2013-12-09,59271,317,1,2,1741,61332
2013-12-10,58903,281,0,188,1227,60599
2013-12-11,63381,376,0,49,1513,65319
2013-12-12,61741,523,0,98,1414,63776
2013-12-13,72615,447,0,5,1192,74259
2013-12-14,74718,465,0,96,1219,76498
2013-12-15,85125,679,0,97,1610,87511
2013-12-16,59710,350,0,48,1685,61793
2013-12-17,60247,441,0,2,153,60843
2013-12-18,69439,575,0,120,1190,71324
2013-12-19,84500,434,0,359,1095,86388
2013-12-20,118582,736,0,46,2283,121647
2013-12-21,170919,664,0,0,1177,172760
2013-12-22,97986,707,0,87,1137,99917
2013-12-23,96786,697,0,0,1123,98606
2013-12-24,92004,430,0,1743,869,95046
2013-12-25,68867,340,0,0,1188,70395
2013-12-26,67682,491,0,64,1314,69551
2013-12-27,90332,910,0,0,1729,92971
2013-12-28,97219,701,0,27,1731,99678
2013-12-29,97384,1578,0,135,2027,101124
2013-12-30,89609,1210,0,5,1717,92541
2013-12-31,60855,631,0,0,925,62411
2014-01-01,66485,1525,0,2,1746,69758
2014-01-02,104647,633,0,502,1390,107172
2014-01-03,107365,912,0,872,2183,111332
2014-01-04,126004,1078,3,51,1747,128883
2014-01-05,144732,816,0,313,2358,148219
2014-01-06,110140,561,0,50,1928,112679
2014-01-07,68473,477,0,5,1550,70505
2014-01-08,71879,490,0,1,1497,73867
2014-01-09,69284,440,0,113,1411,71248
2014-01-10,76175,709,0,3,1353,78240
2014-01-11,82370,742,0,0,1293,84405
2014-01-12,97494,629,0,58,1731,99912
2014-01-13,61819,357,0,4,1520,63700
2014-01-14,57084,373,0,0,1108,58565
2014-01-15,53514,429,0,0,1122,55065
2014-01-16,61764,623,0,51,1239,63677
2014-01-17,69749,364,0,0,1569,71682
2014-01-18,75900,414,0,0,1149,77463
2014-01-19,69678,462,0,52,1635,71827
2014-01-20,62405,407,2,0,1539,64353
2014-01-21,54481,428,0,3,902,55814
2014-01-22,61218,370,0,3,981,62572
2014-01-23,57544,442,0,95,1293,59374
2014-01-24,58691,344,0,0,1912,60947
2014-01-25,63818,207,0,2,765,64792
2014-01-26,65363,541,0,154,1509,67567
2014-01-27,54652,355,0,4,1616,56627
2014-01-28,46676,455,0,0,1043,48174
2014-01-29,53114,401,0,51,931,54497
2014-01-30,51403,425,0,65,1052,52945
2014-01-31,60332,369,0,44,1473,62218
2014-02-01,59673,210,0,0,713,60596
2014-02-02,67328,220,0,53,1336,68937
2014-02-03,49990,312,0,0,1300,51602
2014-02-04,49110,245,0,47,1108,50510
2014-02-05,53541,239,0,55,1452,55287
2014-02-06,56015,204,3,66,1355,57643
2014-02-07,68171,357,0,5,912,69445
2014-02-08,58719,217,0,5,737,59678
2014-02-09,74289,266,0,70,1664,76289
2014-02-10,55578,318,0,1,1408,57305
2014-02-11,54927,255,0,0,944,56126
2014-02-12,53095,250,0,5,1220,54570
2014-02-13,64297,310,0,49,1312,65968
2014-02-14,73664,553,0,0,1546,75763
2014-02-15,73986,318,0,0,1236,75540
2014-02-16,81337,297,0,139,1978,83751
2014-02-17,60204,355,0,0,1487,62046
2014-02-18,55649,285,0,0,1321,57255
2014-02-19,61490,269,0,80,1252,63091
2014-02-20,62446,345,0,102,1526,64419
2014-02-21,75439,531,0,2,1872,77844
2014-02-22,66779,355,0,44,1244,68422
2014-02-23,90393,338,0,128,936,91795
2014-02-24,57070,431,0,0,1446,58947
2014-02-25,55854,215,0,49,1204,57322
2014-02-26,60058,278,0,2,1581,61919
2014-02-27,61384,348,0,88,1391,63211
2014-02-28,78200,437,0,4,2017,80658
2014-03-01,77035,325,0,4,1079,78443
2014-03-02,86310,478,0,109,1797,88694
2014-03-03,63625,372,0,3,852,64852
2014-03-04,62733,234,0,0,1227,64194
2014-03-05,64394,241,0,4,1510,66149
2014-03-06,65608,331,0,117,1481,67537
2014-03-07,81596,385,0,0,1870,83851
2014-03-08,80480,348,0,8,953,81789
2014-03-09,115728,300,0,170,2125,118323
2014-03-10,67676,355,0,0,1559,69590
2014-03-11,56173,251,0,0,976,57400
2014-03-12,60287,276,0,93,1451,62107
2014-03-13,63920,261,0,141,138,64460
2014-03-14,85242,459,0,3,1771,87475
2014-03-15,86223,520,0,46,1179,87968
2014-03-16,106742,520,0,93,2360,109715
2014-03-17,71132,399,0,0,1637,73168
2014-03-18,60799,344,0,163,1318,62624
2014-03-19,69191,427,171,0,1494,71283
2014-03-20,71290,379,0,351,1922,73942
2014-03-21,81409,367,0,14,2029,83819
2014-03-22,84445,464,0,45,1216,86170
2014-03-23,97525,575,0,181,1789,100070
2014-03-24,63901,487,0,3,1711,66102
2014-03-25,62068,469,0,77,1445,64059
2014-03-26,65954,360,177,5,1915,68411
2014-03-27,69973,439,126,223,1578,72339
2014-03-28,79124,489,0,21,2521,82155
2014-03-29,86739,470,169,12,1089,88479
2014-03-30,110418,666,166,439,2439,114128
2014-03-31,69853,485,0,39,2052,72429
2014-04-01,61559,460,0,1539,1897,65455
2014-04-02,65618,352,306,122,1754,68152
2014-04-03,69033,567,84,567,2601,72852
2014-04-04,85242,310,0,32,2369,87953
2014-04-05,80268,414,318,4,3113,84117
2014-04-06,115856,517,0,3166,2775,122314
2014-04-07,68915,456,0,3136,2407,74914
2014-04-08,63882,486,128,1475,3287,69258
2014-04-09,66128,400,364,118,3057,70067
2014-04-10,78955,610,0,2048,3524,85137
2014-04-11,102954,787,0,4212,3573,111526
2014-04-12,121207,608,180,5666,5403,133064
2014-04-13,130444,573,262,3527,4201,139007
2014-04-14,79380,567,121,928,3255,84251
2014-04-15,86438,679,0,176,3453,90746
2014-04-16,96707,439,0,2668,1560,101374
2014-04-17,119196,437,79,305,3767,123784
2014-04-18,160535,558,0,4234,3896,169223
2014-04-19,119447,521,284,8273,7312,135837
2014-04-20,105785,626,0,4823,5201,116435
2014-04-21,195630,794,83,4077,6532,207116
2014-04-22,131056,802,0,6412,5356,143626
2014-04-23,89544,420,415,202,5265,95846
2014-04-24,93135,913,148,4962,4472,103630
2014-04-25,118846,533,0,6255,5020,130654
2014-04-26,157235,578,29,8568,9945,176355
2014-04-27,170867,651,186,4967,6074,182745
2014-04-28,89680,789,0,2505,5237,98211
2014-04-29,86786,703,212,2939,3680,94320
2014-04-30,126430,638,0,872,5481,133421
2014-05-01,142988,603,0,2106,3771,149468
2014-05-02,131600,534,0,6064,4581,142779
2014-05-03,215296,556,188,8397,12073,236510
2014-05-04,271433,738,0,7960,7654,287785
2014-05-05,102411,383,110,5163,6221,114288
2014-05-06,82198,363,85,774,4968,88388
2014-05-07,84992,490,365,5169,5118,96134
2014-05-08,92984,591,107,3245,3115,100042
2014-05-09,93437,398,0,5902,5281,105018
2014-05-10,111822,691,324,6818,13616,133271
2014-05-11,134964,408,254,3807,7916,147349
2014-05-12,83507,402,0,329,3845,88083
2014-05-13,75567,418,99,633,5150,81867
2014-05-14,73449,577,180,407,5830,80443
2014-05-15,77971,551,0,1777,4708,85007
2014-05-16,91532,502,169,10754,5623,108580
2014-05-17,93253,307,327,6549,12395,112831
2014-05-18,114639,740,389,12234,8427,136429
2014-05-19,77101,509,0,3373,6324,87307
2014-05-20,71630,467,138,4332,6141,82708
2014-05-21,80582,419,180,2324,5638,89143
2014-05-22,75098,711,195,4618,5585,86207
2014-05-23,102092,514,271,8007,6263,117147
2014-05-24,123868,388,183,9152,15578,149169
2014-05-25,144462,801,183,7554,8406,161406
2014-05-26,88616,566,200,262,6999,96643
2014-05-27,75090,398,56,1073,6238,82855
2014-05-28,85698,370,637,2974,7501,97180
2014-05-29,105715,468,155,418,6262,113018
2014-05-30,103059,541,110,5762,6868,116340
2014-05-31,132265,486,134,10254,20519,163658
2014-06-01,208113,631,223,6641,11093,226701
2014-06-02,138590,503,151,4661,8165,152070
2014-06-03,89917,582,142,6550,5424,102615
2014-06-04,83971,691,363,3658,7734,96417
2014-06-05,91930,705,0,723,6778,100136
2014-06-06,121667,620,264,9194,6568,138313
2014-06-07,142314,515,165,14567,17841,175402
2014-06-08,175896,724,475,6689,11009,194793
2014-06-09,151877,739,284,1998,9442,164340
2014-06-10,101911,522,246,4015,8808,115502
2014-06-11,97176,921,138,4214,8817,111266
2014-06-12,96358,645,0,5581,7610,110194
2014-06-13,119750,661,236,7467,7103,135217
2014-06-14,172642,650,374,7830,20408,201904
2014-06-15,187072,714,230,12946,12640,213602
2014-06-16,116893,705,131,3988,8506,130223
2014-06-17,107060,747,190,2636,9224,119857
2014-06-18,118531,754,519,2769,9645,132218
2014-06-19,130503,986,0,3511,8624,143624
2014-06-20,156790,664,0,8729,7328,173511
2014-06-21,165490,1011,0,16223,21334,204058
2014-06-22,256318,1046,373,8067,13257,279061
2014-06-23,116085,809,266,5903,8670,131733
2014-06-24,108366,755,380,3559,9246,122306
2014-06-25,131036,620,180,3143,9301,144280
2014-06-26,124364,1030,203,5320,10127,141044
2014-06-27,145135,954,117,6813,8299,161318
2014-06-28,210552,837,269,10365,23642,245665
2014-06-29,266267,1116,297,9989,14870,292539
2014-06-30,141521,731,87,4020,10096,156455
2014-07-01,108718,1059,157,6015,11021,126970
2014-07-02,120136,1045,175,3453,11153,135962
2014-07-03,133186,760,127,2584,10721,147378
2014-07-04,165577,812,101,12273,9353,188116
2014-07-05,260699,813,332,10612,23974,296430
2014-07-06,281147,1313,315,8119,15361,306255
2014-07-07,157912,988,192,951,10880,170923
2014-07-08,145175,913,0,8352,11865,166305
2014-07-09,136556,960,0,3107,12077,152700
2014-07-10,172285,1221,312,3052,13178,190048
2014-07-11,195921,954,346,9237,9452,215910
2014-07-12,264248,1036,117,5864,24559,295824
2014-07-13,271505,1231,0,8619,16119,297474
2014-07-14,159471,998,107,5554,13224,179354
2014-07-15,149882,1259,112,8001,14675,173929
2014-07-16,149757,1205,369,3831,15307,170469
2014-07-17,170801,1058,530,5968,14342,192699
2014-07-18,228047,1339,0,8737,11198,249321
2014-07-19,326370,1342,79,10229,25189,363209
2014-07-20,338619,1719,185,7093,17599,365215
2014-07-21,222881,1567,0,3755,12565,240768
2014-07-22,159913,1285,90,4797,15173,181258
2014-07-23,166723,1252,127,4045,14940,187087
2014-07-24,192895,1594,228,3845,15762,214324
2014-07-25,283609,1294,0,9522,11934,306359
2014-07-26,415525,1974,484,7047,27787,452817
2014-07-27,336535,1973,0,6241,18765,363514
2014-07-28,179325,1033,117,4904,13531,198910
2014-07-29,196452,1273,81,3842,16204,217852
2014-07-30,208796,1343,187,3449,15396,229171
2014-07-31,215142,2035,153,4318,17420,239068
2014-08-01,307831,1533,0,6786,13208,329358
2014-08-02,394563,996,0,11168,27020,433747
2014-08-03,376827,2430,170,13218,18519,411164
2014-08-04,210063,1706,172,6722,13475,232138
2014-08-05,192066,1160,350,5437,14898,213911
2014-08-06,206777,1384,291,4979,16285,229716
2014-08-07,222249,1609,2,5625,16366,245851
2014-08-08,316218,1666,137,14466,13765,346252
2014-08-09,426277,1685,197,8833,27793,464785
2014-08-10,391259,2742,145,6561,19040,419747
2014-08-11,226143,2007,166,5786,14230,248332
2014-08-12,211659,1547,426,2738,15319,231689
2014-08-13,194882,1505,183,6702,17422,220694
2014-08-14,280201,1869,93,7359,15913,305435
2014-08-15,305597,1608,213,7815,14068,329301
2014-08-16,415993,1344,183,14750,28420,460690
2014-08-17,440004,2650,187,14578,19129,476548
2014-08-18,268827,1307,501,8020,12258,290913
2014-08-19,208816,1303,0,6761,15376,232256
2014-08-20,216593,1341,109,6360,15731,240134
2014-08-21,220827,1239,0,9295,15347,246708
2014-08-22,269644,1022,0,15552,12453,298671
2014-08-23,420182,1645,140,11973,27379,461319
2014-08-24,364408,2734,125,11065,18992,397324
2014-08-25,206630,1147,0,6113,12549,226439
2014-08-26,189774,1195,122,4201,13492,208784
2014-08-27,193557,1095,688,5453,15442,216235
2014-08-28,219290,1343,0,4810,15540,240983
2014-08-29,284845,1026,0,12018,12022,309911
2014-08-30,370222,1370,211,10981,28273,411057
2014-08-31,348081,1549,0,10263,17601,377494
2014-09-01,221808,587,0,6741,9891,239027
2014-09-02,153720,863,0,4624,13005,172212
2014-09-03,152506,894,154,8221,13665,175440
2014-09-04,165966,632,128,4446,11481,182653
2014-09-05,188531,513,108,14863,10747,214762
2014-09-06,231260,1101,348,5535,22865,261109
2014-09-07,260267,879,84,8124,15477,284831
2014-09-08,143538,783,121,4078,9086,157606
2014-09-09,127539,816,244,10974,11716,151289
2014-09-10,148646,1156,0,3701,12851,166354
2014-09-11,155288,722,183,5094,11112,172399
2014-09-12,180649,964,165,8646,10900,201324
2014-09-13,193710,738,343,8003,24650,227444
2014-09-14,201164,863,85,9745,15364,227221
2014-09-15,110203,1081,144,839,10576,122843
2014-09-16,107491,821,348,4196,10722,123578
2014-09-17,115391,722,340,4781,12384,133618
2014-09-18,115575,638,0,5867,10538,132618
2014-09-19,149542,860,156,9268,8919,168745
2014-09-20,175336,977,152,10390,22776,209631
2014-09-21,188085,681,44,6871,14162,209843
2014-09-22,109374,711,0,8271,9703,128059
2014-09-23,89059,864,0,4632,10284,104839
2014-09-24,111466,745,0,4733,11752,128696
2014-09-25,113235,608,0,5874,10456,130173
2014-09-26,131831,639,182,7296,9267,149215
2014-09-27,165921,586,338,14441,22831,204117
2014-09-28,191783,816,163,10993,13258,217013
2014-09-29,106612,909,318,5231,9022,122092
2014-09-30,95665,606,0,6678,10380,113329
2014-10-01,95309,872,148,877,9573,106779
2014-10-02,113094,550,0,5114,8172,126930
2014-10-03,138987,453,125,9180,7848,156593
2014-10-04,132557,862,200,8181,17370,159170
2014-10-05,187922,794,155,7053,11506,207430
2014-10-06,97863,898,0,4871,7864,111496
2014-10-07,88098,687,2,2877,7451,99115
2014-10-08,92698,576,187,4309,7014,104784
2014-10-09,84863,804,534,2390,6465,95056
2014-10-10,107962,660,0,5438,5849,119909
2014-10-11,126980,649,162,7272,12883,147946
2014-10-12,155865,814,0,10413,9596,176688
2014-10-13,82783,603,0,529,6985,90900
2014-10-14,81719,459,167,3312,7101,92758
2014-10-15,84683,578,97,370,6437,92165
2014-10-16,87839,392,0,3215,7253,98699
2014-10-17,100154,608,1,12059,5451,118273
2014-10-18,116852,785,179,7007,10949,135772
2014-10-19,146849,630,424,5941,8456,162300
2014-10-20,84614,392,0,514,6442,91962
2014-10-21,72354,562,147,1048,4995,79106
2014-10-22,79092,547,81,1672,4361,85753
2014-10-23,75222,498,0,276,5814,81810
2014-10-24,94659,434,76,11948,5434,112551
2014-10-25,108839,754,120,9853,9623,129189
2014-10-26,134341,965,0,6208,5367,146881
2014-10-27,83951,572,58,1056,3354,88991
2014-10-28,74987,765,0,4953,2845,83550
2014-10-29,85087,603,313,221,3347,89571
2014-10-30,112408,865,0,2123,3517,118913
2014-10-31,114429,653,293,7148,3472,125995
2014-11-01,102822,627,118,7101,3938,114606
2014-11-02,159822,859,0,8054,4303,173038
2014-11-03,91534,558,0,6156,2992,101240
2014-11-04,71506,518,0,3280,2589,77893
2014-11-05,71148,614,75,5,2408,74250
2014-11-06,71134,545,0,368,2342,74389
2014-11-07,83621,411,0,6167,2376,92575
2014-11-08,88542,543,186,722,1455,91448
2014-11-09,103101,596,0,5300,2535,111532
2014-11-10,68535,485,123,4,2051,71198
2014-11-11,75011,419,0,4,1763,77197
2014-11-12,66014,588,0,7,2105,68714
2014-11-13,67409,443,0,239,2125,70216
2014-11-14,87525,699,0,11,2688,90923
2014-11-15,103543,474,0,1,1642,105660
2014-11-16,102665,485,0,3127,2244,108521
2014-11-17,67232,511,0,8,2136,69887
2014-11-18,61486,381,0,3,2060,63930
2014-11-19,66686,514,174,4,2170,69548
2014-11-20,69536,394,0,92,1991,72013
2014-11-21,85744,605,0,18,2161,88528
2014-11-22,82351,516,0,17,1515,84399
2014-11-23,107055,381,0,3071,2376,112883
2014-11-24,66401,472,0,4,2181,69058
2014-11-25,65135,378,0,2012,1673,69198
2014-11-26,65229,278,0,3,2061,67571
2014-11-27,68460,311,0,106,1926,70803
2014-11-28,81014,447,0,7,2044,83512
2014-11-29,79589,407,98,0,1201,81295
2014-11-30,91457,406,0,5152,2027,99042
2014-12-01,65557,277,0,0,1843,67677
2014-12-02,58092,399,0,51,1698,60240
2014-12-03,64829,409,0,1,1798,67037
2014-12-04,66863,452,0,186,1490,68991
2014-12-05,77961,518,0,2,1853,80334
2014-12-06,79660,285,0,3,1227,81175
2014-12-07,76865,355,0,98,2367,79685
2014-12-08,84587,393,0,7,1749,86736
2014-12-09,62410,276,0,0,404,63090
2014-12-10,61612,294,0,4,148,62058
2014-12-11,71708,322,0,128,1799,73957
2014-12-12,78413,371,0,3,2367,81154
2014-12-13,85009,498,0,0,1462,86969
2014-12-14,76651,686,0,73,1312,78722
2014-12-15,61435,343,0,48,1886,63712
2014-12-16,71214,380,0,0,1569,73163
2014-12-17,76202,453,0,34,1627,78316
2014-12-18,88022,458,0,479,1498,90457
2014-12-19,122252,536,0,2,1726,124516
2014-12-20,172603,741,0,2,1295,174641
2014-12-21,135105,824,0,118,1817,137864
2014-12-22,91859,447,0,24,1857,94187
2014-12-23,122877,623,0,7,1604,125111
2014-12-24,140803,716,0,0,742,142261
2014-12-25,89325,561,0,0,395,90281
2014-12-26,84644,558,0,3,1433,86638
2014-12-27,98104,792,0,0,1322,100218
2014-12-28,83414,777,0,97,2025,86313
2014-12-29,80064,1308,0,2,2412,83786
2014-12-30,99074,1771,0,7,2285,103137
2014-12-31,70120,635,0,0,1498,72253
2015-01-01,62132,354,0,168,1187,63841
2015-01-02,107211,1540,0,10,2899,111660
2015-01-03,139327,897,0,51,3002,143277
2015-01-04,159865,690,2,583,2334,163474
2015-01-05,112305,695,0,6,2901,115907
2015-01-06,111365,707,0,38,2361,114471
2015-01-07,73333,432,0,0,2471,76236
2015-01-08,91990,483,0,95,1965,94533
2015-01-09,92042,516,0,2,1448,94008
2015-01-10,126729,716,0,0,1852,129297
2015-01-11,114271,574,0,80,2162,117087
2015-01-12,70301,518,0,0,2020,72839
2015-01-13,81113,658,0,3,947,82721
2015-01-14,68090,513,0,22,1165,69790
2015-01-15,65871,376,0,88,1559,67894
2015-01-16,70237,486,0,5,1585,72313
2015-01-17,77425,448,0,0,1086,78959
2015-01-18,69396,548,0,45,2415,72404
2015-01-19,55319,430,0,39,1795,57583
2015-01-20,55255,247,0,8,1289,56799
2015-01-21,57901,350,0,1,1364,59616
2015-01-22,57676,332,0,69,1449,59526
2015-01-23,62391,332,0,24,1561,64308
2015-01-24,64581,342,0,0,1352,66275
2015-01-25,70821,397,0,54,1576,72848
2015-01-26,54175,449,0,45,1492,56161
2015-01-27,51109,294,0,0,1114,52517
2015-01-28,59458,457,0,140,1273,61328
2015-01-29,56250,322,0,64,1510,58146
2015-01-30,61880,391,0,1,1608,63880
2015-01-31,60027,318,0,0,1233,61578
2015-02-01,64722,321,0,79,2001,67123
2015-02-02,55216,461,0,2,1406,57085
2015-02-03,52636,405,0,1,1498,54540
2015-02-04,51300,304,0,0,1417,53021
2015-02-05,49047,423,0,43,1350,50863
2015-02-06,43808,391,0,46,1573,45818
2015-02-07,52325,379,0,4,1128,53836
2015-02-08,59765,446,0,5,1531,61747
2015-02-09,50380,456,0,39,1652,52527
2015-02-10,55170,682,0,0,1581,57433
2015-02-11,55301,470,0,4,1380,57155
2015-02-12,58762,340,0,143,1695,60940
2015-02-13,75776,433,0,1,2044,78254
2015-02-14,75014,373,0,1,960,76348
2015-02-15,84460,368,0,93,1857,86778
2015-02-16,64992,427,0,9,1741,67169
2015-02-17,64186,385,0,2,1524,66097
2015-02-18,57609,456,0,46,1411,59522
2015-02-19,65118,344,0,77,1890,67429
2015-02-20,74394,387,0,419,2114,77314
2015-02-21,73453,358,0,4,1334,75149
2015-02-22,85441,484,0,79,2370,88374
2015-02-23,59642,351,0,0,1534,61527
2015-02-24,54140,364,0,3,1869,56376
2015-02-25,57725,335,3,0,1755,59818
2015-02-26,62685,386,0,83,1822,64976
2015-02-27,74829,448,0,80,1910,77267
2015-02-28,78359,377,0,28,1374,80138
2015-03-01,90119,532,0,60,2288,92999
2015-03-02,68039,427,0,7,1885,70358
2015-03-03,59891,255,0,0,1531,61677
2015-03-04,59969,300,0,3,1542,61814
2015-03-05,60931,432,0,0,1620,62983
2015-03-06,74181,445,0,0,1960,76586
2015-03-07,75069,425,0,10,1221,76725
2015-03-08,96256,805,0,125,1837,99023
2015-03-09,64427,372,0,64,1907,66770
2015-03-10,61007,182,0,0,1886,63075
2015-03-11,63918,239,0,4,1753,65914
2015-03-12,66566,324,0,436,2104,69430
2015-03-13,74774,375,0,3,2121,77273
2015-03-14,102863,365,0,420,1369,105017
2015-03-15,94134,368,0,58,2865,97425
2015-03-16,64151,343,0,39,2048,66581
2015-03-17,60272,362,0,482,1199,62315
2015-03-18,77920,347,0,7,1815,80089
2015-03-19,73544,383,145,276,2044,76392
2015-03-20,81675,420,0,9,1941,84045
2015-03-21,85716,560,0,2,1229,87507
2015-03-22,97232,337,0,155,2403,100127
2015-03-23,64854,421,0,126,1939,67340
2015-03-24,64757,553,0,46,1957,67313
2015-03-25,63457,343,0,80,1876,65756
2015-03-26,92659,388,0,141,2177,95365
2015-03-27,87228,464,0,18,2221,89931
2015-03-28,112200,520,0,17,2022,114759
2015-03-29,110896,434,0,137,3565,115032
2015-03-30,92766,525,0,86,2261,95638
2015-03-31,74628,492,145,116,2510,77891
2015-04-01,91810,520,143,133,2307,94913
2015-04-02,111584,555,0,189,2662,114990
2015-04-03,201911,538,221,553,2333,205556
2015-04-04,122109,571,0,44,2690,125414
2015-04-05,114917,487,0,1181,4361,120946
2015-04-06,230290,718,0,3444,5401,239853
2015-04-07,150641,675,167,438,4605,156526
2015-04-08,87360,448,179,253,3537,91777
2015-04-09,80123,422,0,1726,3938,86209
2015-04-10,109927,587,72,85,3841,114512
2015-04-11,123949,569,0,176,5932,130626
2015-04-12,126860,584,0,499,6496,134439
2015-04-13,92448,741,264,228,4311,97992
2015-04-14,72417,377,257,2695,4552,80298
2015-04-15,74375,510,227,1975,3642,80729
2015-04-16,79550,349,0,819,3646,84364
2015-04-17,103602,444,528,241,4270,109085
2015-04-18,100500,472,73,3803,6178,111026
2015-04-19,160412,669,0,3160,4927,169168
2015-04-20,75767,595,498,462,3987,81309
2015-04-21,71156,433,526,274,4790,77179
2015-04-22,75950,573,14,3844,4162,84543
2015-04-23,78535,446,2,3443,3064,85490
2015-04-24,101929,465,269,5376,2908,110947
2015-04-25,116582,483,187,3022,8082,128356
2015-04-26,118170,771,0,5289,6693,130923
2015-04-27,104717,602,366,789,3964,110438
2015-04-28,85430,532,321,3941,3500,93724
2015-04-29,104140,437,237,162,4772,109748
2015-04-30,144559,1343,243,2711,4530,153386
2015-05-01,146073,660,363,7459,3899,158454
2015-05-02,157319,890,0,9350,8850,176409
2015-05-03,264469,833,0,3175,7777,276254
2015-05-04,112398,731,203,5704,6182,125218
2015-05-05,83289,482,0,249,4975,88995
2015-05-06,84744,557,119,6116,5124,96660
2015-05-07,90400,533,108,3292,5163,99496
2015-05-08,105185,1031,298,8230,5559,120303
2015-05-09,118356,522,166,5542,11188,135774
2015-05-10,142844,829,86,7439,9907,161105
2015-05-11,84332,855,312,683,5643,91825
2015-05-12,81197,469,0,3478,5004,90148
2015-05-13,109140,654,300,3401,5496,118991
2015-05-14,107434,595,190,6174,6761,121154
2015-05-15,104764,430,179,6468,6183,118024
2015-05-16,116985,729,0,8908,13880,140502
2015-05-17,173910,609,0,3270,10561,188350
2015-05-18,97703,524,0,3168,6169,107564
2015-05-19,77677,540,267,2430,7019,87933
2015-05-20,84713,423,62,5441,6746,97385
2015-05-21,85016,425,86,3270,7900,96697
2015-05-22,125124,459,93,4497,5468,135641
2015-05-23,116822,580,229,5319,15380,138330
2015-05-24,123501,692,168,8982,9494,142837
2015-05-25,164532,412,447,934,7591,173916
2015-05-26,92238,369,275,2058,8297,103237
2015-05-27,83423,264,0,3804,8324,95815
2015-05-28,89990,692,0,3678,9650,104010
2015-05-29,112339,752,408,6567,6263,126329
2015-05-30,135468,565,128,7286,18773,162220
2015-05-31,159529,357,164,4497,11611,176158
2015-06-01,120346,798,91,3237,6857,131329
2015-06-02,145003,317,192,7812,7279,160603
2015-06-03,130674,512,92,8456,8674,148408
2015-06-04,135427,985,0,12655,8924,157991
2015-06-05,148968,683,112,5591,6140,161494
2015-06-06,187832,232,129,10420,19239,217852
2015-06-07,299591,858,137,11744,12153,324483
2015-06-08,136025,597,260,1782,8269,146933
2015-06-09,104743,687,149,2938,8092,116609
2015-06-10,115147,220,402,3664,8409,127842
2015-06-11,108885,943,0,2171,9653,121652
2015-06-12,144442,837,361,8433,7697,161770
2015-06-13,173316,1013,142,8832,21063,204366
2015-06-14,250476,391,124,6833,12955,270779
2015-06-15,122477,184,238,5384,8290,136573
2015-06-16,108150,413,0,1111,9208,118882
2015-06-17,123436,266,118,2479,10072,136371
2015-06-18,120754,889,82,10436,10439,142600
2015-06-19,140066,278,154,7212,7767,155477
2015-06-20,188827,374,305,6536,22248,218290
2015-06-21,242190,1201,0,10260,13308,266959
2015-06-22,137376,777,378,2951,8513,149995
2015-06-23,122817,921,275,2841,9631,136485
2015-06-24,146862,850,118,7862,10242,165934
2015-06-25,154851,1246,419,6960,10886,174362
2015-06-26,173477,917,182,9171,7963,191710
2015-06-27,262507,935,0,8122,25119,296683
2015-06-28,315534,1292,79,6918,15543,339366
2015-06-29,181945,1560,275,3570,9247,196597
2015-06-30,152624,963,375,2135,11893,167990
2015-07-01,152903,951,0,8300,12479,174633
2015-07-02,159665,1028,310,8479,12547,182029
2015-07-03,201162,855,112,6587,8526,217242
2015-07-04,256864,943,0,7670,25627,291104
2015-07-05,317928,1531,258,12201,15645,347563
2015-07-06,188590,913,319,3879,11367,205068
2015-07-07,163064,1106,0,3087,11735,178992
2015-07-08,166644,1080,151,3321,13266,184462
2015-07-09,169432,1263,221,9315,13772,194003
2015-07-10,230686,804,283,4893,11478,248144
2015-07-11,346031,1062,2,9867,25817,382779
2015-07-12,365569,1652,128,11962,17685,396996
2015-07-13,206586,1463,85,3796,13173,225103
2015-07-14,188596,1747,0,1872,15107,207322
2015-07-15,207251,1219,159,6113,16062,230804
2015-07-16,247767,1737,145,10792,15150,275591
2015-07-17,261997,1428,126,8049,12635,284235
2015-07-18,377773,1263,297,12655,28376,420364
2015-07-19,413335,2332,0,11360,17836,444863
2015-07-20,237522,1698,182,5648,13426,258476
2015-07-21,200070,1444,0,4893,14005,220412
2015-07-22,209650,1268,0,8941,16103,235962
2015-07-23,237247,2479,119,7723,10855,258423
2015-07-24,305052,277,184,6208,11384,323105
2015-07-25,439577,1546,290,10849,27649,479911
2015-07-26,385859,2455,177,7235,18615,414341
2015-07-27,251888,1342,139,5910,14348,273627
2015-07-28,202944,1675,0,3194,14751,222564
2015-07-29,225628,1265,282,8577,13020,248772
2015-07-30,283129,1937,0,9198,17280,311544
2015-07-31,394291,986,0,7608,13675,416560
2015-08-01,593763,1249,124,9281,29197,633614
2015-08-02,428755,2119,241,12649,18785,462549
2015-08-03,272889,1354,185,5153,14677,294258
2015-08-04,239051,1568,321,4285,16061,261286
2015-08-05,265117,1079,155,5461,17127,288939
2015-08-06,288981,2039,129,9721,16699,317569
2015-08-07,391999,1598,333,7410,13820,415160
2015-08-08,522782,1593,0,12348,30508,567231
2015-08-09,440078,2042,135,8746,18505,469506
2015-08-10,323360,2033,112,7681,14873,348059
2015-08-11,246607,1875,418,2728,16244,267872
2015-08-12,259920,1141,126,7659,17934,286780
2015-08-13,281236,1750,0,10723,16746,310455
2015-08-14,390613,1913,194,8023,13428,414171
2015-08-15,496137,1928,138,10250,30269,538722
2015-08-16,482100,2580,0,17151,19292,521123
2015-08-17,286813,1166,184,7873,9486,305522
2015-08-18,232664,2122,166,3881,16087,254920
2015-08-19,248515,1442,0,3646,16693,270296
2015-08-20,280442,1516,0,11930,17155,311043
2015-08-21,335495,1915,454,14094,13051,365009
2015-08-22,421263,1694,84,11555,28881,463477
2015-08-23,451742,2364,0,11132,19400,484638
2015-08-24,294129,1224,362,8462,13028,317205
2015-08-25,205228,1362,250,3266,14842,224948
2015-08-26,206221,1399,146,7911,17403,233080
2015-08-27,242459,1477,0,8307,16823,269066
2015-08-28,323505,1119,106,8853,13031,346614
2015-08-29,427653,1430,0,10890,28106,468079
2015-08-30,379846,2153,0,12915,19664,414578
2015-08-31,250571,1085,284,7331,12563,271834
2015-09-01,164129,917,0,4114,13754,182914
2015-09-02,148183,1197,132,6515,13420,169447
2015-09-03,184957,1004,719,9075,13516,209271
2015-09-04,238437,983,182,12756,10521,262879
2015-09-05,276329,1193,107,9368,26718,313715
2015-09-06,227465,1261,0,6538,16108,251372
2015-09-07,151640,1298,0,4761,10470,168169
2015-09-08,138289,853,0,2542,11868,153552
2015-09-09,145224,1232,117,6609,13175,166357
2015-09-10,152330,993,398,8131,13357,175209
2015-09-11,194002,986,86,6021,8695,209790
2015-09-12,227873,1282,134,7218,25592,262099
2015-09-13,265720,1070,258,10921,14714,292683
2015-09-14,133336,852,322,971,9492,144973
2015-09-15,117697,1011,174,1184,11644,131710
2015-09-16,109217,959,280,2620,11654,124730
2015-09-17,125874,634,25,6202,11869,144604
2015-09-18,147786,196,184,9646,8925,166737
2015-09-19,194440,11,0,8917,25450,228818
2015-09-20,188596,225,31,5038,13826,207716
2015-09-21,119688,16,118,3331,10597,133750
2015-09-22,102777,37,0,6135,11352,120301
2015-09-23,124152,33,84,8862,10711,143842
2015-09-24,110502,30,0,9059,11989,131580
2015-09-25,118612,76,144,9191,8885,136908
2015-09-26,139674,11,279,9267,25559,174790
2015-09-27,180209,29,7,11493,14475,206213
2015-09-28,97717,24,173,5457,10932,114303
2015-09-29,93296,11,0,1694,11222,106223
2015-09-30,97382,17,37,5391,9598,112425
2015-10-01,98406,16,83,4196,10045,112746
2015-10-02,105817,13,361,6260,8414,120865
2015-10-03,129854,18,0,10313,20751,160936
2015-10-04,138804,233,0,5723,11210,155970
2015-10-05,91068,246,19,1153,8314,100800
2015-10-06,78655,240,114,3784,8536,91329
2015-10-07,86858,290,0,4539,8820,100507
2015-10-08,103589,260,0,5985,8958,118792
2015-10-09,108013,257,0,5809,6548,120627
2015-10-10,108391,507,143,8257,15435,132733
2015-10-11,129681,510,0,7474,9967,147632
2015-10-12,88237,455,437,939,8168,98236
2015-10-13,74368,415,83,1983,6957,83806
2015-10-14,74782,518,419,3313,7375,86407
2015-10-15,81562,371,0,5305,8487,95725
2015-10-16,100577,425,180,8358,5857,115397
2015-10-17,106591,40,268,7918,13527,128344
2015-10-18,119034,102,0,6178,8251,133565
2015-10-19,78597,80,0,3403,7088,89168
2015-10-20,73966,52,91,2276,6024,82409
2015-10-21,74327,40,72,5908,6527,86874
2015-10-22,88874,47,410,3992,6962,100285
2015-10-23,108391,261,89,3149,5302,117192
2015-10-24,115166,37,142,6590,12728,134663
2015-10-25,124167,90,0,4852,5862,134971
2015-10-26,117465,37,283,1497,4326,123608
2015-10-27,79702,43,0,601,4041,84387
2015-10-28,80741,31,136,1777,3650,86335
2015-10-29,86486,41,0,4868,4271,95666
2015-10-30,103027,33,178,3003,3458,109699
2015-10-31,114167,94,0,4031,4962,123254
2015-11-01,127275,562,0,2318,4502,134657
2015-11-02,85386,177,200,2469,3534,91766
2015-11-03,78484,309,152,1353,3983,84281
2015-11-04,75631,331,0,7687,2811,86460
2015-11-05,76948,273,0,2466,2910,82597
2015-11-06,90029,299,10,5674,2337,98349
2015-11-07,93131,300,142,2863,2513,98949
2015-11-08,128768,240,0,6121,2749,137878
2015-11-09,73206,287,0,1240,2455,77188
2015-11-10,68337,215,0,908,2213,71673
2015-11-11,70803,176,0,883,2600,74462
2015-11-12,75139,196,0,2184,2022,79541
2015-11-13,83734,233,0,4342,1827,90136
2015-11-14,91949,210,0,2686,1828,96673
2015-11-15,99880,422,0,4345,2531,107178
2015-11-16,69614,180,5,4,2576,72379
2015-11-17,82159,210,0,3,2300,84672
2015-11-18,68363,194,0,477,2014,71048
2015-11-19,72215,236,0,2216,2010,76677
2015-11-20,82393,227,0,2352,2008,86980
2015-11-21,74926,193,0,2692,1373,79184
2015-11-22,90615,216,0,1798,1952,94581
2015-11-23,65989,351,0,4,1534,67878
2015-11-24,60520,325,0,14,1354,62213
2015-11-25,64116,187,0,848,1380,66531
2015-11-26,63251,166,0,2315,1582,67314
2015-11-27,76960,238,0,1913,1552,80663
2015-11-28,70960,183,0,49,747,71939
2015-11-29,85640,232,0,917,1913,88702
2015-11-30,70299,215,0,1,1403,71918
2015-12-01,61517,204,0,0,1282,63003
2015-12-02,63484,309,0,5,1160,64958
2015-12-03,63887,251,0,143,1173,65454
2015-12-04,81104,230,0,0,1585,82919
2015-12-05,77535,420,0,16,1110,79081
2015-12-06,87392,258,0,174,1464,89288
2015-12-07,59831,218,0,6,854,60909
2015-12-08,70580,159,0,15,956,71710
2015-12-09,62580,167,0,9,1553,64309
2015-12-10,67743,233,0,110,1710,69796
2015-12-11,74029,184,0,26,1149,75388
2015-12-12,77549,176,0,7,1101,78833
2015-12-13,89617,323,0,106,1291,91337
2015-12-14,62226,326,0,3,1036,63591
2015-12-15,66400,245,0,1,1199,67845
2015-12-16,74995,296,0,8,1044,76343
2015-12-17,80902,309,0,385,1303,82899
2015-12-18,112929,360,0,0,1143,114432
2015-12-19,141347,479,0,52,925,142803
2015-12-20,120696,519,0,84,1735,123034
2015-12-21,94078,330,0,10,894,95312
2015-12-22,102970,317,0,10,749,104046
2015-12-23,144308,338,0,0,1444,146090
2015-12-24,167303,304,0,40,818,168465
2015-12-25,97684,347,0,1,354,98386
2015-12-26,95310,639,0,0,2047,97996
2015-12-27,119665,619,0,129,2028,122441
2015-12-28,96469,512,0,4,2169,99154
2015-12-29,100264,469,0,69,2604,103406
2015-12-30,124457,961,0,4,1604,127026
2015-12-31,78119,695,0,46,982,79842
2016-01-01,67163,426,0,43,761,68393
2016-01-02,155646,789,0,3,2993,159431
2016-01-03,155675,1022,0,463,2910,160070
2016-01-04,95876,667,0,6,1886,98435
2016-01-05,94943,568,0,51,2017,97579
2016-01-06,92478,503,0,4,1749,94734
2016-01-07,82450,414,0,147,1438,84449
2016-01-08,94930,438,0,3,1549,96920
2016-01-09,118763,501,0,50,1639,120953
2016-01-10,130052,587,0,101,1874,132614
2016-01-11,79199,508,0,0,1732,81439
2016-01-12,67379,396,0,6,922,68703
2016-01-13,70961,531,0,3,1651,73146
2016-01-14,67635,451,0,82,1342,69510
2016-01-15,76498,385,4,3,1195,78085
2016-01-16,74280,752,0,0,782,75814
2016-01-17,71818,518,0,49,1717,74102
2016-01-18,58036,369,0,0,1067,59472
2016-01-19,59006,498,0,42,809,60355
2016-01-20,58224,398,0,10,1202,59834
2016-01-21,60654,389,0,67,1910,63020
2016-01-22,67775,346,0,30,1378,69529
2016-01-23,72735,366,0,0,638,73739
2016-01-24,72277,402,0,85,951,73715
2016-01-25,55707,316,0,5,1035,57063
2016-01-26,53504,453,0,23,962,54942
2016-01-27,57321,295,0,19,899,58534
2016-01-28,58804,334,0,71,949,60158
2016-01-29,73021,452,0,3,1312,74788
2016-01-30,70618,370,0,0,875,71863
2016-01-31,77391,391,0,38,568,78388
2016-02-01,56325,391,0,51,1186,57953
2016-02-02,56029,314,0,4,1032,57379
2016-02-03,55605,374,0,14,1394,57387
2016-02-04,61546,377,0,39,1091,63053
2016-02-05,72577,346,0,166,1370,74459
2016-02-06,77516,465,0,81,1059,79121
2016-02-07,79395,363,0,65,1605,81428
2016-02-08,72842,69,0,381,811,74103
2016-02-09,59751,391,0,0,1066,61208
2016-02-10,59290,411,0,28,1522,61251
2016-02-11,64334,336,0,66,1735,66471
2016-02-12,76695,644,0,8,1854,79201
2016-02-13,78951,508,0,0,1281,80740
2016-02-14,82441,319,0,54,1740,84554
2016-02-15,64689,392,0,1,1310,66392
2016-02-16,64878,506,3,4,1136,66527
2016-02-17,62156,464,0,1,1678,64299
2016-02-18,63916,422,0,67,1691,66096
2016-02-19,72833,399,0,10,1987,75229
2016-02-20,80411,456,0,5,1655,82527
2016-02-21,90590,434,0,95,1359,92478
2016-02-22,62287,281,0,34,1424,64026
2016-02-23,61017,376,0,4,1075,62472
2016-02-24,62541,309,0,16,1648,64514
2016-02-25,65975,365,0,109,1426,67875
2016-02-26,76534,325,0,5,1928,78792
2016-02-27,75765,750,0,21,1724,78260
2016-02-28,91602,359,0,0,1656,93617
2016-02-29,64478,402,0,48,1424,66352
2016-03-01,67930,404,0,8,1501,69843
2016-03-02,66028,273,0,3,1756,68060
2016-03-03,65863,289,0,129,1613,67894
2016-03-04,80051,209,0,378,1474,82112
2016-03-05,77794,303,0,1,1865,79963
2016-03-06,92658,302,0,75,2353,95388
2016-03-07,66098,460,0,46,1773,68377
2016-03-08,58985,678,0,3,1304,60970
2016-03-09,63922,286,0,82,1932,66222
2016-03-10,69336,480,0,432,1646,71894
2016-03-11,79546,484,0,18,1812,81860
2016-03-12,81932,442,0,6,1399,83779
2016-03-13,100157,434,0,88,2750,103429
2016-03-14,70647,502,0,333,1992,73474
2016-03-15,64846,334,2,25,1709,66916
2016-03-16,67516,363,0,909,1831,70619
2016-03-17,73995,294,0,103,2504,76896
2016-03-18,93801,395,0,370,2628,97194
2016-03-19,117059,439,0,51,2060,119609
2016-03-20,111381,385,0,1076,2764,115606
2016-03-21,75885,480,0,15,1984,78364
2016-03-22,72974,415,0,433,1579,75401
2016-03-23,84193,544,0,2434,1691,88862
2016-03-24,112630,425,0,2605,2160,117820
2016-03-25,159216,579,0,358,2010,162163
2016-03-26,111834,598,0,3010,1796,117238
2016-03-27,124614,399,0,3266,3367,131646
2016-03-28,221860,515,0,1893,3033,227301
2016-03-29,110897,581,0,726,2903,115107
2016-03-30,79241,474,0,80,1954,81749
2016-03-31,80086,628,0,2569,2385,85668
2016-04-01,94784,449,143,3156,2839,101371
2016-04-02,116535,463,147,3863,4410,125418
2016-04-03,131676,444,113,3545,4762,140540
2016-04-04,76589,555,0,1003,2953,81100
2016-04-05,68980,361,109,1627,2913,73990
2016-04-06,70189,410,0,1238,2958,74795
2016-04-07,78333,557,0,2184,3110,84184
2016-04-08,92016,330,45,3790,3262,99443
2016-04-09,95745,540,133,2807,4648,103873
2016-04-10,110210,453,126,5225,4538,120552
2016-04-11,76622,643,194,2083,3868,83410
2016-04-12,72026,510,293,462,3122,76413
2016-04-13,72253,400,133,770,3096,76652
2016-04-14,76853,458,0,2426,2978,82715
2016-04-15,96103,552,455,6695,3617,107422
2016-04-16,106096,472,117,3729,6044,116458
2016-04-17,133225,405,116,2539,5232,141517
2016-04-18,80646,530,55,2675,3489,87395
2016-04-19,6107,2,128,0,0,6237
2016-04-20,70601,343,0,1087,2161,74192
2016-04-21,75616,376,86,4413,2824,83315
2016-04-22,97830,428,150,2981,3471,104860
2016-04-23,99580,531,0,5236,5412,110759
2016-04-24,115982,538,0,2526,6152,125198
2016-04-25,106542,436,0,2658,4560,114196
2016-04-26,95758,538,117,556,4239,101208
2016-04-27,97202,546,318,527,4121,102714
2016-04-28,108793,443,0,4115,3949,117300
2016-04-29,135543,581,176,3227,4072,143599
2016-04-30,155597,499,0,4376,8377,168849
2016-05-01,147430,511,100,2044,7283,157368
2016-05-02,155514,726,271,979,5278,162768
2016-05-03,117766,629,0,7530,5491,131416
2016-05-04,98788,482,124,3063,5740,108197
2016-05-05,111297,554,101,1848,6696,120496
2016-05-06,108398,538,0,7260,4401,120597
2016-05-07,129964,566,339,2721,13442,147032
2016-05-08,207443,655,139,3361,12178,223776
2016-05-09,102884,463,0,2811,7298,113456
2016-05-10,81021,361,0,1948,6646,89976
2016-05-11,83807,329,322,2582,6050,93090
2016-05-12,92056,617,0,6418,6791,105882
2016-05-13,110750,465,110,8979,5985,126289
2016-05-14,124509,585,391,4141,12996,142622
2016-05-15,127402,508,112,5230,10525,143777
2016-05-16,132115,976,295,901,8338,142625
2016-05-17,99014,664,151,2295,8225,110349
2016-05-18,93539,602,76,4682,7437,106336
2016-05-19,92795,588,78,4016,8436,105913
2016-05-20,111831,806,93,11734,7651,132115
2016-05-21,134369,679,463,7108,16929,159548
2016-05-22,172543,761,167,7184,12758,193413
2016-05-23,102699,477,274,6153,7801,117404
2016-05-24,85829,478,338,4847,8661,100153
2016-05-25,102239,620,0,1194,8840,112893
2016-05-26,133259,682,245,10637,10594,155417
2016-05-27,128472,497,78,8294,6132,143473
2016-05-28,155804,633,0,4379,20756,181572
2016-05-29,244398,605,36,5761,14858,265658
2016-05-30,114459,721,163,739,9143,125225
2016-05-31,90349,554,343,1955,10529,103730
2016-06-01,109128,575,168,3339,10240,123450
2016-06-02,118558,662,100,6396,10421,136137
2016-06-03,129721,683,68,8980,7828,147280
2016-06-04,156895,473,194,3259,19284,180105
2016-06-05,202217,710,295,5124,14142,222488
2016-06-06,112106,790,0,4819,9524,127239
2016-06-07,103000,643,74,2055,8482,114254
2016-06-08,109584,617,718,1575,10280,122774
2016-06-09,112535,693,303,3056,10776,127363
2016-06-10,140838,585,280,11634,8526,161863
2016-06-11,173047,743,9,3972,21463,199234
2016-06-12,190102,718,0,12316,16287,219423
2016-06-13,115172,665,292,1227,7611,124967
2016-06-14,101974,1206,268,5202,11354,120004
2016-06-15,118043,711,109,8053,11158,138074
2016-06-16,127010,803,0,8281,12503,148597
2016-06-17,162830,563,0,12527,8773,184693
2016-06-18,176661,467,346,3216,23084,203774
2016-06-19,269022,1104,257,5545,16480,292408
2016-06-20,136655,579,46,7104,10676,155060
2016-06-21,126975,658,4,3500,11373,142510
2016-06-22,126130,741,265,3356,12002,142494
2016-06-23,144504,1261,203,4546,13040,163554
2016-06-24,170279,1185,554,8575,5824,186417
2016-06-25,236419,830,360,8791,23893,270293
2016-06-26,280208,1226,278,11891,18773,312376
2016-06-27,172452,924,395,1423,11908,187102
2016-06-28,140116,889,488,1955,10769,154217
2016-06-29,147856,863,0,4048,14684,167451
2016-06-30,169985,1232,47,4773,17064,193101
2016-07-01,213221,1147,101,8866,11559,234894
2016-07-02,290788,1172,472,4383,20898,317713
2016-07-03,314873,1685,0,9329,20241,346128
2016-07-04,185527,1209,69,8238,12945,207988
2016-07-05,161285,1332,342,2817,13883,179659
2016-07-06,169790,974,263,2380,17311,190718
2016-07-07,180008,1382,28,3554,17505,202477
2016-07-08,222612,1399,122,11021,12978,248132
2016-07-09,367854,1213,123,8163,27540,404893
2016-07-10,428586,2487,151,11880,15234,458338
2016-07-11,220046,1472,212,3075,15241,240046
2016-07-12,175973,1520,342,4388,16117,198340
2016-07-13,196064,1090,0,8162,18866,224182
2016-07-14,249472,1827,145,11839,19597,282880
2016-07-15,281182,1722,207,8404,13911,305426
2016-07-16,362805,1190,201,7873,30182,402251
2016-07-17,350154,1975,99,7080,21885,381193
2016-07-18,236193,1580,90,4747,10369,252979
2016-07-19,198675,2431,0,1811,19727,222644
2016-07-20,206873,1383,136,4608,21092,234092
2016-07-21,239302,2064,0,8693,20986,271045
2016-07-22,338323,1741,0,10703,12760,363527
2016-07-23,411506,1817,0,7375,29802,450500
2016-07-24,389287,2325,0,11963,22421,425996
2016-07-25,262114,1544,82,7420,17153,288313
2016-07-26,221558,1870,130,2073,18782,244413
2016-07-27,214151,1592,126,5539,21821,243229
2016-07-28,265136,2007,219,8565,22246,298173
2016-07-29,351393,1593,130,10440,16051,379607
2016-07-30,497315,2004,294,9361,23764,532738
2016-07-31,454253,2377,0,12535,23070,492235
2016-08-01,293925,1459,0,7813,17004,320201
2016-08-02,227895,1680,0,3250,15636,248461
2016-08-03,249214,1214,5,7142,21993,279568
2016-08-04,281095,1809,227,9327,21293,313751
2016-08-05,373578,1278,0,18027,15401,408284
2016-08-06,476541,1563,308,8197,31116,517725
2016-08-07,451772,2132,0,10968,22954,487826
2016-08-08,279298,1640,0,2644,17214,300796
2016-08-09,241588,1805,495,2786,20128,266802
2016-08-10,282935,1620,0,5925,22884,313364
2016-08-11,343908,2222,228,8922,20802,376082
2016-08-12,330726,1331,100,14365,15897,362419
2016-08-13,456948,1392,277,7148,31905,497670
2016-08-14,425756,2487,0,15341,22893,466477
2016-08-15,390796,1359,0,7173,15633,414961
2016-08-16,296983,2025,174,4795,19751,323728
2016-08-17,269476,1297,0,3827,22292,296892
2016-08-18,290851,1689,106,10654,20854,324154
2016-08-19,355475,1378,164,17481,13115,387613
2016-08-20,454708,1312,54,12508,31946,500528
2016-08-21,467163,1821,0,14449,23229,506662
2016-08-22,301950,1537,192,5134,15592,324405
2016-08-23,254124,1909,504,5820,19052,281409
2016-08-24,263272,1474,294,10023,21630,296693
2016-08-25,274324,1205,0,8011,13893,297433
2016-08-26,342945,1230,352,10600,14374,369501
2016-08-27,423156,1657,148,13514,30363,468838
2016-08-28,420971,1681,0,13172,23132,458956
2016-08-29,276348,1015,173,11265,15151,303952
2016-08-30,248846,1021,0,3618,18083,271568
2016-08-31,232604,1272,84,2782,19124,255866
2016-09-01,184375,1039,202,6246,18679,210541
2016-09-02,216872,1494,137,18686,11854,249043
2016-09-03,279865,1003,0,7100,27993,315961
2016-09-04,331389,1168,0,9571,19544,361672
2016-09-05,187463,1110,251,6041,13315,208180
2016-09-06,144932,1166,146,2995,13777,163016
2016-09-07,153717,671,241,6530,16074,177233
2016-09-08,156345,758,0,5114,16084,178301
2016-09-09,193554,1009,0,7649,11192,213404
2016-09-10,254790,792,181,5390,26004,287157
2016-09-11,260091,991,0,9276,20972,291330
2016-09-12,150193,754,187,7848,12861,171843
2016-09-13,133119,831,303,2410,14442,151105
2016-09-14,137143,936,139,7396,11969,157583
2016-09-15,152947,1208,291,8835,17280,180561
2016-09-16,170151,1108,0,11457,10393,193109
2016-09-17,200409,945,334,9761,26356,237805
2016-09-18,214160,1229,0,7537,19537,242463
2016-09-19,135381,905,0,3352,12234,151872
2016-09-20,106440,973,539,5295,12997,126244
2016-09-21,116799,939,0,4950,12918,135606
2016-09-22,123163,796,155,4864,15939,144917
2016-09-23,148743,868,102,8015,10570,168298
2016-09-24,191701,745,213,5305,24167,222131
2016-09-25,222195,1009,165,11955,13210,248534
2016-09-26,124243,872,165,10161,12086,147527
2016-09-27,114373,747,304,4656,12433,132513
2016-09-28,113336,599,0,3261,14557,131753
2016-09-29,116912,754,144,3228,14789,135827
2016-09-30,142516,787,38,11809,9998,165148
2016-10-01,144929,783,0,6743,16527,168982
2016-10-02,168360,859,87,11084,16305,196695
2016-10-03,124224,663,11,3987,9682,138567
2016-10-04,91493,721,440,1376,9938,103968
2016-10-05,103641,714,255,5913,11374,121897
2016-10-06,105627,727,0,7432,10379,124165
2016-10-07,113839,650,206,7374,7965,130034
2016-10-08,132956,600,0,5200,18150,156906
2016-10-09,162284,722,0,7881,14059,184946
2016-10-10,87894,619,248,7014,8947,104722
2016-10-11,87571,621,0,3700,7604,99496
2016-10-12,87155,626,507,3038,9074,100400
2016-10-13,102862,513,460,4019,9397,117251
2016-10-14,107016,867,0,10085,5662,123630
2016-10-15,115548,677,0,8832,15199,140256
2016-10-16,139704,654,0,5096,11507,156961
2016-10-17,89518,847,133,3710,8367,102575
2016-10-18,75012,455,73,232,7861,83633
2016-10-19,85870,541,0,6167,8775,101353
2016-10-20,89394,699,139,3813,9222,103267
2016-10-21,104144,896,0,5845,5507,116392
2016-10-22,112755,631,322,5990,13275,132973
2016-10-23,134226,859,325,3454,10917,149781
2016-10-24,85431,666,0,2863,7656,96616
2016-10-25,61233,695,95,1779,6138,69940
2016-10-26,86149,635,0,2890,5797,95471
2016-10-27,87764,581,0,2638,6544,97527
2016-10-28,119145,224,0,5488,6822,131679
2016-10-29,153687,874,176,5161,11288,171186
2016-10-30,129819,597,0,8357,1493,140266
2016-10-31,109913,523,0,963,4049,115448
2016-11-01,156004,1069,177,2693,2675,162618
2016-11-02,114997,797,142,4820,1930,122686
2016-11-03,87312,578,64,6181,1391,95526
2016-11-04,93782,669,145,5074,3054,102724
2016-11-05,97590,663,188,3747,1750,103938
2016-11-06,108620,727,0,3281,1779,114407
2016-11-07,68109,407,0,3130,1278,72924
2016-11-08,66492,362,186,409,1790,69239
2016-11-09,74131,489,0,3,1180,75803
2016-11-10,82016,522,0,2924,1062,86524
2016-11-11,90614,663,0,3719,953,95949
2016-11-12,89765,532,0,3697,2050,96044
2016-11-13,106835,529,0,7059,3357,117780
2016-11-14,69447,159,0,10,674,70290
2016-11-15,65195,513,0,53,2667,68428
2016-11-16,73526,571,0,503,2356,76956
2016-11-17,72142,588,142,2325,2204,77401
2016-11-18,85405,550,0,2735,850,89540
2016-11-19,77653,467,0,3228,1635,82983
2016-11-20,96020,517,0,3052,2739,102328
2016-11-21,78087,616,0,15,2475,81193
2016-11-22,59400,460,0,3,2436,62299
2016-11-23,72497,450,0,28,2143,75118
2016-11-24,70813,453,0,3025,2257,76548
2016-11-25,95553,526,0,0,2191,98270
2016-11-26,79424,1080,0,2494,1752,84750
2016-11-27,103182,563,0,4159,2897,110801
2016-11-28,72468,492,0,0,2720,75680
2016-11-29,64900,473,0,1877,2869,70119
2016-11-30,66429,504,0,53,2279,69265
2016-12-01,69128,539,0,120,1943,71730
2016-12-02,81722,487,0,1,2204,84414
2016-12-03,81097,605,0,0,1869,83571
2016-12-04,90419,370,0,53,2536,93378
2016-12-05,65261,755,0,239,1992,68247
2016-12-06,72774,511,0,347,1997,75629
2016-12-07,68422,559,0,0,2140,71121
2016-12-08,76671,509,0,192,1724,79096
2016-12-09,80317,519,0,9,1703,82548
2016-12-10,99386,920,0,875,1791,102972
2016-12-11,103844,501,0,947,3237,108529
2016-12-12,68797,349,0,1894,2233,73273
2016-12-13,60727,468,0,3,1206,62404
2016-12-14,68116,367,0,74,1780,70337
2016-12-15,75609,519,0,343,2722,79193
2016-12-16,93919,374,0,907,1955,97155
2016-12-17,105600,994,0,0,2910,109504
2016-12-18,113519,639,0,92,2554,116804
2016-12-19,80974,499,0,44,2047,83564
2016-12-20,84547,489,0,48,1946,87030
2016-12-21,87447,378,0,0,1567,89392
2016-12-22,129236,616,0,165,1700,131717
2016-12-23,151471,586,0,0,1665,153722
2016-12-24,157453,640,0,57,1351,159501
2016-12-25,93705,322,0,0,746,94773
2016-12-26,113237,1565,0,0,1524,116326
2016-12-27,108501,1315,0,105,1115,111036
2016-12-28,105700,775,0,0,1334,107809
2016-12-29,115091,1197,0,130,1597,118015
2016-12-30,147062,1795,0,11,2100,150968
2016-12-31,83475,667,0,2,1203,85347
2017-01-01,108742,1875,0,78,1911,112606
2017-01-02,149975,1253,0,8,3291,154527
2017-01-03,112340,711,0,13,3433,116497
2017-01-04,100736,535,0,512,3218,105001
2017-01-05,114369,835,0,15,2282,117501
2017-01-06,110276,534,0,0,2438,113248
2017-01-07,141731,645,0,7,1302,143685
2017-01-08,162694,530,0,158,2245,165627
2017-01-09,103546,917,0,2,1801,106266
2017-01-10,73120,363,0,47,2091,75621
2017-01-11,76797,496,0,119,2116,79528
2017-01-12,73968,456,0,1,1227,75652
2017-01-13,67008,463,0,0,1363,68834
2017-01-14,72242,523,0,2,915,73682
2017-01-15,82354,527,0,109,1450,84440
2017-01-16,57610,570,0,0,1331,59511
2017-01-17,49615,297,0,0,1086,50998
2017-01-18,52076,349,0,0,1340,53765
2017-01-19,65021,372,0,75,1581,67049
2017-01-20,71497,316,0,6,2040,73859
2017-01-21,68936,585,0,0,922,70443
2017-01-22,79633,442,0,127,1897,82099
2017-01-23,60899,302,0,39,1527,62767
2017-01-24,54029,439,0,0,1642,56110
2017-01-25,60875,328,0,106,1240,62549
2017-01-26,60899,303,0,0,1791,62993
2017-01-27,76819,301,0,11,1743,78874
2017-01-28,71803,374,0,2,1567,73746
2017-01-29,78300,524,0,76,1712,80612
2017-01-30,57973,386,0,0,1491,59850
2017-01-31,60792,174,0,23,1553,62542
2017-02-01,55764,442,0,32,1367,57605
2017-02-02,63126,404,0,16,1648,65194
2017-02-03,73074,440,0,0,1538,75052
2017-02-04,73879,284,0,0,1254,75417
2017-02-05,78674,385,0,111,2218,81388
2017-02-06,62326,378,0,113,1626,64443
2017-02-07,57949,299,0,0,1672,59920
2017-02-08,67328,372,0,40,1920,69660
2017-02-09,69178,303,0,0,1561,71042
2017-02-10,76264,327,0,0,2080,78671
2017-02-11,77424,442,0,0,949,78815
2017-02-12,94290,298,0,114,2307,97009
2017-02-13,69050,374,0,48,2343,71815
2017-02-14,64049,484,0,22,1767,66322
2017-02-15,71143,439,0,59,1608,73249
2017-02-16,74855,337,0,0,2023,77215
2017-02-17,83903,344,0,48,1907,86202
2017-02-18,85440,448,0,43,1428,87359
2017-02-19,107242,526,0,89,2467,110324
2017-02-20,70406,650,0,53,1834,72943
2017-02-21,66187,320,0,4,2195,68706
2017-02-22,69620,429,0,114,2356,72519
2017-02-23,72137,506,0,3,1831,74477
2017-02-24,85205,396,0,0,2182,87783
2017-02-25,87761,340,0,43,1749,89893
2017-02-26,106633,649,0,127,2597,110006
2017-02-27,74061,541,0,52,1748,76402
2017-02-28,67907,614,0,32,1930,70483
2017-03-01,73339,314,0,56,2101,75810
2017-03-02,73824,434,0,51,2068,76377
2017-03-03,85814,575,0,2,2183,88574
2017-03-04,89883,438,2,23,1578,91924
2017-03-05,101367,446,0,329,2325,104467
2017-03-06,69164,506,0,50,2307,72027
2017-03-07,63379,416,0,2,1806,65603
2017-03-08,70009,484,0,93,1922,72508
2017-03-09,70222,342,0,372,1905,72841
2017-03-10,84697,426,0,48,2294,87465
2017-03-11,85462,360,0,6,1350,87178
2017-03-12,123292,441,0,84,2912,126729
2017-03-13,72074,270,0,68,2273,74685
2017-03-14,67643,426,0,4,2574,70647
2017-03-15,70405,338,0,887,1604,73234
2017-03-16,78159,394,0,401,2505,81459
2017-03-17,93480,435,0,7,2533,96455
2017-03-18,90078,493,0,345,1226,92142
2017-03-19,118068,447,144,1179,2591,122429
2017-03-20,74432,410,140,951,2729,78662
2017-03-21,68896,501,0,904,2464,72765
2017-03-22,72713,358,1,75,2104,75251
2017-03-23,75576,319,0,29,2189,78113
2017-03-24,87197,532,0,20,2458,90207
2017-03-25,98903,394,180,916,1746,102139
2017-03-26,115652,337,0,1017,1760,118766
2017-03-27,79043,393,0,2,5215,84653
2017-03-28,70075,410,0,8,3922,74415
2017-03-29,74596,435,84,633,1719,77467
2017-03-30,75847,454,0,14,1445,77760
2017-03-31,91136,408,0,906,1787,94237
2017-04-01,106076,319,145,2747,3442,112729
2017-04-02,121198,370,0,1057,2181,124806
2017-04-03,78049,466,0,556,1604,80675
2017-04-04,69281,436,180,249,2566,72712
2017-04-05,77665,448,119,636,3305,82173
2017-04-06,86026,355,0,1899,4068,92348
2017-04-07,99134,388,200,5464,3237,108423
2017-04-08,131179,308,317,3783,5397,140984
2017-04-09,134727,372,0,2281,6111,143491
2017-04-10,90596,217,0,207,3294,94314
2017-04-11,89002,306,110,2163,3632,95213
2017-04-12,101446,360,96,170,4654,106726
2017-04-13,131122,341,0,2020,4749,138232
2017-04-14,179072,388,0,5155,4069,188684
2017-04-15,121368,343,0,2827,8568,133106
2017-04-16,127018,370,0,316,7927,135631
2017-04-17,253689,547,334,1073,6905,262548
2017-04-18,142393,475,357,3005,7981,154211
2017-04-19,98705,351,141,259,7902,107358
2017-04-20,93910,711,171,1932,5489,102213
2017-04-21,112541,421,256,810,4477,118505
2017-04-22,145385,531,0,7588,11355,164859
2017-04-23,142083,467,156,416,8671,151793
2017-04-24,97139,172,92,2953,5975,106331
2017-04-25,110184,439,0,1123,5575,117321
2017-04-26,103065,291,151,414,6304,110225
2017-04-27,106119,370,130,1951,6124,114694
2017-04-28,120847,313,398,2721,4522,128801
2017-04-29,148177,454,136,5025,10463,164255
2017-04-30,144849,603,3,557,8218,154230
2017-05-01,197969,398,271,1161,7098,206897
2017-05-02,184116,407,182,4540,7333,196578
2017-05-03,122807,347,0,889,7389,131432
2017-05-04,98356,391,0,4180,7111,110038
2017-05-05,110205,224,124,5414,5384,121351
2017-05-06,128947,393,325,2570,13793,146028
2017-05-07,137136,412,388,967,11234,150137
2017-05-08,99101,424,131,1507,6719,107882
2017-05-09,83378,261,0,1023,8243,92905
2017-05-10,85798,280,362,2926,7348,96714
2017-05-11,89463,405,257,1681,8281,100087
2017-05-12,90138,254,0,7993,5351,103736
2017-05-13,104638,374,145,8718,14669,128544
2017-05-14,139621,956,0,586,13268,154431
2017-05-15,95227,287,0,1587,6246,103347
2017-05-16,87313,248,236,746,8935,97478
2017-05-17,89044,326,139,3840,8919,102268
2017-05-18,88520,297,123,2776,11325,103041
2017-05-19,114975,285,240,2737,8268,126505
2017-05-20,124041,532,461,2925,18029,145988
2017-05-21,148093,363,198,8446,14183,171283
2017-05-22,94309,407,186,2639,7275,104816
2017-05-23,93218,258,166,2601,9767,106010
2017-05-24,101393,323,0,560,9679,111955
2017-05-25,123008,351,0,4139,9049,136547
2017-05-26,115006,289,286,2819,7338,125738
2017-05-27,136909,366,145,2917,23521,163858
2017-05-28,228767,468,334,1312,17007,247888
2017-05-29,116949,300,99,2746,9712,129806
2017-05-30,93348,286,244,1401,12275,107554
2017-05-31,102607,312,278,1152,12241,116590
2017-06-01,120677,320,225,1603,11001,133826
2017-06-02,145498,289,202,12623,8358,166970
2017-06-03,158978,360,328,8182,22874,190722
2017-06-04,237799,535,0,4877,15964,259175
2017-06-05,202151,627,174,3487,11056,217495
2017-06-06,140134,311,0,2710,13792,156947
2017-06-07,115863,408,0,2574,12663,131508
2017-06-08,118272,517,159,2019,12554,133521
2017-06-09,148633,432,0,13231,9423,171719
2017-06-10,197561,463,242,5591,26941,230798
2017-06-11,235903,425,223,5383,15276,257210
2017-06-12,140451,483,343,1049,9889,152215
2017-06-13,118463,426,352,3519,13811,136571
2017-06-14,152752,513,0,2099,13699,169063
2017-06-15,172785,504,478,2242,15006,191015
2017-06-16,188203,430,0,3851,9757,202241
2017-06-17,198813,561,181,7881,25948,233384
2017-06-18,343427,574,165,5972,19519,369657
2017-06-19,165051,525,63,818,12096,178553
2017-06-20,134858,494,100,3476,14752,153680
2017-06-21,142713,458,123,850,14038,158182
2017-06-22,158051,831,322,4973,15340,179517
2017-06-23,188139,506,0,4008,10935,203588
2017-06-24,222416,604,0,8067,27856,258943
2017-06-25,268707,843,0,3736,20360,293646
2017-06-26,190108,416,216,3875,13644,208259
2017-06-27,154191,590,185,1889,15809,172664
2017-06-28,170348,592,80,2327,16526,189873
2017-06-29,178970,1049,0,6032,18715,204766
2017-06-30,230212,849,237,8694,14684,254676
2017-07-01,284091,696,354,6434,30624,322199
2017-07-02,282331,930,0,6309,22076,311646
2017-07-03,193985,994,89,1492,17161,213721
2017-07-04,159165,553,404,9120,19132,188374
2017-07-05,176869,1022,137,3653,18889,200570
2017-07-06,194150,689,152,10829,16288,222108
2017-07-07,241131,782,0,14738,14460,271111
2017-07-08,337653,629,103,9194,31819,379398
2017-07-09,377758,1268,0,8856,21504,409386
2017-07-10,234987,841,185,5108,16900,258021
2017-07-11,186547,625,230,5989,19999,213390
2017-07-12,191867,901,333,3930,21167,218198
2017-07-13,223766,900,79,3130,20711,248586
2017-07-14,298003,1059,0,10191,18155,327408
2017-07-15,372928,1051,182,9808,28425,412394
2017-07-16,384110,1597,143,7011,25669,418530
2017-07-17,244370,1150,14,1927,21313,268774
2017-07-18,198110,1541,263,5004,22780,227698
2017-07-19,224105,959,114,4340,23886,253404
2017-07-20,264538,1028,330,5891,23359,295146
2017-07-21,308616,1237,139,10176,17488,337656
2017-07-22,433282,1127,128,6108,29586,470231
2017-07-23,430043,1523,0,7052,26486,465104
2017-07-24,264096,1131,7,1897,20535,287666
2017-07-25,220555,1027,331,4256,19226,245395
2017-07-26,251052,1107,155,5772,24380,282466
2017-07-27,281582,1194,89,9837,24187,316889
2017-07-28,335076,1191,0,13512,18264,368043
2017-07-29,477923,1329,233,9919,31602,521006
2017-07-30,463395,1499,112,5263,27777,498046
2017-07-31,312861,1246,50,4577,21863,340597
2017-08-01,239167,1192,0,7293,23415,271067
2017-08-02,234606,1019,0,5265,25059,265949
2017-08-03,295397,1284,0,6594,20427,323702
2017-08-04,359996,1318,214,9993,18814,390335
2017-08-05,417602,1287,164,14370,32191,465614
2017-08-06,413327,1990,0,7107,22072,444496
2017-08-07,307036,1260,0,2258,21601,332155
2017-08-08,242977,1205,182,7642,24631,276637
2017-08-09,294171,1127,261,3726,21962,321247
2017-08-10,281976,1333,0,7140,21369,311818
2017-08-11,352269,1507,106,10117,19240,383239
2017-08-12,453729,1553,184,12710,37364,505540
2017-08-13,372156,1269,9,9756,27510,410700
2017-08-14,324624,1224,251,2536,17575,346210
2017-08-15,328689,1047,87,3727,23290,356840
2017-08-16,283892,1285,2,6358,23666,315203
2017-08-17,276370,1217,126,6817,23271,307801
2017-08-18,341140,1185,0,14324,16668,373317
2017-08-19,486493,1494,375,12479,37614,538455
2017-08-20,439936,1676,0,6697,25512,473821
2017-08-21,285434,1167,261,8736,18622,314220
2017-08-22,233411,1229,331,6128,21335,262434
2017-08-23,219632,995,401,9258,24167,254453
2017-08-24,263217,1128,87,9282,22689,296403
2017-08-25,325937,1299,178,12886,17132,357432
2017-08-26,415309,1217,178,11785,32835,461324
2017-08-27,396140,1674,0,9538,26061,433413
2017-08-28,284817,909,0,7359,17746,310831
2017-08-29,218902,902,124,5118,22843,247889
2017-08-30,230281,1056,147,3473,22593,257550
2017-08-31,278446,896,224,8054,22242,309862
2017-09-01,236027,780,321,9107,16178,262413
2017-09-02,285690,849,0,9198,34191,329928
2017-09-03,277352,1180,14,7873,24299,310718
2017-09-04,167456,853,319,2047,14899,185574
2017-09-05,140096,857,467,4414,16901,162735
2017-09-06,156522,580,501,2847,17755,178205
2017-09-07,183766,621,81,7658,18967,211093
2017-09-08,228145,790,406,10439,12329,252109
2017-09-09,224116,720,329,9696,28105,262966
2017-09-10,243323,901,0,6841,22004,273069
2017-09-11,146857,587,693,3460,12764,164361
2017-09-12,132860,622,0,5293,17876,156651
2017-09-13,107397,417,158,1484,15042,124498
2017-09-14,136742,379,143,4769,19133,161166
2017-09-15,172496,1028,153,8870,12395,194942
2017-09-16,200215,463,282,11566,32723,245249
2017-09-17,195953,549,105,9554,16727,222888
2017-09-18,134611,507,256,2109,12717,150200
2017-09-19,115927,435,305,2602,16588,135857
2017-09-20,117186,392,0,2647,17305,137530
2017-09-21,131767,471,452,4769,18454,155913
2017-09-22,144011,410,416,8772,10673,164282
2017-09-23,164900,544,178,5522,28016,199160
2017-09-24,198142,493,31,11016,19859,229541
2017-09-25,115136,727,148,3524,11603,131138
2017-09-26,102436,334,131,5787,15189,123877
2017-09-27,110290,423,0,1890,15393,127996
2017-09-28,121862,436,170,6970,17326,146764
2017-09-29,145032,488,114,11119,10080,166833
2017-09-30,170058,520,0,7879,24846,203303
2017-10-01,188623,527,85,7924,19644,216803
2017-10-02,113467,370,115,5801,10757,130510
2017-10-03,113857,301,182,5920,13330,133590
2017-10-04,97446,263,0,2543,10376,110628
2017-10-05,105062,299,0,4866,11369,121596
2017-10-06,124208,344,267,8997,8663,142479
2017-10-07,136568,483,185,5004,22974,165214
2017-10-08,154761,399,365,8294,15722,179541
2017-10-09,96654,304,0,3419,9440,109817
2017-10-10,93331,433,0,1617,10770,106151
2017-10-11,92762,419,280,4144,9414,107019
2017-10-12,98586,346,151,5001,11290,115374
2017-10-13,110552,330,0,9477,6043,126402
2017-10-14,132728,494,249,8325,17134,158930
2017-10-15,162674,432,0,4639,13884,181629
2017-10-16,95040,306,270,2388,7149,105153
2017-10-17,80919,275,343,3175,8418,93130
2017-10-18,88559,234,305,4402,7785,101285
2017-10-19,98103,310,0,3385,9704,111502
2017-10-20,111446,324,0,11259,5821,128850
2017-10-21,120326,543,241,9212,14963,145285
2017-10-22,137883,388,0,2926,12190,153387
2017-10-23,99656,245,0,3961,6857,110719
2017-10-24,80183,371,51,1939,7330,89874
2017-10-25,91396,262,9,229,7137,99033
2017-10-26,107605,323,0,1414,9990,119332
2017-10-27,120403,314,75,7884,5802,134478
2017-10-28,143352,465,260,4985,14246,163308
2017-10-29,159087,461,0,828,8562,168938
2017-10-30,114439,362,152,4630,3826,123409
2017-10-31,115333,378,183,684,4014,120592
2017-11-01,129485,437,0,217,3685,133824
2017-11-02,105195,372,0,1251,3913,110731
2017-11-03,107675,520,0,9261,3723,121179
2017-11-04,130047,399,310,2806,4336,137898
2017-11-05,144276,570,0,713,4435,149994
2017-11-06,73542,323,0,788,2744,77397
2017-11-07,74396,229,163,0,2513,77301
2017-11-08,75608,200,4,3941,1813,81566
2017-11-09,79910,180,0,2697,2384,85171
2017-11-10,91651,428,0,5842,2333,100254
2017-11-11,99605,240,0,2456,2211,104512
2017-11-12,110767,280,0,3014,2468,116529
2017-11-13,71857,307,20,1253,2111,75548
2017-11-14,68969,215,179,3,2033,71399
2017-11-15,74730,178,166,1,1893,76968
2017-11-16,74721,201,0,76,2161,77159
2017-11-17,93698,215,0,2343,2031,98287
2017-11-18,86540,234,0,2409,1790,90973
2017-11-19,101873,209,0,266,1933,104281
2017-11-20,78842,206,0,58,1556,80662
2017-11-21,73076,176,0,635,1858,75745
2017-11-22,70209,239,0,1062,1517,73027
2017-11-23,78588,199,0,56,1740,80583
2017-11-24,92821,264,0,2419,1749,97253
2017-11-25,89783,238,0,2563,1984,94568
2017-11-26,102783,249,0,106,2157,105295
2017-11-27,74759,211,0,737,1607,77314
2017-11-28,67552,170,0,3,1669,69394
2017-11-29,67322,251,0,62,1362,68997
2017-11-30,69583,210,0,16,2025,71834
2017-12-01,85268,278,0,6,1703,87255
2017-12-02,82395,125,0,48,1336,83904
2017-12-03,92231,340,0,177,2079,94827
2017-12-04,70735,190,0,5,1625,72555
2017-12-05,66300,197,0,8,1689,68194
2017-12-06,69807,198,0,135,1315,71455
2017-12-07,80232,238,0,3,1640,82113
2017-12-08,88373,309,0,2592,1909,93183
2017-12-09,87640,1199,0,49,1779,90667
2017-12-10,109025,1251,0,10,2471,112757
2017-12-11,72951,194,0,0,1450,74595
2017-12-12,65315,190,0,8,1693,67206
2017-12-13,69238,251,0,143,1438,71070
2017-12-14,76895,300,0,1,1659,78855
2017-12-15,93387,293,0,2376,1638,97694
2017-12-16,104734,1553,0,3,2333,108623
2017-12-17,106224,814,0,57,1852,108947
2017-12-18,89291,269,0,40,1475,91075
2017-12-19,89507,251,0,56,1363,91177
2017-12-20,98684,226,0,346,1730,100986
2017-12-21,124952,329,0,0,1757,127038
2017-12-22,158442,420,0,2645,1840,163347
2017-12-23,198590,1252,0,66,1561,201469
2017-12-24,121704,378,0,44,1050,123176
2017-12-25,84180,273,0,40,402,84895
2017-12-26,119226,1644,0,0,1490,122360
2017-12-27,116998,827,0,13,1277,119115
2017-12-28,109389,429,0,0,1817,111635
2017-12-29,132872,1292,0,2741,1839,138744
2017-12-30,135515,2048,0,56,1932,139551
2017-12-31,69648,319,0,61,1113,71141
2018-01-01,116466,556,0,112,1992,119126
2018-01-02,177270,1473,0,6,3169,181918
2018-01-03,120987,722,0,552,1822,124083
2018-01-04,122599,514,0,6,2380,125499
2018-01-05,158326,497,0,2768,2169,163760
2018-01-06,159292,463,0,4,1861,161620
2018-01-07,149461,507,0,162,1870,152000
2018-01-08,117114,412,0,0,1358,118884
2018-01-09,93134,382,0,50,1468,95034
2018-01-10,92099,245,0,60,1385,93789
2018-01-11,82643,180,0,3,1544,84370
2018-01-12,89487,531,12,0,1301,91331
2018-01-13,109772,309,0,92,1423,111596
2018-01-14,118131,684,0,63,1535,120413
2018-01-15,49729,65,0,0,1494,51288
2018-01-16,39425,179,0,1,1743,41348
2018-01-17,51913,187,0,65,1954,54119
2018-01-18,62020,188,0,9,1727,63944
2018-01-19,65128,164,0,0,1403,66695
2018-01-20,62617,192,0,0,1084,63893
2018-01-21,71135,221,0,69,1554,72979
2018-01-22,52702,174,3,8,1120,54007
2018-01-23,39193,165,0,8,1382,40748
2018-01-24,43632,202,0,57,1314,45205
2018-01-25,47374,157,0,21,1692,49244
2018-01-26,57919,231,0,3,1688,59841
2018-01-27,57429,267,0,4,1358,59058
2018-01-28,68550,213,0,68,1498,70329
2018-01-29,42548,205,0,0,2851,45604
2018-01-30,47772,225,0,3,1400,49400
2018-01-31,46558,187,0,54,1250,48049
2018-02-01,51549,255,0,0,1224,53028
2018-02-02,54222,212,0,36,1346,55816
2018-02-03,52957,245,0,0,1152,54354
2018-02-04,58789,175,0,145,1371,60480
2018-02-05,42047,180,0,0,1059,43286
2018-02-06,42911,176,0,48,1162,44297
2018-02-07,40543,209,0,55,1145,41952
2018-02-08,47454,184,0,1,1664,49303
2018-02-09,51404,239,0,2,1505,53150
2018-02-10,60637,238,0,23,1374,62272
2018-02-11,74660,242,0,129,1695,76726
2018-02-12,44452,252,0,111,1314,46129
2018-02-13,39692,169,0,0,1632,41493
2018-02-14,52130,238,0,82,1575,54025
2018-02-15,52654,214,0,55,1622,54545
2018-02-16,68145,168,0,74,2042,70429
2018-02-17,74030,281,0,7,1866,76184
2018-02-18,77617,256,0,119,2092,80084
2018-02-19,52140,235,0,47,1566,53988
2018-02-20,49953,213,0,56,1683,51905
2018-02-21,49749,180,0,62,1685,51676
2018-02-22,52572,208,0,26,1789,54595
2018-02-23,60073,223,0,0,1826,62122
2018-02-24,61479,368,0,22,1678,63547
2018-02-25,62123,283,0,49,1497,63952
2018-02-26,46012,225,0,1,1336,47574
2018-02-27,36207,51,0,52,1879,38189
2018-02-28,43829,199,0,82,1660,45770
2018-03-01,46468,167,0,2,1857,48494
2018-03-02,56052,196,0,0,1719,57967
2018-03-03,54329,50,0,6,1577,55962
2018-03-04,66363,269,0,123,1858,68613
2018-03-05,50599,214,0,77,1366,52256
2018-03-06,48438,154,0,51,1656,50299
2018-03-07,49872,167,0,59,1592,51690
2018-03-08,52554,166,0,35,1679,54434
2018-03-09,71926,220,0,6,1787,73939
2018-03-10,66223,205,0,10,1704,68142
2018-03-11,79027,227,0,95,1854,81203
2018-03-12,53302,142,0,4,1500,54948
2018-03-13,51622,126,0,9,1913,53670
2018-03-14,53414,191,0,111,1789,55505
2018-03-15,62947,194,0,4,2069,65214
2018-03-16,79455,205,0,14,2285,81959
2018-03-17,74260,287,0,2,1745,76294
2018-03-18,73352,314,329,1012,2675,77682
2018-03-19,59857,257,0,5,1642,61761
2018-03-20,53742,161,0,1325,1896,57124
2018-03-21,59392,276,0,246,1843,61757
2018-03-22,58958,197,0,19,1861,61035
2018-03-23,82766,221,0,2275,2318,87580
2018-03-24,100287,439,0,2489,2215,105430
2018-03-25,106305,358,0,100,2412,109175
2018-03-26,70238,179,0,1333,1832,73582
2018-03-27,74066,207,0,2324,2280,78877
2018-03-28,79448,219,304,312,3059,83342
2018-03-29,102967,301,0,663,3155,107086
2018-03-30,143464,305,0,45,3046,146860
2018-03-31,103197,246,0,2749,5181,111373
2018-04-01,104086,215,327,219,5205,110052
2018-04-02,215239,421,0,2370,5425,223455
2018-04-03,126750,396,185,901,4840,133072
2018-04-04,88383,262,100,1326,4499,94570
2018-04-05,84830,314,0,1147,4494,90785
2018-04-06,103938,285,100,55,4880,109258
2018-04-07,129792,321,157,5225,7797,143292
2018-04-08,143789,281,140,4577,8722,157509
2018-04-09,99681,423,0,1026,5595,106725
2018-04-10,70192,211,249,243,5517,76412
2018-04-11,72332,235,249,293,4917,78026
2018-04-12,77435,227,0,2406,5151,85219
2018-04-13,88073,269,319,2307,4603,95571
2018-04-14,98517,235,70,4482,7752,111056
2018-04-15,122086,289,185,2282,6563,131405
2018-04-16,83919,294,246,431,4678,89568
2018-04-17,65786,301,321,2559,4622,73589
2018-04-18,71397,174,154,163,5453,77341
2018-04-19,78279,399,152,2447,5133,86410
2018-04-20,96268,256,284,2622,5087,104517
2018-04-21,106454,296,258,4760,6545,118313
2018-04-22,130168,390,154,501,8334,139547
2018-04-23,84714,371,110,4604,5475,95274
2018-04-24,76978,242,179,3275,5274,85948
2018-04-25,90183,223,333,2117,6203,99059
2018-04-26,101747,359,288,5580,5595,113569
2018-04-27,137601,644,318,6925,5505,150993
2018-04-28,139660,369,228,2799,10165,153221
2018-04-29,147924,356,188,728,9379,158575
2018-04-30,136220,462,130,1082,6399,144293
2018-05-01,206959,445,335,5078,8953,221770
2018-05-02,167380,455,126,5519,8355,181835
2018-05-03,113448,381,0,6035,6255,126119
2018-05-04,109776,282,320,5230,5923,121531
2018-05-05,139882,346,0,9744,15055,165027
2018-05-06,127325,486,205,1914,12669,142599
2018-05-07,100378,345,0,797,7376,108896
2018-05-08,88587,212,0,6628,9372,104799
2018-05-09,91018,321,477,1893,10040,103749
2018-05-10,113047,378,0,5233,10035,128693
2018-05-11,100891,469,165,7948,8282,117755
2018-05-12,125796,357,260,5174,20789,152376
2018-05-13,180009,333,177,2387,18310,201216
2018-05-14,99116,542,469,485,8917,109529
2018-05-15,81599,273,165,701,10519,93257
2018-05-16,81362,312,278,2515,9994,94461
2018-05-17,90718,265,0,4625,12166,107774
2018-05-18,109089,261,158,11156,7541,128205
2018-05-19,134907,378,437,3699,20185,159606
2018-05-20,144072,574,122,2757,15536,163061
2018-05-21,148781,371,361,2399,10763,162675
2018-05-22,113364,348,152,4138,11557,129559
2018-05-23,86144,336,343,407,10294,97524
2018-05-24,87592,259,427,5941,11799,106018
2018-05-25,112570,379,324,14057,9682,137012
2018-05-26,127397,398,84,7042,24394,159315
2018-05-27,178205,701,185,6487,17302,202880
2018-05-28,112292,297,266,864,11683,125402
2018-05-29,88320,259,124,2797,13163,104663
2018-05-30,110938,332,392,4669,13451,129782
2018-05-31,132826,343,389,5746,13203,152507
2018-06-01,155862,280,207,8889,10575,175813
2018-06-02,183776,350,135,11405,26933,222599
2018-06-03,240740,650,483,9328,19863,271064
2018-06-04,179280,413,0,4499,11455,195647
2018-06-05,99035,194,443,5178,13633,118483
2018-06-06,113289,367,335,1260,14160,129411
2018-06-07,108058,354,148,8805,14497,131862
2018-06-08,125351,516,324,6091,11006,143288
2018-06-09,128783,464,470,8582,26970,165269
2018-06-10,207441,435,183,7068,20330,235457
2018-06-11,117795,426,266,826,11051,130364
2018-06-12,108545,384,411,1889,14731,125960
2018-06-13,120067,277,807,2370,15494,139015
2018-06-14,136112,432,160,8653,15963,161320
2018-06-15,150294,463,108,7988,12223,171076
2018-06-16,179106,548,125,11379,28280,219438
2018-06-17,256014,319,0,8387,21781,286501
2018-06-18,147684,422,254,1285,13698,163343
2018-06-19,113784,353,0,9390,14810,138337
2018-06-20,135436,565,524,2050,15876,154451
2018-06-21,146914,466,147,7190,17914,172631
2018-06-22,207127,508,416,5985,12763,226799
2018-06-23,216825,540,226,8194,29314,255099
2018-06-24,229213,526,405,7910,21768,259822
2018-06-25,212133,563,1,1116,17427,231240
2018-06-26,157334,424,122,2452,16855,177187
2018-06-27,170511,392,316,5360,19518,196097
2018-06-28,165966,668,402,6905,20400,194341
2018-06-29,211753,629,0,9578,16391,238351
2018-06-30,285632,868,135,8273,34453,329361
2018-07-01,293135,1101,0,7399,26556,328191
2018-07-02,178931,527,258,3213,18338,201267
2018-07-03,140446,600,133,9773,20138,171090
2018-07-04,153604,616,182,1554,21323,177279
2018-07-05,178643,432,369,12246,21348,213038
2018-07-06,223829,742,155,13788,16739,255253
2018-07-07,317684,594,0,6861,33018,358157
2018-07-08,339779,1077,349,9584,27519,378308
2018-07-09,224814,906,163,4790,21105,251778
2018-07-10,174115,1054,270,4318,22022,201779
2018-07-11,180314,894,0,5188,23073,209469
2018-07-12,214012,1251,239,8702,26336,250540
2018-07-13,269823,900,205,10129,19941,300998
2018-07-14,353582,886,123,17113,34932,406636
2018-07-15,365017,1655,0,9951,26880,403503
2018-07-16,255080,1825,439,1346,21791,280481
2018-07-17,207180,863,163,8971,23078,240255
2018-07-18,206777,818,190,4432,25125,237342
2018-07-19,218519,978,510,11368,23652,255027
2018-07-20,296225,1264,5,7168,20464,325126
2018-07-21,402410,1409,133,12275,34616,450843
2018-07-22,408945,1274,189,7089,27252,444749
2018-07-23,252696,1195,321,2032,21185,277429
2018-07-24,204833,1137,123,2234,24109,232436
2018-07-25,217095,1077,225,5616,25845,249858
2018-07-26,248501,1332,602,10920,27118,288473
2018-07-27,332172,1732,149,9825,26200,370078
2018-07-28,438079,1132,0,10003,36234,485448
2018-07-29,414036,1358,0,11273,24022,450689
2018-07-30,271773,979,143,2055,21507,296457
2018-07-31,236780,1009,0,8819,25491,272099
2018-08-01,236552,1105,181,4947,27249,270034
2018-08-02,256298,975,319,11242,27152,295986
2018-08-03,200554,953,0,9183,21827,232517
2018-08-04,418468,1247,114,11269,35579,466677
2018-08-05,388619,1914,186,6941,28555,426215
2018-08-06,283005,1283,147,5717,23670,313822
2018-08-07,239975,1125,0,4764,25130,270994
2018-08-08,230131,1057,0,4185,25491,260864
2018-08-09,261514,1477,0,8283,27938,299212
2018-08-10,350629,1050,151,13352,21857,387039
2018-08-11,370207,1565,170,20026,37038,429006
2018-08-12,367231,1561,0,13744,28758,411294
2018-08-13,274482,1105,261,2778,21752,300378
2018-08-14,254049,972,238,5388,24175,284822
2018-08-15,275951,580,304,5209,25774,307818
2018-08-16,271325,586,185,14453,26181,312730
2018-08-17,364132,984,0,9290,20273,394679
2018-08-18,438914,1292,159,18731,37250,496346
2018-08-19,439047,769,182,11399,26736,478133
2018-08-20,300775,1132,0,3392,21003,326302
2018-08-21,217019,1246,0,6453,23360,248078
2018-08-22,217725,1107,71,11306,24101,254310
2018-08-23,280041,397,113,11809,21656,314016
2018-08-24,332006,918,0,10832,19774,363530
2018-08-25,427918,1091,35,15295,36720,481059
2018-08-26,352413,811,0,9000,27836,390060
2018-08-27,218201,1235,90,5194,20635,245355
2018-08-28,196459,826,150,4669,23575,225679
2018-08-29,211124,867,186,6078,24434,242689
2018-08-30,234733,628,158,13453,24455,273427
2018-08-31,315128,683,0,8513,18915,343239
2018-09-01,304000,688,295,9495,36534,351012
2018-09-02,326562,1784,188,5937,25840,360311
2018-09-03,181911,1333,18,3578,15608,202448
2018-09-04,146845,563,0,2849,15828,166085
2018-09-05,146550,461,253,1282,19091,167637
2018-09-06,163037,1424,84,9760,19473,193778
2018-09-07,211474,782,0,12766,14473,239495
2018-09-08,230084,886,137,13524,31838,276469
2018-09-09,257943,1076,318,6124,24234,289695
2018-09-10,150342,457,0,1156,14283,166238
2018-09-11,129462,529,89,9131,17782,156993
2018-09-12,123947,700,323,2277,19013,146260
2018-09-13,132922,438,353,8802,19959,162474
2018-09-14,172573,539,150,7205,14786,195253
2018-09-15,205008,930,17,7743,32487,246185
2018-09-16,247143,678,303,3711,23785,275620
2018-09-17,144953,556,330,962,14681,161482
2018-09-18,121900,430,176,1817,17179,141502
2018-09-19,138376,425,191,7278,18016,164286
2018-09-20,142069,499,0,8300,19864,170732
2018-09-21,167866,455,288,21549,14342,204500
2018-09-22,200382,545,0,9315,30518,240760
2018-09-23,178452,747,0,5044,22368,206611
2018-09-24,174058,1234,0,9225,112784,297301
2018-09-25,106327,371,213,3918,18199,129028
2018-09-26,111446,607,231,5783,22605,140672
2018-09-27,125885,506,149,8040,18860,153440
2018-09-28,142495,415,163,13359,13778,170210
2018-09-29,174151,638,0,7548,29335,211672
2018-09-30,179537,460,357,9294,22941,212589
2018-10-01,114289,345,311,4024,12513,131482
2018-10-02,81166,460,0,3059,14131,98816
2018-10-03,97533,311,79,4751,15089,117763
2018-10-04,100918,436,283,7332,14948,123917
2018-10-05,129464,361,270,8376,9549,148020
2018-10-06,132829,354,207,9690,24827,167907
2018-10-07,148385,527,132,2718,21119,172881
2018-10-08,93319,412,274,1743,10742,106490
2018-10-09,87442,383,158,2684,11447,102114
2018-10-10,102332,240,551,4222,9402,116747
2018-10-11,92783,289,277,4349,12245,109943
2018-10-12,108638,596,162,8426,8785,126607
2018-10-13,125318,337,101,8848,21589,156193
2018-10-14,164742,319,349,2799,16720,184929
2018-10-15,90846,345,198,3336,8369,103094
2018-10-16,59793,394,0,6989,8693,75869
2018-10-17,82609,284,61,5156,8991,97101
2018-10-18,85115,280,11,7014,11101,103521
2018-10-19,108313,330,292,7453,7658,124046
2018-10-20,115968,436,0,9112,16937,142453
2018-10-21,128687,484,0,578,14344,144093
2018-10-22,91243,228,0,2939,6976,101386
2018-10-23,85182,383,0,4736,9083,99384
2018-10-24,78679,365,305,4646,8308,92303
2018-10-25,91300,216,128,7252,12035,110931
2018-10-26,110017,291,0,6249,7191,123748
2018-10-27,115130,454,0,5159,16903,137646
2018-10-28,131924,302,156,363,7642,140387
2018-10-29,83948,228,0,1238,4073,89487
2018-10-30,96260,257,0,4740,3880,105137
2018-10-31,111791,579,0,7410,4467,124247
2018-11-01,93593,439,0,3482,3304,100818
2018-11-02,88658,384,0,4855,3030,96927
2018-11-03,118261,476,0,3881,5772,128390
2018-11-04,182428,616,0,2339,5117,190500
2018-11-05,94756,431,0,600,2742,98529
2018-11-06,63417,169,0,3,2524,66113
2018-11-07,66601,192,184,1395,2725,71097
2018-11-08,71343,183,0,9,2335,73870
2018-11-09,87953,227,0,2476,2897,93553
2018-11-10,84428,269,0,3095,2492,90284
2018-11-11,98340,265,185,2295,2220,103305
2018-11-12,72336,238,0,36,2248,74858
2018-11-13,61923,172,0,2046,2085,66226
2018-11-14,66611,184,0,190,2102,69087
2018-11-15,71388,277,0,9,2149,73823
2018-11-16,90438,202,0,3452,2597,96689
2018-11-17,87553,311,0,6283,2054,96201
2018-11-18,101281,47,0,1162,2417,104907
2018-11-19,68871,178,0,2886,2155,74090
2018-11-20,56804,154,0,679,2048,59685
2018-11-21,58254,261,189,183,1991,60878
2018-11-22,70449,210,0,13,2171,72843
2018-11-23,83625,123,0,2430,2030,88208
2018-11-24,81031,231,0,2490,2162,85914
2018-11-25,92037,354,0,2972,2250,97613
2018-11-26,72666,225,0,51,1902,74844
2018-11-27,56739,95,0,40,1642,58516
2018-11-28,60121,185,0,63,1889,62258
2018-11-29,63716,215,0,0,1815,65746
2018-11-30,82279,292,0,2278,2120,86969
2018-12-01,78642,809,0,64,1697,81212
2018-12-02,90416,207,0,2204,1874,94701
2018-12-03,67360,173,0,18,1954,69505
2018-12-04,62201,233,0,57,1812,64303
2018-12-05,60730,226,0,133,1925,63014
2018-12-06,63311,292,0,0,1788,65391
2018-12-07,77202,287,0,2403,2082,81974
2018-12-08,90796,1152,0,0,1891,93839
2018-12-09,97230,313,0,261,2585,100389
2018-12-10,65339,351,0,4,2252,67946
2018-12-11,58274,347,0,0,1861,60482
2018-12-12,66787,284,0,117,1996,69184
2018-12-13,67215,239,0,0,1905,69359
2018-12-14,68622,446,0,2252,2402,73722
2018-12-15,83077,1334,0,1,1881,86293
2018-12-16,101040,1765,0,67,2127,104999
2018-12-17,69407,248,0,78,1792,71525
2018-12-18,67333,286,0,9,1469,69097
2018-12-19,79205,263,0,126,1825,81419
2018-12-20,104881,302,0,0,1720,106903
2018-12-21,141512,344,0,2552,1903,146311
2018-12-22,192667,1699,0,5,1537,195908
2018-12-23,155220,1715,0,48,1754,158737
2018-12-24,79066,497,0,134,1186,80883
2018-12-25,66636,249,0,0,546,67431
2018-12-26,105900,1301,0,82,1402,108685
2018-12-27,105451,455,0,2,1614,107522
2018-12-28,115795,1072,0,2689,1695,121251
2018-12-29,128044,1449,0,12,1626,131131
2018-12-30,130748,1319,0,131,2209,134407
2018-12-31,67847,491,0,45,1457,69840
2019-01-01,67493,84,0,48,2290,69915
2019-01-02,165823,734,0,482,2998,170037
2019-01-03,144828,669,0,34,2147,147678
2019-01-04,150684,506,0,2581,2570,156341
2019-01-05,246958,449,0,0,2270,249677
2019-01-06,150206,479,0,185,1940,152810
2019-01-07,99729,314,0,40,1919,102002
2019-01-08,94268,395,5,2,1488,96158
2019-01-09,79014,245,0,104,1647,81010
2019-01-10,68955,236,0,1,1489,70681
2019-01-11,78833,313,0,0,1622,80768
2019-01-12,95938,367,0,3,1375,97683
2019-01-13,83185,314,0,48,1513,85060
2019-01-14,66334,209,0,0,1378,67921
2019-01-15,61313,184,0,3,1286,62786
2019-01-16,60852,360,0,58,1499,62769
2019-01-17,63642,144,0,0,1476,65262
2019-01-18,81961,289,0,0,1883,84133
2019-01-19,72224,176,0,0,1157,73557
2019-01-20,77624,199,0,66,1447,79336
2019-01-21,60394,212,0,0,1457,62063
2019-01-22,70412,167,80,5035,9892,85586
2019-01-23,48854,133,0,63,1714,50764
2019-01-24,55938,40,0,9,1720,57707
2019-01-25,66347,166,0,63,1824,68400
2019-01-26,68984,144,0,8,1480,70616
2019-01-27,69890,187,0,109,1606,71792
2019-01-28,55707,160,0,42,1383,57292
2019-01-29,50781,140,0,35,1229,52185
2019-01-30,52936,171,0,41,1620,54768
2019-01-31,57184,179,0,8,1640,59011
2019-02-01,71646,214,0,46,1633,73539
2019-02-02,66650,159,0,3,1404,68216
2019-02-03,82590,195,0,57,1887,84729
2019-02-04,56588,171,0,50,1332,58141
2019-02-05,52273,229,0,36,1435,53973
2019-02-06,60934,174,0,105,1544,62757
2019-02-07,71421,215,0,1,1921,73558
2019-02-08,79602,229,0,0,1974,81805
2019-02-09,93869,189,0,16,1650,95724
2019-02-10,100630,254,0,723,2093,103700
2019-02-11,62264,204,0,81,1693,64242
2019-02-12,57028,167,0,6,1347,58548
2019-02-13,57498,134,0,62,1746,59440
2019-02-14,69055,209,0,48,1880,71192
2019-02-15,82144,202,0,134,1979,84459
2019-02-16,88887,220,0,57,1802,90966
2019-02-17,103475,241,0,67,2046,105829
2019-02-18,72743,242,0,94,1807,74886
2019-02-19,55709,225,0,60,1656,57650
2019-02-20,63829,194,0,76,2001,66100
2019-02-21,66806,196,0,48,2200,69250
2019-02-22,79053,191,0,144,1693,81081
2019-02-23,81008,165,0,3,2175,83351
2019-02-24,89415,237,0,98,2253,92003
2019-02-25,66449,190,0,50,1908,68597
2019-02-26,59710,171,0,2,1647,61530
2019-02-27,62656,223,0,92,2088,65059
2019-02-28,73905,220,0,2,2145,76272
2019-03-01,93121,221,0,195,2168,95705
2019-03-02,92199,270,0,11,1933,94413
2019-03-03,109580,268,0,81,2207,112136
2019-03-04,74389,231,0,1,1676,76297
2019-03-05,62040,257,0,4,2100,64401
2019-03-06,65471,176,0,123,1943,67713
2019-03-07,69110,211,0,4304,2264,75889
2019-03-08,88493,452,0,169,2687,91801
2019-03-09,88356,224,0,3404,2254,94238
2019-03-10,109180,274,0,104,2745,112303
2019-03-11,68751,173,123,20,2412,71479
2019-03-12,61489,195,0,39,2068,63791
2019-03-13,61091,158,0,87,2447,63783
2019-03-14,68665,141,0,60,2682,71548
2019-03-15,90497,227,151,188,2715,93778
2019-03-16,84518,258,0,2,2334,87112
2019-03-17,110617,391,142,73,2528,113751
2019-03-18,72805,188,4,0,2130,75127
2019-03-19,66190,171,0,36,2085,68482
2019-03-20,64361,173,179,145,2571,67429
2019-03-21,71899,197,0,9,2846,74951
2019-03-22,90418,221,0,167,2861,93667
2019-03-23,89406,272,0,6,2508,92192
2019-03-24,122573,296,137,1079,3105,127190
2019-03-25,70745,187,0,15,2468,73415
2019-03-26,61766,178,174,2147,2243,66508
2019-03-27,63795,221,0,316,2474,66806
2019-03-28,71533,169,0,105,2971,74778
2019-03-29,91368,353,366,3563,3181,98831
2019-03-30,89780,263,174,2531,2541,95289
2019-03-31,124451,349,0,2052,4440,131292
2019-04-01,78506,259,151,20,2564,81500
2019-04-02,64277,201,170,317,2968,67933
2019-04-03,71590,160,247,4073,3379,79449
2019-04-04,74133,135,168,2424,4580,81440
2019-04-05,94441,260,298,12,4349,99360
2019-04-06,94125,265,136,4558,6271,105355
2019-04-07,122647,207,138,2229,7158,132379
2019-04-08,77110,244,184,27,5406,82971
2019-04-09,66389,310,467,4632,5035,76833
2019-04-10,74574,189,0,1814,5388,81965
2019-04-11,82825,228,31,3822,6088,92994
2019-04-12,104140,345,481,2838,6443,114247
2019-04-13,139227,270,346,2718,10118,152679
2019-04-14,129930,315,36,239,8661,139181
2019-04-15,86952,260,123,2757,6302,96394
2019-04-16,86659,213,0,3199,6166,96237
2019-04-17,101110,276,0,170,6603,108159
2019-04-18,134855,282,147,1684,7576,144544
2019-04-19,182590,369,310,5203,6406,194878
2019-04-20,138967,390,0,5436,13963,158756
2019-04-21,143737,397,309,3887,12695,161025
2019-04-22,268978,481,614,5264,9990,285327
2019-04-23,138545,370,130,519,9886,149450
2019-04-24,100178,277,285,1083,8477,110300
2019-04-25,111452,513,167,7788,9321,129241
2019-04-26,151205,430,280,5055,7463,164433
2019-04-27,177895,363,432,6400,16154,201244
2019-04-28,163326,400,0,6701,14243,184670
2019-04-29,121660,532,283,3989,9302,135766
2019-04-30,141100,292,0,4796,9491,155679
2019-05-01,146214,364,172,3803,9137,159690
2019-05-02,139684,258,160,7917,10486,158505
2019-05-03,202258,385,286,7864,7431,218224
2019-05-04,228820,416,465,3056,18652,251409
2019-05-05,213267,538,20,4010,16318,234153
2019-05-06,98965,290,185,3254,9583,112277
2019-05-07,85864,249,140,1691,10933,98877
2019-05-08,84921,366,551,4080,10082,100000
2019-05-09,88837,373,479,5254,12512,107455
2019-05-10,101685,224,178,8828,8444,119359
2019-05-11,114845,386,309,6483,19719,141742
2019-05-12,127132,392,206,5044,17007,149781
2019-05-13,89392,340,0,232,9191,99155
2019-05-14,73415,244,266,6233,11401,91559
2019-05-15,78446,292,321,2740,9453,91252
2019-05-16,81252,227,344,10455,11077,103355
2019-05-17,111481,591,655,8442,7683,128852
2019-05-18,114671,301,449,4311,21023,140755
2019-05-19,132141,710,294,9142,17278,159565
2019-05-20,90226,265,315,6427,9940,107173
2019-05-21,81372,286,156,5605,11979,99398
2019-05-22,86061,266,137,6983,10512,103959
2019-05-23,86040,390,131,12938,13141,112640
2019-05-24,109933,306,860,6236,8921,126256
2019-05-25,121707,324,370,7728,22775,152904
2019-05-26,149534,343,184,6997,17982,175040
2019-05-27,97970,425,457,2350,12111,113313
2019-05-28,86585,194,236,4166,14564,105745
2019-05-29,93750,271,163,1537,12236,107957
2019-05-30,116536,275,437,8414,15002,140664
2019-05-31,118417,272,909,6526,11384,137508
2019-06-01,152946,540,480,5157,28197,187320
2019-06-02,233831,454,516,5706,22245,262752
2019-06-03,131865,251,653,2871,13878,149518
2019-06-04,96570,281,0,1848,15069,113768
2019-06-05,110203,281,251,503,13288,124526
2019-06-06,118516,287,292,10328,14557,143980
2019-06-07,144197,406,183,13996,12417,171199
2019-06-08,166098,278,140,5927,28350,200793
2019-06-09,210316,926,225,5843,21661,238971
2019-06-10,216344,539,318,5413,14787,237401
2019-06-11,126210,314,0,7526,17100,151150
2019-06-12,118289,281,153,3127,16598,138448
2019-06-13,127632,510,301,11916,17334,157693
2019-06-14,155948,369,192,8434,14639,179582
2019-06-15,208163,591,114,5926,30907,245701
2019-06-16,249557,469,256,8543,23269,282094
2019-06-17,154322,557,251,3613,15170,173913
2019-06-18,129632,373,147,1228,17072,148452
2019-06-19,151341,409,335,2370,16458,170913
2019-06-20,188404,481,162,7104,18121,214272
2019-06-21,215286,713,398,11632,14311,242340
2019-06-22,267603,668,309,9803,32337,310720
2019-06-23,317717,715,74,5069,24869,348444
2019-06-24,186617,506,487,2826,17582,208018
2019-06-25,188797,753,240,6729,19137,215656
2019-06-26,163306,615,380,7229,17854,189384
2019-06-27,161529,714,564,10308,21203,194318
2019-06-28,204853,576,180,12643,17675,235927
2019-06-29,271747,855,322,11678,34687,319289
2019-06-30,314432,846,0,10072,27696,353046
2019-07-01,193791,624,493,7306,19072,221286
2019-07-02,155514,579,113,8052,20196,184454
2019-07-03,168028,561,160,1257,19988,189994
2019-07-04,188704,711,293,9054,21322,220084
2019-07-05,222844,644,184,13478,18553,255703
2019-07-06,313687,702,321,9872,35501,360083
2019-07-07,322615,734,0,4792,27839,355980
2019-07-08,219850,872,722,4058,21098,246600
2019-07-09,174969,625,426,8761,21687,206468
2019-07-10,192588,540,111,2478,22863,218580
2019-07-11,179696,966,562,10849,24080,216153
2019-07-12,270876,974,404,11420,20583,304257
2019-07-13,351865,824,298,5948,37017,395952
2019-07-14,356881,1339,0,8382,29058,395660
2019-07-15,236921,1544,180,4488,23336,266469
2019-07-16,187072,771,370,3569,25077,216859
2019-07-17,197434,1000,0,4129,25504,228067
2019-07-18,229580,1263,183,5869,27593,264488
2019-07-19,284260,1336,610,11063,22013,319282
2019-07-20,381988,1081,370,12424,38102,433965
2019-07-21,387525,971,90,7155,29823,425564
2019-07-22,265745,1308,175,1990,23175,292393
2019-07-23,202900,825,0,7384,24060,235169
2019-07-24,222435,815,138,7102,25914,256404
2019-07-25,251217,915,161,11440,26698,290431
2019-07-26,342915,1180,629,8072,22020,374816
2019-07-27,402089,917,261,6273,36412,445952
2019-07-28,419412,1664,124,8391,31118,460709
2019-07-29,253199,908,142,9576,25443,289268
2019-07-30,221795,1067,0,4827,27160,254849
2019-07-31,237862,1055,103,4993,27737,271750
2019-08-01,266702,906,70,9127,28155,304960
2019-08-02,357375,956,304,15202,22839,396676
2019-08-03,406815,1145,0,5781,39995,453736
2019-08-04,369254,1668,0,13672,30926,415520
2019-08-05,286918,1124,451,4280,23251,316024
2019-08-06,173600,1055,0,7138,26049,207842
2019-08-07,249593,2454,144,4444,25876,282511
2019-08-08,280345,1012,165,16240,28687,326449
2019-08-09,335092,1162,677,10049,22397,369377
2019-08-10,450580,1415,0,13118,40261,505374
2019-08-11,397022,1194,217,12073,29670,440176
2019-08-12,286868,1522,333,5687,22646,317056
2019-08-13,235904,1307,277,5882,26195,269565
2019-08-14,274195,969,514,4467,26216,306361
2019-08-15,303365,903,157,11130,27301,342856
2019-08-16,360450,1427,184,12534,21173,395768
2019-08-17,444804,1298,250,17832,40535,504719
2019-08-18,527753,1183,0,9499,29912,568347
2019-08-19,292060,1010,295,6008,22463,321836
2019-08-20,226253,1071,122,6537,22189,256172
2019-08-21,248859,917,379,4504,24880,279539
2019-08-22,280525,692,317,13485,26139,321158
2019-08-23,341847,855,466,8435,21310,372913
2019-08-24,364194,1602,563,12718,24571,403648
2019-08-25,420973,1379,161,14247,30189,466949
2019-08-26,255759,732,477,6970,22904,286842
2019-08-27,218395,663,85,5639,25764,250546
2019-08-28,219877,863,156,4554,24939,250389
2019-08-29,239024,572,568,11569,25893,277626
2019-08-30,317648,825,179,8930,21306,348888
2019-08-31,362389,848,48,9166,39072,411523
2019-09-01,319819,1393,134,7824,28309,357479
2019-09-02,191904,587,273,3429,16545,212738
2019-09-03,165159,426,494,7319,19756,193154
2019-09-04,162870,790,311,4636,19246,187853
2019-09-05,178463,586,339,9669,20692,209749
2019-09-06,247379,575,787,9921,16262,274924
2019-09-07,247934,1027,205,7033,34647,290846
2019-09-08,252394,857,447,9733,26280,289711
2019-09-09,150625,470,533,2747,16221,170596
2019-09-10,128322,472,155,5849,18685,153483
2019-09-11,127460,514,272,6847,19047,154140
2019-09-12,135055,461,480,8885,22013,166894
2019-09-13,168170,528,411,12106,16236,197451
2019-09-14,199772,736,583,11557,34952,247600
2019-09-15,263672,517,297,5601,27147,297234
2019-09-16,156882,1050,183,1166,15546,174827
2019-09-17,133678,649,268,4186,18869,157650
2019-09-18,127751,364,261,1417,18751,148544
2019-09-19,135494,1045,369,7332,21207,165447
2019-09-20,169261,393,336,6853,15755,192598
2019-09-21,196693,524,461,7563,35192,240433
2019-09-22,232603,469,238,8779,25579,267668
2019-09-23,115587,416,184,1782,15185,133154
2019-09-24,100491,325,257,7391,18380,126844
2019-09-25,109306,369,281,7117,17619,134692
2019-09-26,118065,360,504,11784,20771,151484
2019-09-27,123966,385,301,5633,12490,142775
2019-09-28,157343,560,405,7915,32561,198784
2019-09-29,189045,501,162,8176,25257,223141
2019-09-30,116065,353,338,3898,14100,134754
2019-10-01,94987,253,174,4451,15778,115643
2019-10-02,90853,430,79,344,14872,106578
2019-10-03,107303,352,341,7751,17167,132914
2019-10-04,124442,407,761,11438,11671,148719
2019-10-05,146029,681,334,9230,28959,185233
2019-10-06,174790,416,307,7186,22506,205205
2019-10-07,103886,391,194,2667,12752,119890
2019-10-08,94276,423,440,6178,14497,115814
2019-10-09,82314,293,124,4150,11728,98609
2019-10-10,99573,333,329,7230,14809,122274
2019-10-11,123282,414,600,7220,10374,141890
2019-10-12,125867,501,108,13773,24682,164931
2019-10-13,165108,567,390,10473,19442,195980
2019-10-14,98044,321,475,3483,10789,113112
2019-10-15,82029,359,0,4505,12064,98957
2019-10-16,86450,421,170,1155,10911,99107
2019-10-17,94480,316,320,6301,13769,115186
2019-10-18,111336,551,335,6760,9162,128144
2019-10-19,118627,544,160,9646,22087,151064
2019-10-20,149364,489,0,9519,17063,176435
2019-10-21,92237,286,204,6911,10068,109706
2019-10-22,79690,372,95,454,11894,92505
2019-10-23,80019,498,0,5680,10354,96551
2019-10-24,93551,290,290,4702,14109,112942
2019-10-25,123215,448,176,8107,14286,146232
2019-10-26,131710,427,0,6055,20036,158228
2019-10-27,149657,540,98,9748,9321,169364
2019-10-28,98464,357,489,5449,4634,109393
2019-10-29,89299,240,0,2653,4934,97126
2019-10-30,106224,283,132,6274,4904,117817
2019-10-31,130146,439,152,2489,5058,138284
2019-11-01,111994,315,170,805,3590,116874
2019-11-02,122110,647,0,2788,7026,132571
2019-11-03,186949,435,0,4872,6483,198739
2019-11-04,101655,360,176,6991,3111,112293
2019-11-05,73727,349,149,4674,3314,82213
2019-11-06,70340,469,0,999,3006,74814
2019-11-07,71639,236,143,4190,3100,79308
2019-11-08,87427,379,181,1906,2932,92825
2019-11-09,86353,225,0,3745,2595,92918
2019-11-10,106866,511,0,2106,2887,112370
2019-11-11,72431,432,172,2262,2633,77930
2019-11-12,61343,213,0,4523,2519,68598
2019-11-13,67326,249,2,32,2338,69947
2019-11-14,72286,315,0,2074,2551,77226
2019-11-15,89083,295,142,1955,2615,94090
2019-11-16,83368,362,0,2668,2476,88874
2019-11-17,101193,324,0,299,2757,104573
2019-11-18,73013,197,186,45,2486,75927
2019-11-19,59203,152,0,702,2344,62401
2019-11-20,67323,214,0,1953,2241,71731
2019-11-21,77330,289,0,1988,3378,82985
2019-11-22,89689,211,0,1935,2943,94778
2019-11-23,93098,255,0,2501,2155,98009
2019-11-24,101984,294,0,243,2549,105070
2019-11-25,82987,214,0,674,2243,86118
2019-11-26,64168,208,0,1,2135,66512
2019-11-27,62911,170,0,64,2064,65209
2019-11-28,71020,206,0,4,2515,73745
2019-11-29,94545,186,0,9,2618,97358
2019-11-30,81827,584,0,2893,1917,87221
2019-12-01,102158,322,0,132,2584,105196
2019-12-02,66515,221,0,2,2127,68865
2019-12-03,62275,234,0,62,2171,64742
2019-12-04,62992,195,0,172,1860,65219
2019-12-05,66942,198,0,896,2282,70318
2019-12-06,82386,295,0,0,2356,85037
2019-12-07,86187,979,0,60,2308,89534
2019-12-08,102250,454,0,513,2939,106156
2019-12-09,67922,290,0,10,2549,70771
2019-12-10,58091,463,0,2,1888,60444
2019-12-11,69668,262,0,170,1994,72094
2019-12-12,68657,213,0,2,2661,71533
2019-12-13,80013,310,0,0,2324,82647
2019-12-14,97924,2929,0,2,2032,102887
2019-12-15,112153,712,0,136,2605,115606
2019-12-16,75866,271,0,12,2037,78186
2019-12-17,74622,364,0,2108,1836,78930
2019-12-18,85106,516,0,103,1868,87593
2019-12-19,112709,309,0,3,1864,114885
2019-12-20,148132,309,0,2,1836,150279
2019-12-21,210583,1327,0,2629,1684,216223
2019-12-22,163782,528,0,109,1895,166314
2019-12-23,121613,399,0,46,1268,123326
2019-12-24,99793,228,0,4,1125,101150
2019-12-25,78039,510,0,3,685,79237
2019-12-26,101550,1883,0,2295,1626,107354
2019-12-27,118072,1643,0,18,1653,121386
2019-12-28,134789,1400,0,2737,1567,140493
2019-12-29,128530,1164,0,92,2065,131851
2019-12-30,118776,1401,0,69,1885,122131
2019-12-31,71730,330,0,96,1698,73854
2020-01-01,86446,40,0,26,1894,88406
2020-01-02,138233,1970,0,531,2854,143588
2020-01-03,179087,702,140,22,2677,182628
2020-01-04,189642,707,0,2697,2311,195357
2020-01-05,215582,560,0,245,2221,218608
2020-01-06,119859,382,0,20,1729,121990
2020-01-07,86114,294,0,0,1610,88018
2020-01-08,97122,278,0,131,1600,99131
2020-01-09,77269,287,0,0,1656,79212
2020-01-10,85278,261,0,1,1762,87302
2020-01-11,102015,290,0,0,1314,103619
2020-01-12,124548,297,0,82,1624,126551
2020-01-13,69176,183,0,16,1433,70808
2020-01-14,61880,192,0,5,1155,63232
2020-01-15,64104,160,0,57,1524,65845
2020-01-16,69277,166,0,19,1386,70848
2020-01-17,77923,226,0,16,1560,79725
2020-01-18,79493,207,0,16,1068,80784
2020-01-19,80528,214,0,31,1727,82500
2020-01-20,67388,171,0,13,1365,68937
2020-01-21,59160,166,0,12,1068,60406
2020-01-22,61446,191,0,58,1496,63191
2020-01-23,62486,167,0,0,1403,64056
2020-01-24,75687,206,0,27,1976,77896
2020-01-25,73027,176,0,8,1367,74578
2020-01-26,77716,247,0,54,1540,79557
2020-01-27,59818,277,5,0,1223,61323
2020-01-28,54238,166,0,127,1068,55599
2020-01-29,57279,127,0,62,1307,58775
2020-01-30,61044,188,0,2,1602,62836
2020-01-31,78882,223,0,3,141,79249
2020-02-01,77282,174,0,460,1322,79238
2020-02-02,83851,181,0,94,1700,85826
2020-02-03,62435,254,0,9,1043,63741
2020-02-04,53772,220,0,14,1281,55287
2020-02-05,58134,136,0,97,1387,59754
2020-02-06,60386,174,0,47,1604,62211
2020-02-07,76704,214,0,21,160,77099
2020-02-08,82169,228,0,57,1220,83674
2020-02-09,101420,254,0,67,1435,103176
2020-02-10,64384,263,0,0,1580,66227
2020-02-11,58086,212,0,10,1711,60019
2020-02-12,63348,184,0,118,1661,65311
2020-02-13,67361,209,0,0,1878,69448
2020-02-14,90658,211,0,7,1955,92831
2020-02-15,87837,299,0,18,1801,89955
2020-02-16,106031,274,0,130,2019,108454
2020-02-17,78561,298,0,0,1753,80612
2020-02-18,64757,187,12,48,1569,66573
2020-02-19,65036,214,0,71,1730,67051
2020-02-20,66604,162,0,34,1960,68760
2020-02-21,90364,253,0,2,2484,93103
2020-02-22,90104,234,0,5,1983,92326
2020-02-23,99024,295,0,54,2393,101766
2020-02-24,74861,274,0,58,1974,77167
2020-02-25,61346,145,0,6,1841,63338
2020-02-26,55772,158,0,85,1942,57957
2020-02-27,65243,128,0,86,2118,67575
2020-02-28,82930,306,0,3,2113,85352
2020-02-29,72873,164,0,11,1926,74974
2020-03-01,87611,280,0,95,2421,90407
2020-03-02,64843,150,0,22,1701,66716
2020-03-03,49295,39,0,0,1590,50924
2020-03-04,53679,162,0,85,1714,55640
2020-03-05,57067,134,0,0,2046,59247
2020-03-06,75244,150,0,2,2018,77414
2020-03-07,65195,179,0,0,1402,66776
2020-03-08,87897,171,0,71,2082,90221
2020-03-09,62032,130,130,60,1566,63918
2020-03-10,51499,106,0,1,1364,52970
2020-03-11,52289,199,0,2,1299,53789
2020-03-12,50316,110,0,77,1610,52113
2020-03-13,49547,111,0,0,1644,51302
2020-03-14,31765,173,0,0,1627,33565
2020-03-15,29176,48,0,6,1800,31030
2020-03-16,16098,2,0,70,1202,17372
2020-03-17,14155,0,0,0,691,14846
2020-03-18,13528,0,0,0,626,14154
2020-03-19,9849,0,0,0,438,10287
2020-03-20,9003,0,0,28,346,9377
2020-03-21,5350,0,0,13,326,5689
2020-03-22,4241,0,0,1,372,4614
2020-03-23,7282,0,0,0,224,7506
2020-03-24,6608,0,0,22,225,6855
2020-03-25,5972,0,0,13,153,6138
2020-03-26,6776,0,0,0,102,6878
2020-03-27,6749,0,0,0,334,7083
2020-03-28,4268,0,0,16,227,4511
2020-03-29,2731,0,0,20,33,2784
2020-03-30,6731,0,0,8,56,6795
2020-03-31,6562,0,0,0,35,6597
2020-04-01,6964,0,0,0,32,6996
2020-04-02,6524,0,0,6,9,6539
2020-04-03,6810,0,0,0,58,6868
2020-04-04,4180,0,0,0,42,4222
2020-04-05,2604,0,0,8,10,2622
2020-04-06,6533,0,0,0,46,6579
2020-04-07,6026,0,0,0,21,6047
2020-04-08,6620,0,0,0,7,6627
2020-04-09,6545,0,0,25,19,6589
2020-04-10,5639,0,0,45,17,5701
2020-04-11,2655,0,0,0,12,2667
2020-04-12,1374,0,0,0,13,1387
2020-04-13,3471,0,0,76,6,3553
2020-04-14,6426,0,0,0,1,6427
2020-04-15,6789,0,0,0,11,6800
2020-04-16,6421,0,0,0,12,6433
2020-04-17,6465,0,0,29,10,6504
2020-04-18,3555,0,0,0,11,3566
2020-04-19,2547,0,0,0,13,2560
2020-04-20,5885,0,0,0,17,5902
2020-04-21,7346,0,0,30,33,7409
2020-04-22,6862,0,0,0,9,6871
2020-04-23,7253,0,0,0,12,7265
2020-04-24,7162,0,0,0,9,7171
2020-04-25,4394,0,0,18,13,4425
2020-04-26,3474,0,0,2,12,3488
2020-04-27,6917,0,0,0,14,6931
2020-04-28,7275,0,0,2,71,7348
2020-04-29,8637,0,0,50,13,8700
2020-04-30,7766,0,0,0,16,7782
2020-05-01,3599,0,0,0,64,3663
2020-05-02,3335,0,0,0,13,3348
2020-05-03,5135,0,0,20,9,5164
2020-05-04,9689,0,0,0,22,9711
2020-05-05,8138,0,0,0,19,8157
2020-05-06,8536,0,0,66,19,8621
2020-05-07,8590,0,0,65,30,8685
2020-05-08,9070,0,0,43,32,9145
2020-05-09,5796,0,0,8,19,5823
2020-05-10,4892,0,0,20,20,4932
2020-05-11,9442,0,0,0,33,9475
2020-05-12,10157,0,0,0,31,10188
2020-05-13,11058,0,0,4,15,11077
2020-05-14,10993,0,0,40,23,11056
2020-05-15,13390,0,0,4,26,13420
2020-05-16,10702,0,0,0,22,10724
2020-05-17,15522,0,0,3,30,15555
2020-05-18,17455,0,0,15,30,17500
2020-05-19,14814,0,0,3,21,14838
2020-05-20,17875,0,0,42,321,18238
2020-05-21,28320,0,0,3,204,28527
2020-05-22,36386,0,0,2,192,36580
2020-05-23,24216,0,0,6,218,24440
2020-05-24,36579,0,0,4,95,36678
2020-05-25,33059,0,0,27,95,33181
2020-05-26,25344,0,0,0,272,25616
2020-05-27,24688,0,0,16,279,24983
2020-05-28,28369,0,0,12,235,28616
2020-05-29,38004,0,0,23,131,38158
2020-05-30,37831,0,0,35,97,37963
2020-05-31,52036,0,0,11,104,52151
2020-06-01,47284,0,0,3,180,47467
2020-06-02,33923,0,0,5,171,34099
2020-06-03,37627,0,0,9,133,37769
2020-06-04,41427,0,0,0,136,41563
2020-06-05,48731,0,0,7,159,48897
2020-06-06,48450,0,0,24,177,48651
2020-06-07,73196,0,0,46,305,73547
2020-06-08,43055,0,0,58,167,43280
2020-06-09,35653,0,0,35,165,35853
2020-06-10,46673,0,0,28,167,46868
2020-06-11,50103,0,0,18,198,50319
2020-06-12,56223,0,0,41,187,56451
2020-06-13,63865,2,0,38,427,64332
2020-06-14,93883,0,0,51,496,94430
2020-06-15,53831,0,0,25,424,54280
2020-06-16,44385,0,0,10,269,44664
2020-06-17,50197,0,0,68,242,50507
2020-06-18,58250,1,0,19,300,58570
2020-06-19,62590,0,0,48,281,62919
2020-06-20,77058,0,0,72,710,77840
2020-06-21,74990,0,0,55,693,75738
2020-06-22,62265,13,0,47,515,62840
2020-06-23,52760,13,0,165,341,53279
2020-06-24,51457,57,0,26,647,52187
2020-06-25,58358,36,0,81,553,59028
2020-06-26,78007,39,0,119,648,78813
2020-06-27,91623,22,0,129,1753,93527
2020-06-28,160583,71,0,386,1335,162375
2020-06-29,96285,178,0,193,880,97536
2020-06-30,72332,74,0,174,740,73320
2020-07-01,56258,206,0,47,1015,57526
2020-07-02,66472,100,0,172,839,67583
2020-07-03,92803,89,0,99,1186,94177
2020-07-04,87000,723,0,117,2404,90244
2020-07-05,116936,301,0,306,2393,119936
2020-07-06,73183,380,0,214,1389,75166
2020-07-07,63016,63,0,167,1345,64591
2020-07-08,71452,462,0,64,1389,73367
2020-07-09,73452,210,0,176,1616,75454
2020-07-10,90923,99,0,247,2286,93555
2020-07-11,110406,660,0,312,5077,116455
2020-07-12,143439,373,0,374,4984,149170
2020-07-13,88878,710,0,221,2499,92308
2020-07-14,67005,570,0,298,2288,70161
2020-07-15,81721,535,0,153,2640,85049
2020-07-16,78234,267,90,346,3158,82095
2020-07-17,103664,169,0,87,3726,107646
2020-07-18,119257,721,0,318,7123,127419
2020-07-19,149839,126,0,756,6703,157424
2020-07-20,109010,624,0,352,3604,113590
2020-07-21,76851,939,0,301,3126,81217
2020-07-22,81415,616,0,171,3609,85811
2020-07-23,105039,480,77,348,3885,109829
2020-07-24,123264,432,96,211,4698,128701
2020-07-25,148265,651,86,542,9228,158772
2020-07-26,150074,866,0,634,7872,159446
2020-07-27,113795,471,0,366,4561,119193
2020-07-28,94912,529,0,426,4203,100070
2020-07-29,102715,506,0,250,4309,107780
2020-07-30,117846,368,0,538,4870,123622
2020-07-31,153604,698,120,337,5776,160535
2020-08-01,178346,633,0,699,12241,191919
2020-08-02,174737,594,0,921,9220,185472
2020-08-03,110208,559,1,271,4665,115704
2020-08-04,107042,679,0,260,4878,112859
2020-08-05,95228,535,0,108,4920,100791
2020-08-06,111364,621,0,398,5866,118249
2020-08-07,119214,676,133,402,6354,126779
2020-08-08,198479,743,0,901,13854,213977
2020-08-09,209336,853,0,705,11227,222121
2020-08-10,151686,79,0,506,5649,157920
2020-08-11,105673,119,0,476,6547,112815
2020-08-12,122635,719,0,337,6574,130265
2020-08-13,137144,468,0,1314,6920,145846
2020-08-14,183245,692,113,511,7535,192096
2020-08-15,212731,812,0,1291,15318,230152
2020-08-16,191586,862,0,1334,12704,206486
2020-08-17,131560,681,0,582,5946,138769
2020-08-18,99072,602,0,662,7047,107383
2020-08-19,121676,602,0,330,7626,130234
2020-08-20,117851,741,0,1123,7909,127624
2020-08-21,144674,659,116,701,8905,155055
2020-08-22,156422,589,0,1552,14460,173023
2020-08-23,133151,639,0,590,11769,146149
2020-08-24,100005,710,0,266,5684,106665
2020-08-25,87986,550,0,448,7144,96128
2020-08-26,73276,550,1,143,6851,80821
2020-08-27,97906,557,0,515,6744,105722
2020-08-28,142302,646,118,391,6177,149634
2020-08-29,115352,687,0,328,12607,128974
2020-08-30,118291,503,67,370,9691,128922
2020-08-31,80010,510,0,89,3943,84552
2020-09-01,51229,396,0,218,3670,55513
2020-09-02,58542,314,0,69,2507,61432
2020-09-03,59813,72,116,213,3256,63470
2020-09-04,64062,83,94,139,2549,66927
2020-09-05,65095,352,0,110,7447,73004
2020-09-06,78082,263,0,193,5204,83742
2020-09-07,49000,111,0,88,2349,51548
2020-09-08,40488,64,0,155,2121,42828
2020-09-09,45653,390,0,64,1839,47946
2020-09-10,53621,46,73,195,2358,56293
2020-09-11,59291,48,111,102,2088,61640
2020-09-12,59411,513,83,50,6644,66701
2020-09-13,69237,121,0,170,4394,73922
2020-09-14,43815,580,0,151,1687,46233
2020-09-15,45468,59,0,27,2098,47652
2020-09-16,43647,371,0,201,1505,45724
2020-09-17,48297,37,225,65,1683,50307
2020-09-18,54604,56,73,28,1603,56364
2020-09-19,55025,486,163,31,6276,61981
2020-09-20,72082,161,0,151,4092,76486
2020-09-21,48610,270,0,129,1418,50427
2020-09-22,44858,34,0,41,1333,46266
2020-09-23,41300,174,0,118,1544,43136
2020-09-24,40660,47,0,26,1311,42044
2020-09-25,51497,53,0,26,1523,53099
2020-09-26,53461,264,48,113,5258,59144
2020-09-27,52750,106,0,76,2930,55862
2020-09-28,32899,70,0,66,1316,34351
2020-09-29,39175,75,0,81,977,40308
2020-09-30,45783,52,0,95,1070,47000
2020-10-01,45593,51,0,18,890,46552
2020-10-02,58724,58,0,34,940,59756
2020-10-03,60489,82,0,0,3312,63883
2020-10-04,54522,218,0,91,1903,56734
2020-10-05,42641,37,0,102,1058,43838
2020-10-06,36657,59,62,27,494,37299
2020-10-07,40047,54,0,71,778,40950
2020-10-08,44350,25,0,49,604,45028
2020-10-09,59322,46,0,46,761,60175
2020-10-10,61874,59,0,59,2168,64160
2020-10-11,64270,45,0,119,1433,65867
2020-10-12,44092,35,0,78,871,45076
2020-10-13,38300,28,0,14,532,38874
2020-10-14,38135,48,0,155,693,39031
2020-10-15,44831,45,0,2,642,45520
2020-10-16,57881,40,0,5,767,58693
2020-10-17,51851,40,0,21,2052,53964
2020-10-18,53724,27,0,61,1174,54986
2020-10-19,48295,35,0,95,755,49180
2020-10-20,36675,19,0,33,532,37259
2020-10-21,35564,22,0,59,640,36285
2020-10-22,39007,38,0,72,547,39664
2020-10-23,53536,25,0,19,965,54545
2020-10-24,46037,27,0,14,2338,48416
2020-10-25,41486,29,0,48,677,42240
2020-10-26,38653,34,0,49,412,39148
2020-10-27,29892,35,0,25,328,30280
2020-10-28,31339,27,0,55,416,31837
2020-10-29,33478,31,0,12,286,33807
2020-10-30,43106,32,0,27,765,43930
2020-10-31,44170,22,0,28,958,45178
2020-11-01,43115,31,0,56,708,43910
2020-11-02,36464,29,0,7,449,36949
2020-11-03,27554,20,0,78,180,27832
2020-11-04,31035,18,0,58,480,31591
2020-11-05,32153,23,0,0,237,32413
2020-11-06,38601,35,0,2,532,39170
2020-11-07,30433,16,0,14,439,30902
2020-11-08,43016,18,0,27,475,43536
2020-11-09,31017,23,0,11,342,31393
2020-11-10,27614,16,0,0,184,27814
2020-11-11,28927,46,0,51,547,29571
2020-11-12,32732,26,0,6,179,32943
2020-11-13,42319,21,0,2,387,42729
2020-11-14,32451,25,0,6,333,32815
2020-11-15,36126,21,5,38,484,36674
2020-11-16,25557,26,0,30,333,25946
2020-11-17,25462,17,0,1,200,25680
2020-11-18,21708,34,0,68,385,22195
2020-11-19,26636,27,0,25,232,26920
2020-11-20,29930,52,0,0,401,30383
2020-11-21,23176,38,0,2,228,23444
2020-11-22,23882,29,0,28,388,24327
2020-11-23,24114,33,0,16,363,24526
2020-11-24,25661,31,8,10,162,25872
2020-11-25,25169,18,0,23,476,25686
2020-11-26,25554,25,0,7,192,25778
2020-11-27,32070,11,0,2,412,32495
2020-11-28,23927,9,0,6,251,24193
2020-11-29,23681,17,0,24,440,24162
2020-11-30,27510,33,0,24,361,27928
2020-12-01,23556,10,0,0,149,23715
2020-12-02,22799,23,0,24,357,23203
2020-12-03,23399,32,0,0,152,23583
2020-12-04,27790,20,0,2,428,28240
2020-12-05,22612,14,0,0,175,22801
2020-12-06,19207,18,0,22,343,19590
2020-12-07,21752,26,0,1,310,22089
2020-12-08,20384,13,0,12,119,20528
2020-12-09,23559,19,0,48,309,23935
2020-12-10,25159,21,0,5,239,25424
2020-12-11,30451,35,0,0,522,31008
2020-12-12,25073,19,0,3,338,25433
2020-12-13,22654,13,0,32,330,23029
2020-12-14,22733,16,0,4,302,23055
2020-12-15,24486,36,0,2,170,24694
2020-12-16,32176,25,0,31,370,32602
2020-12-17,37379,21,0,34,195,37629
2020-12-18,56836,17,0,6,451,57310
2020-12-19,74434,26,0,4,329,74793
2020-12-20,59708,12,0,16,600,60336
2020-12-21,33094,26,0,38,341,33499
2020-12-22,39420,11,0,3,154,39588
2020-12-23,53310,6,15,33,409,53773
2020-12-24,59137,8,0,16,85,59246
2020-12-25,27408,7,0,0,107,27522
2020-12-26,16844,18,0,0,98,16960
2020-12-27,18380,3,0,66,370,18819
2020-12-28,19945,14,0,46,158,20163
2020-12-29,23219,25,8,3,81,23336
2020-12-30,29420,17,0,0,235,29672
2020-12-31,24951,10,0,16,63,25040
2021-01-01,18356,6,0,0,92,18454
2021-01-02,26445,21,0,0,280,26746
2021-01-03,35584,42,0,31,485,36142
2021-01-04,33177,34,0,0,286,33497
2021-01-05,28457,22,8,16,200,28703
2021-01-06,25573,19,0,38,304,25934
2021-01-07,30215,29,0,0,214,30458
2021-01-08,34154,23,0,15,304,34496
2021-01-09,38241,25,0,0,182,38448
2021-01-10,37085,34,0,16,445,37580
2021-01-11,31306,6,0,21,256,31589
2021-01-12,22874,22,0,43,114,23053
2021-01-13,23083,13,0,62,273,23431
2021-01-14,24210,1,0,46,126,24383
2021-01-15,27545,11,0,40,250,27846
2021-01-16,23094,14,0,85,126,23319
2021-01-17,23872,7,0,65,253,24197
2021-01-18,21527,3,0,90,219,21839
2021-01-19,23066,7,0,0,69,23142
2021-01-20,22444,4,0,16,209,22673
2021-01-21,26723,10,0,0,109,26842
2021-01-22,33239,1,0,9,211,33460
2021-01-23,25913,18,0,0,123,26054
2021-01-24,25797,8,0,44,215,26064
2021-01-25,23565,8,0,0,157,23730
2021-01-26,23433,7,0,2,105,23547
2021-01-27,24419,8,0,32,204,24663
2021-01-28,28723,9,0,0,134,28866
2021-01-29,32362,8,0,1,391,32762
2021-01-30,28197,11,0,0,140,28348
2021-01-31,25666,9,0,28,221,25924
2021-02-01,22608,18,0,0,193,22819
2021-02-02,25046,14,0,7,49,25116
2021-02-03,24836,4,0,25,234,25099
2021-02-04,28712,3,0,2,99,28816
2021-02-05,37072,3,0,11,215,37301
2021-02-06,31529,8,0,7,83,31627
2021-02-07,26562,12,0,29,226,26829
2021-02-08,25955,14,0,8,209,26186
2021-02-09,26323,4,0,0,90,26417
2021-02-10,26609,9,0,20,135,26773
2021-02-11,29736,6,0,2,168,29912
2021-02-12,40172,8,0,0,296,40476
2021-02-13,33894,2,0,0,133,34029
2021-02-14,29309,9,0,17,261,29596
2021-02-15,26515,8,0,0,142,26665
2021-02-16,26255,22,0,1,85,26363
2021-02-17,27098,4,0,32,263,27397
2021-02-18,29910,14,0,13,135,30072
2021-02-19,39707,7,0,10,301,40025
2021-02-20,35153,3,0,0,175,35331
2021-02-21,35429,6,0,24,277,35736
2021-02-22,29165,7,0,0,210,29382
2021-02-23,27216,7,0,0,152,27375
2021-02-24,29667,24,0,16,228,29935
2021-02-25,30774,6,0,0,177,30957
2021-02-26,42606,8,0,0,383,42997
2021-02-27,35673,13,0,2,151,35839
2021-02-28,37525,23,0,34,310,37892
2021-03-01,27841,3,0,25,210,28079
2021-03-02,28916,9,0,0,111,29036
2021-03-03,28941,9,0,33,294,29277
2021-03-04,34951,25,0,0,196,35172
2021-03-05,36104,9,0,1,288,36402
2021-03-06,33594,9,0,0,226,33829
2021-03-07,35242,4,0,30,359,35635
2021-03-08,27746,19,0,2,231,27998
2021-03-09,26578,9,0,0,101,26688
2021-03-10,30033,10,0,27,251,30321
2021-03-11,24635,5,0,20,193,24853
2021-03-12,31359,38,0,3,306,31706
2021-03-13,24416,2,0,22,244,24684
2021-03-14,23497,17,0,28,350,23892
2021-03-15,22690,7,0,2,261,22960
2021-03-16,26285,2,0,0,112,26399
2021-03-17,27062,10,0,34,308,27414
2021-03-18,30009,10,0,8,322,30349
2021-03-19,38119,10,0,28,292,38449
2021-03-20,30469,11,0,0,261,30741
2021-03-21,30641,4,0,27,449,31121
2021-03-22,26720,12,0,0,281,27013
2021-03-23,24213,12,0,0,160,24385
2021-03-24,28733,5,0,17,258,29013
2021-03-25,29511,10,0,6,237,29764
2021-03-26,42417,10,0,4,456,42887
2021-03-27,46737,7,0,1,310,47055
2021-03-28,36067,4,0,61,439,36571
2021-03-29,25819,8,0,0,262,26089
2021-03-30,29002,6,0,17,203,29228
2021-03-31,35727,23,0,72,370,36192
2021-04-01,46107,13,0,4,547,46671
2021-04-02,53848,13,0,5,450,54316
2021-04-03,32829,5,0,3,293,33130
2021-04-04,32240,2,0,28,454,32724
2021-04-05,46314,12,0,14,844,47184
2021-04-06,35341,20,0,2,210,35573
2021-04-07,31815,15,0,51,313,32194
2021-04-08,28330,2,0,3,421,28756
2021-04-09,40601,9,0,7,650,41267
2021-04-10,45186,9,0,17,1091,46303
2021-04-11,42908,15,0,31,814,43768
2021-04-12,26534,6,0,0,365,26905
2021-04-13,25767,17,0,1,224,26009
2021-04-14,28344,18,0,60,402,28824
2021-04-15,31421,8,0,5,316,31750
2021-04-16,40006,18,0,18,524,40566
2021-04-17,35260,20,0,23,572,35875
2021-04-18,39996,27,0,31,524,40578
2021-04-19,28984,14,0,0,323,29321
2021-04-20,27250,17,0,5,204,27476
2021-04-21,30734,10,0,52,271,31067
2021-04-22,30695,13,0,3,379,31090
2021-04-23,44378,6,0,30,536,44950
2021-04-24,43527,18,0,44,582,44171
2021-04-25,47528,21,0,36,766,48351
2021-04-26,33490,15,0,41,876,34422
2021-04-27,36411,21,0,7,197,36636
2021-04-28,36366,17,0,48,385,36816
2021-04-29,44667,14,0,6,448,45135
2021-04-30,57481,26,0,11,691,58209
2021-05-01,52001,11,0,20,698,52730
2021-05-02,50169,17,0,36,1055,51277
2021-05-03,45068,16,0,16,567,45667
2021-05-04,34955,22,0,27,324,35328
2021-05-05,36986,22,0,70,643,37721
2021-05-06,35609,12,0,35,612,36268
2021-05-07,47572,6,0,12,759,48349
2021-05-08,58143,14,0,17,1241,59415
2021-05-09,63609,16,0,35,1265,64925
2021-05-10,38954,18,0,10,1168,40150
2021-05-11,45268,9,0,15,246,45538
2021-05-12,59799,29,0,64,710,60602
2021-05-13,59332,24,0,8,781,60145
2021-05-14,45196,30,0,9,715,45950
2021-05-15,53598,6,0,53,1402,55059
2021-05-16,80925,38,0,95,1788,82846
2021-05-17,49559,19,0,47,665,50290
2021-05-18,35866,45,0,34,309,36254
2021-05-19,38440,18,0,82,647,39187
2021-05-20,41157,18,0,14,778,41967
2021-05-21,56772,27,0,24,995,57818
2021-05-22,71586,21,0,6,1522,73135
2021-05-23,68793,16,0,119,1551,70479
2021-05-24,56992,29,0,20,1530,58571
2021-05-25,42420,32,0,38,501,42991
2021-05-26,40825,19,0,103,1017,41964
2021-05-27,43323,17,0,22,901,44263
2021-05-28,57172,19,0,47,1401,58639
2021-05-29,66584,22,0,56,2579,69241
2021-05-30,77584,22,0,80,2127,79813
2021-05-31,48705,26,0,93,1238,50062
2021-06-01,42034,84,0,35,826,42979
2021-06-02,60066,21,0,95,945,61127
2021-06-03,64808,56,144,311,1069,66388
2021-06-04,63045,24,58,537,1284,64948
2021-06-05,87057,47,69,850,3320,91343
2021-06-06,138612,233,252,1022,3725,143844
2021-06-07,60919,32,0,106,1283,62340
2021-06-08,47773,149,0,36,1179,49137
2021-06-09,46442,24,0,81,1330,47877
2021-06-10,56478,156,0,22,1785,58441
2021-06-11,78306,26,0,1209,2010,81551
2021-06-12,80211,25,0,44,4292,84572
2021-06-13,114007,347,0,181,4446,118981
2021-06-14,64310,27,0,918,2067,67322
2021-06-15,55541,166,0,54,1585,57346
2021-06-16,62375,26,0,140,1917,64458
2021-06-17,66905,162,0,85,2467,69619
2021-06-18,87062,41,4,1732,2759,91598
2021-06-19,97008,36,0,49,6040,103133
2021-06-20,141474,434,0,186,5404,147498
2021-06-21,79633,35,0,825,2852,83345
2021-06-22,65790,244,0,325,2481,68840
2021-06-23,75308,85,0,51,2214,77658
2021-06-24,98058,408,0,186,3488,102140
2021-06-25,112960,57,146,1687,3648,118498
2021-06-26,128028,71,0,1147,8462,137708
2021-06-27,171216,653,0,390,7485,179744
2021-06-28,93964,31,0,1804,4442,100241
2021-06-29,84539,526,0,378,3780,89223
2021-06-30,103352,60,0,11,3691,107114
2021-07-01,95352,652,0,340,5194,101538
2021-07-02,140470,49,0,1944,4942,147405
2021-07-03,157869,252,0,1463,10263,169847
2021-07-04,197222,450,0,306,9710,207688
2021-07-05,107462,215,0,1351,5757,114785
2021-07-06,72290,452,0,617,5149,78508
2021-07-07,82322,565,0,290,4514,87691
2021-07-08,115010,447,236,781,6457,122931
2021-07-09,144631,411,0,2163,7258,154463
2021-07-10,213731,477,0,1762,14580,230550
2021-07-11,184919,764,239,618,12096,198636
2021-07-12,139183,747,0,1513,7238,148681
2021-07-13,116467,653,0,421,7101,124642
2021-07-14,131617,529,110,124,7009,139389
2021-07-15,145616,655,215,1468,8448,156402
2021-07-16,192723,593,0,1986,9455,204757
2021-07-17,235204,582,133,1821,17476,255216
2021-07-18,238912,982,0,766,13884,254544
2021-07-19,164800,622,113,2423,8962,176920
2021-07-20,137329,578,0,974,8067,146948
2021-07-21,131207,485,0,1210,7917,140819
2021-07-22,146170,845,229,842,10092,158178
2021-07-23,230834,659,0,3774,12034,247301
2021-07-24,277821,669,0,2251,20537,301278
2021-07-25,294202,833,0,851,17359,313245
2021-07-26,167693,811,103,3353,11356,183316
2021-07-27,154578,731,0,939,11300,167548
2021-07-28,159970,628,83,858,11084,172623
2021-07-29,185010,809,150,1255,13024,200248
2021-07-30,275917,727,0,2711,16542,295897
2021-07-31,364555,797,266,3247,24266,393131
2021-08-01,326999,844,0,920,19317,348080
2021-08-02,207982,711,0,3564,13258,225515
2021-08-03,168700,802,0,1042,13050,183594
2021-08-04,176732,629,0,182,12526,190069
2021-08-05,207217,891,360,1740,13781,223989
2021-08-06,250324,561,58,5293,16057,272293
2021-08-07,337642,552,0,4148,25679,368021
2021-08-08,319184,865,0,1315,21268,342632
2021-08-09,221818,748,202,4536,14743,242047
2021-08-10,180240,564,126,1558,14442,196930
2021-08-11,187289,666,70,1145,14685,203855
2021-08-12,219245,740,154,1709,16281,238129
2021-08-13,284293,621,59,6161,17469,308603
2021-08-14,340592,714,54,4439,27398,373197
2021-08-15,313693,844,0,2165,21833,338535
2021-08-16,235750,716,109,4346,15582,256503
2021-08-17,172542,799,0,1952,15499,190792
2021-08-18,171399,607,119,746,15647,188518
2021-08-19,212241,810,191,2900,16498,232640
2021-08-20,282313,698,131,6604,17195,306941
2021-08-21,318958,633,4,5734,28316,353645
2021-08-22,337964,893,182,3001,22876,364916
2021-08-23,230290,883,73,3606,15860,250712
2021-08-24,170245,819,86,1524,16419,189093
2021-08-25,199419,620,0,883,15774,216696
2021-08-26,224035,670,355,1993,17760,244813
2021-08-27,276967,223,66,7764,17806,302826
2021-08-28,288879,642,0,4579,29782,323882
2021-08-29,249541,1070,0,2107,23877,276595
2021-08-30,199638,585,305,4596,16067,221191
2021-08-31,161101,719,165,1029,15677,178691
2021-09-01,130425,635,124,953,13238,145375
2021-09-02,148297,724,347,1359,13629,164356
2021-09-03,176319,108,435,5663,13756,196281
2021-09-04,190186,172,131,2466,25833,218788
2021-09-05,216202,834,0,1747,20061,238844
2021-09-06,140586,208,0,4753,11233,156780
2021-09-07,114708,695,208,2185,11162,128958
2021-09-08,122673,95,177,1189,10862,134996
2021-09-09,136873,649,338,1419,12560,151839
2021-09-10,160825,163,405,6723,13029,181145
2021-09-11,194312,261,0,3227,24162,221962
2021-09-12,190506,825,54,894,18698,210977
2021-09-13,112972,187,124,3281,11009,127573
2021-09-14,103533,334,145,1850,10726,116588
2021-09-15,113268,122,123,2537,11123,127173
2021-09-16,126667,518,736,1329,11616,140866
2021-09-17,142755,171,312,5552,12856,161646
2021-09-18,137129,176,139,2625,23653,163722
2021-09-19,138668,700,0,1195,17379,157942
2021-09-20,92047,100,89,3000,10104,105340
2021-09-21,77801,523,82,1411,10412,90229
2021-09-22,91652,242,124,244,9203,101465
2021-09-23,86426,364,253,1971,10015,99029
2021-09-24,111743,127,125,4526,10966,127487
2021-09-25,123466,135,418,3764,22037,149820
2021-09-26,150821,508,0,1639,15823,168791
2021-09-27,76656,96,97,1683,9948,88480
2021-09-28,70242,412,0,532,10312,81498
2021-09-29,72676,86,133,449,9118,82462
2021-09-30,80050,27,443,1531,9468,91519
2021-10-01,85199,55,146,3562,9026,97988
2021-10-02,88499,82,27,3023,18294,109925
2021-10-03,114608,114,0,746,12611,128079
2021-10-04,68534,66,91,1190,6872,76753
2021-10-05,52916,72,163,42,6854,60047
2021-10-06,56714,44,178,2596,5093,64625
2021-10-07,61289,33,119,1144,5372,67957
2021-10-08,78141,41,88,2755,6422,87447
2021-10-09,75372,58,103,3000,15290,93823
2021-10-10,101446,33,0,223,9701,111403
2021-10-11,58652,47,103,146,6229,65177
2021-10-12,51589,28,55,37,5749,57458
2021-10-13,48712,15,0,459,4064,53250
2021-10-14,50433,60,509,313,4697,56012
2021-10-15,78744,74,562,309,5721,85410
2021-10-16,76447,93,96,6988,12709,96333
2021-10-17,84560,108,0,2352,8985,96005
2021-10-18,60774,59,107,2332,5718,68990
2021-10-19,52207,58,75,620,5608,58568
2021-10-20,53652,69,61,1449,4305,59536
2021-10-21,59081,92,0,1303,5447,65923
2021-10-22,79052,106,187,2225,6437,88007
2021-10-23,92368,89,135,3022,12922,108536
2021-10-24,86996,100,159,1869,8835,97959
2021-10-25,61550,91,110,682,5724,68157
2021-10-26,67227,45,0,657,5350,73279
2021-10-27,64739,32,0,3175,4140,72086
2021-10-28,67285,36,116,439,5083,72959
2021-10-29,90131,68,392,573,5419,96583
2021-10-30,94974,52,0,3032,10411,108469
2021-10-31,94101,68,0,2090,3914,100173
2021-11-01,97048,66,54,477,2010,99655
2021-11-02,65211,44,45,2068,1694,69062
2021-11-03,47132,40,0,777,1601,49550
2021-11-04,50242,84,122,8,1809,52265
2021-11-05,58805,64,73,7,2068,61017
2021-11-06,57878,51,127,3450,3532,65038
2021-11-07,61486,66,0,1265,2884,65701
2021-11-08,46895,134,66,800,1779,49674
2021-11-09,36298,56,0,1638,975,38967
2021-11-10,43056,47,0,1035,1257,45395
2021-11-11,46147,40,0,1223,1454,48864
2021-11-12,57783,54,47,6,1432,59322
2021-11-13,52259,93,0,0,1935,54287
2021-11-14,61639,40,0,1002,2730,65411
2021-11-15,39503,36,104,88,1914,41645
2021-11-16,37475,50,75,14,1071,38685
2021-11-17,46304,49,0,65,1254,47672
2021-11-18,43558,47,0,471,1238,45314
2021-11-19,53586,32,0,13,1111,54742
2021-11-20,47660,37,0,10,1646,49353
2021-11-21,66971,23,0,1031,1765,69790
2021-11-22,46959,14,0,8,2050,49031
2021-11-23,42820,31,0,53,1016,43920
2021-11-24,47849,44,0,81,1018,48992
2021-11-25,45992,29,0,1,1562,47584
2021-11-26,54768,42,65,1,1560,56436
2021-11-27,40766,24,0,0,1844,42634
2021-11-28,53004,55,0,659,1706,55424
2021-11-29,40762,30,0,18,1624,42434
2021-11-30,37177,18,0,29,1031,38255
2021-12-01,37986,16,0,51,1109,39162
2021-12-02,41511,57,0,10,1429,43007
2021-12-03,56346,40,0,1,1330,57717
2021-12-04,45243,26,0,1,1718,46988
2021-12-05,45423,40,0,56,1705,47224
2021-12-06,38656,66,0,0,1759,40481
2021-12-07,37030,31,0,28,1075,38164
2021-12-08,40794,24,0,60,1085,41963
2021-12-09,35062,24,0,0,1612,36698
2021-12-10,50883,57,0,5,1447,52392
2021-12-11,47539,23,0,0,2005,49567
2021-12-12,47656,63,0,69,2127,49915
2021-12-13,36713,22,0,4,1667,38406
2021-12-14,39289,47,0,2,985,40323
2021-12-15,48219,17,0,61,1077,49374
2021-12-16,48289,32,0,10,1581,49912
2021-12-17,66544,47,0,9,1393,67993
2021-12-18,89547,266,0,0,2137,91950
2021-12-19,75127,210,0,40,1722,77099
2021-12-20,51158,76,0,17,1589,52840
2021-12-21,53336,61,0,8,996,54401
2021-12-22,80546,168,0,104,1389,82207
2021-12-23,119844,81,0,1,1640,121566
2021-12-24,144914,51,0,2,1251,146218
2021-12-25,79188,26,0,4,666,79884
2021-12-26,65999,70,0,38,1377,67484
2021-12-27,61690,210,0,1,1391,63292
2021-12-28,59338,248,0,4,1256,60846
2021-12-29,59665,265,0,56,1719,61705
2021-12-30,83134,153,0,1,1899,85187
2021-12-31,49347,57,0,0,1065,50469
2022-01-01,53447,180,0,2,1271,54900
2022-01-02,98474,189,0,41,2381,101085
2022-01-03,59392,73,0,7,2099,61571
2022-01-04,54677,55,0,2,1690,56424
2022-01-05,57250,39,0,62,1798,59149
2022-01-06,62396,51,0,0,1690,64137
2022-01-07,70574,59,0,8,1759,72400
2022-01-08,97714,64,0,0,2056,99834
2022-01-09,113545,70,0,58,2134,115807
2022-01-10,66824,36,0,0,1640,68500
2022-01-11,40269,19,0,0,846,41134
2022-01-12,42278,31,0,33,867,43209
2022-01-13,41731,30,0,6,985,42752
2022-01-14,50458,31,0,0,1300,51789
2022-01-15,47309,46,0,5,1144,48504
2022-01-16,56995,45,0,39,1282,58361
2022-01-17,41747,27,0,0,1195,42969
2022-01-18,35793,29,0,8,608,36438
2022-01-19,38305,34,0,24,757,39120
2022-01-20,39963,30,0,4,897,40894
2022-01-21,48862,42,0,19,1239,50162
2022-01-22,44288,32,0,0,1058,45378
2022-01-23,52146,61,0,31,1462,53700
2022-01-24,39832,21,0,0,1188,41041
2022-01-25,33540,40,0,11,549,34140
2022-01-26,36536,14,0,29,800,37379
2022-01-27,38700,72,0,1,922,39695
2022-01-28,51051,12,0,1,1031,52095
2022-01-29,43646,48,0,9,1123,44826
2022-01-30,46954,34,0,36,1399,48423
2022-01-31,36193,18,0,0,1285,37496
2022-02-01,36066,16,0,0,846,36928
2022-02-02,36944,44,0,34,775,37797
2022-02-03,43583,49,0,2,909,44543
2022-02-04,54942,27,0,487,1347,56803
2022-02-05,52226,36,0,5,1293,53560
2022-02-06,51984,71,0,37,1642,53734
2022-02-07,40714,40,0,0,1353,42107
2022-02-08,53696,60,0,3,855,54614
2022-02-09,43233,60,0,40,898,44231
2022-02-10,43326,45,0,0,1183,44554
2022-02-11,54360,59,0,0,1365,55784
2022-02-12,54959,53,0,0,1297,56309
2022-02-13,64302,126,0,42,1653,66123
2022-02-14,43889,57,0,3,1532,45481
2022-02-15,42251,31,0,8,1035,43325
2022-02-16,41777,31,0,36,892,42736
2022-02-17,47920,31,0,5,1248,49204
2022-02-18,67117,31,0,5,1631,68784
2022-02-19,65747,56,0,0,1689,67492
2022-02-20,68004,39,0,45,2108,70196
2022-02-21,51252,21,0,634,1534,53441
2022-02-22,44627,26,0,0,1031,45684
2022-02-23,51305,17,0,40,1151,52513
2022-02-24,53702,7,0,629,1550,55888
2022-02-25,72552,17,0,2,1684,74255
2022-02-26,71778,34,0,0,1966,73778
2022-02-27,78238,21,0,0,2071,80330
2022-02-28,50368,16,0,0,1752,52136
2022-03-01,48132,12,0,2,1184,49330
2022-03-02,45322,26,0,48,1123,46519
2022-03-03,50303,28,0,16,1341,51688
2022-03-04,67321,16,0,3,1661,69001
2022-03-05,66563,27,0,0,1386,67976
2022-03-06,78462,56,0,67,2091,80676
2022-03-07,48965,18,0,50,1796,50829
2022-03-08,39178,2,0,2,1203,40385
2022-03-09,43133,9,0,54,1165,44361
2022-03-10,47748,24,0,1099,1430,50301
2022-03-11,61185,16,0,2,1679,62882
2022-03-12,59149,4,0,0,1668,60821
2022-03-13,80031,49,0,52,2101,82233
2022-03-14,49048,30,0,4,1700,50782
2022-03-15,48140,58,0,1010,1275,50483
2022-03-16,47471,17,0,56,1222,48766
2022-03-17,55233,15,0,3,1415,56666
2022-03-18,66432,35,104,522,1744,68837
2022-03-19,63138,41,0,4,1928,65111
2022-03-20,75888,16,0,666,2748,79318
2022-03-21,50953,24,0,35,1958,52970
2022-03-22,44181,54,0,38,1284,45557
2022-03-23,48522,18,86,55,1345,50026
2022-03-24,50467,13,0,23,1816,52319
2022-03-25,72489,27,230,581,1688,75015
2022-03-26,67220,21,118,547,1879,69785
2022-03-27,96163,39,0,105,3130,99437
2022-03-28,48712,14,97,13,1979,50815
2022-03-29,45058,24,0,572,2172,47826
2022-03-30,47262,35,0,304,2414,50015
2022-03-31,54228,23,0,876,2601,57728
2022-04-01,62559,45,77,8,2425,65114
2022-04-02,58941,20,67,201,3422,62651
2022-04-03,72988,67,74,51,4675,77855
2022-04-04,49466,17,58,50,3524,53115
2022-04-05,43282,33,114,17,2741,46187
2022-04-06,51088,23,0,146,2990,54247
2022-04-07,56943,34,226,587,3838,61628
2022-04-08,73985,17,0,308,3248,77558
2022-04-09,93982,39,57,2058,5737,101873
2022-04-10,101457,44,0,470,6576,108547
2022-04-11,60073,36,105,3760,3705,67679
2022-04-12,59451,23,1,3051,3616,66142
2022-04-13,66752,61,69,2116,4102,73100
2022-04-14,107933,30,100,3253,5055,116371
2022-04-15,141857,68,194,3089,5071,150279
2022-04-16,108797,31,191,2598,9953,121570
2022-04-17,101744,108,0,146,10082,112080
2022-04-18,227908,80,85,1308,8115,237496
2022-04-19,100555,67,124,384,6330,107460
2022-04-20,66818,40,90,262,6577,73787
2022-04-21,74972,83,389,4140,6504,86088
2022-04-22,109425,38,465,64,5796,115788
2022-04-23,126884,27,134,1295,12864,141204
2022-04-24,103751,20,98,1960,12022,117851
2022-04-25,95819,65,161,1077,6898,104020
2022-04-26,78605,48,0,2508,5423,86584
2022-04-27,84125,44,146,2008,5653,91976
2022-04-28,87660,16,192,1874,5473,95215
2022-04-29,113823,87,122,2383,5178,121593
2022-04-30,147950,54,339,3488,9796,161627
2022-05-01,152559,83,48,4511,10235,167436
2022-05-02,115083,38,0,1882,5951,122954
2022-05-03,81984,44,149,2722,6197,91096
2022-05-04,67029,20,112,2741,6160,76062
2022-05-05,80935,32,360,2301,6402,90030
2022-05-06,87700,33,91,73,5840,93737
2022-05-07,93867,66,103,2444,12409,108889
2022-05-08,117314,25,96,2355,12736,132526
2022-05-09,79479,22,181,1441,6475,87598
2022-05-10,60458,27,118,2870,6622,70095
2022-05-11,61356,38,130,5257,6717,73498
2022-05-12,69076,132,106,3242,6714,79270
2022-05-13,86525,108,418,2119,6133,95303
2022-05-14,90263,101,222,1609,14191,106386
2022-05-15,138869,111,208,3072,13793,156053
2022-05-16,76869,124,106,2621,6963,86683
2022-05-17,66302,61,0,728,7125,74216
2022-05-18,65620,86,276,1500,7142,74624
2022-05-19,72225,89,301,5876,8588,87079
2022-05-20,87069,159,291,143,6789,94451
2022-05-21,104539,125,6,3729,17840,126239
2022-05-22,153142,242,306,1626,15116,170432
2022-05-23,84449,141,225,6560,8151,99526
2022-05-24,70294,94,0,3809,7982,82179
2022-05-25,86054,80,172,5320,8930,100556
2022-05-26,115519,230,186,2857,10331,129123
2022-05-27,104491,73,645,4376,8437,118022
2022-05-28,119565,81,309,2159,22685,144799
2022-05-29,194531,114,139,662,20718,216164
2022-05-30,93549,186,214,2287,10581,106817
2022-05-31,65341,74,271,533,11006,77225
2022-06-01,80549,79,180,1083,10086,91977
2022-06-02,97776,26,173,3484,11790,113249
2022-06-03,145394,34,194,2272,9365,157259
2022-06-04,150347,90,195,7198,22712,180542
2022-06-05,213031,346,200,8077,22079,243733
2022-06-06,163805,54,204,5422,13066,182551
2022-06-07,112857,115,80,6286,13317,132655
2022-06-08,93971,93,228,4080,12692,111064
2022-06-09,110152,230,0,3592,13100,127074
2022-06-10,132728,29,496,4036,13177,150466
2022-06-11,167490,89,78,4360,24359,196376
2022-06-12,247370,676,158,2752,21054,272010
2022-06-13,126785,126,280,4620,12355,144166
2022-06-14,102770,272,23,1840,13233,118138
2022-06-15,122883,30,88,3271,13276,139548
2022-06-16,169885,470,353,3920,14468,189096
2022-06-17,190646,104,195,1296,14589,206830
2022-06-18,235524,29,191,7791,27266,270801
2022-06-19,326953,182,159,1734,23902,352930
2022-06-20,158625,73,140,5985,15644,180467
2022-06-21,124306,365,214,7091,14074,146050
2022-06-22,119578,72,131,6818,14045,140644
2022-06-23,138026,400,135,4247,14642,157450
2022-06-24,175700,95,360,4247,14241,194643
2022-06-25,225131,45,247,2765,26832,255020
2022-06-26,253480,697,81,2202,23664,280124
2022-06-27,194680,263,379,6553,17473,219348
2022-06-28,137113,567,546,6393,16565,161184
2022-06-29,138656,50,342,3888,15981,158917
2022-06-30,162239,423,254,5145,18565,186626
2022-07-01,204602,412,115,1158,16147,222434
2022-07-02,220743,524,254,15773,29239,266533
2022-07-03,275056,782,169,4797,25902,306706
2022-07-04,173157,283,127,4362,18277,196206
2022-07-05,131236,413,79,3156,15504,150388
2022-07-06,148977,622,25,5493,16426,171543
2022-07-07,213790,826,97,3049,18181,235943
2022-07-08,242931,561,371,3901,19160,266924
2022-07-09,269476,797,121,5517,32437,308348
2022-07-10,290152,1061,0,2729,28434,322376
2022-07-11,215012,1005,121,6637,20236,243011
2022-07-12,155267,1069,252,5021,20614,182223
2022-07-13,174437,782,110,4703,20050,200082
2022-07-14,201344,956,304,7498,20844,230946
2022-07-15,278970,1037,341,3595,20070,304013
2022-07-16,348118,938,131,12138,32948,394273
2022-07-17,358268,1101,0,6171,29262,394802
2022-07-18,237036,1133,237,9078,20836,268320
2022-07-19,184257,846,0,10005,20904,216012
2022-07-20,190105,423,52,7068,22054,219702
2022-07-21,228510,768,138,4690,22133,256239
2022-07-22,266514,1049,198,6613,21738,296112
2022-07-23,383157,1116,36,5431,32987,422727
2022-07-24,385062,977,126,3303,29796,419264
2022-07-25,240895,872,197,5903,21383,269250
2022-07-26,201024,736,106,1575,22412,225853
2022-07-27,207350,1037,159,3774,21861,234181
2022-07-28,244281,606,40,7178,25285,277390
2022-07-29,351903,688,137,2470,23837,379035
2022-07-30,440715,1211,285,13122,36287,491620
2022-07-31,411163,2156,0,6431,31034,450784
2022-08-01,268136,337,268,6387,22979,298107
2022-08-02,200883,679,261,7713,23042,232578
2022-08-03,213732,1026,0,7652,23960,246370
2022-08-04,255869,1645,70,4006,23837,285427
2022-08-05,302928,801,152,3484,23344,330709
2022-08-06,371701,1031,90,11510,36905,421237
2022-08-07,341050,1368,96,6916,31104,380534
2022-08-08,262980,1035,87,11638,23400,299140
2022-08-09,205190,1177,158,8286,24557,239368
2022-08-10,218118,630,67,3364,25655,247834
2022-08-11,223502,1167,150,10752,25344,260915
2022-08-12,309463,1075,162,2760,24416,337876
2022-08-13,315910,1089,0,13847,36914,367760
2022-08-14,351115,1539,0,4939,31039,388632
2022-08-15,325447,935,134,9891,22764,359171
2022-08-16,220628,1235,78,6143,24121,252205
2022-08-17,224866,957,226,8499,23109,257657
2022-08-18,238457,826,0,6461,24212,269956
2022-08-19,307838,1152,109,11066,23015,343180
2022-08-20,361357,1300,79,12312,35437,410485
2022-08-21,336645,1195,0,4574,31234,373648
2022-08-22,249643,908,298,6400,21413,278662
2022-08-23,191660,1068,0,4662,23995,221385
2022-08-24,196754,1530,0,4376,22872,225532
2022-08-25,257610,672,0,7367,24016,289665
2022-08-26,291335,783,180,4505,22032,318835
2022-08-27,352778,1002,363,21123,35963,411229
2022-08-28,341451,1471,0,7216,31307,381445
2022-08-29,250507,903,162,10191,21190,282953
2022-08-30,214893,919,95,7717,22552,246176
2022-08-31,70412,167,80,5035,9892,85586
2022-09-01,174056,1014,0,4106,21080,200256
2022-09-02,200602,1038,289,3588,19115,224632
2022-09-03,267871,380,213,6255,32619,307338
2022-09-04,233911,1023,145,3984,28677,267740
2022-09-05,141820,173,207,4638,16670,163508
2022-09-06,131176,634,167,2655,17457,152089
2022-09-07,127852,448,321,3275,16691,148587
2022-09-08,160248,745,384,7117,18875,187369
2022-09-09,185445,413,223,1420,18208,205709
2022-09-10,205636,308,149,8011,31061,245165
2022-09-11,226677,907,116,4152,25972,257824
2022-09-12,126398,298,115,1858,17360,146029
2022-09-13,108987,754,140,4934,16826,131641
2022-09-14,118381,154,201,7556,17020,143312
2022-09-15,135236,741,201,2502,18569,157249
2022-09-16,157929,275,303,4319,18406,181232
2022-09-17,165667,317,213,4234,30843,201274
2022-09-18,182233,722,0,1473,26203,210631
2022-09-19,117814,362,148,2838,16091,137253
2022-09-20,102088,622,143,3888,17569,124310
2022-09-21,108200,249,196,2675,16426,127746
2022-09-22,119733,760,409,6576,17408,144886
2022-09-23,147716,228,111,1058,16971,166084
2022-09-24,168140,220,188,11198,30562,210308
2022-09-25,175383,885,89,4686,25158,206201
2022-09-26,104311,145,248,4127,14836,123667
2022-09-27,85508,510,139,4186,15990,106333
2022-09-28,88997,148,0,5527,14498,109170
2022-09-29,96087,315,90,3493,16005,115990
2022-09-30,126022,273,516,3621,14377,144809
2022-10-01,124567,125,515,6177,25491,156875
2022-10-02,136898,220,46,3305,20628,161097
2022-10-03,94349,215,461,5480,11775,112280
2022-10-04,71253,244,353,1049,11956,84855
2022-10-05,72460,273,172,5075,10881,88861
2022-10-06,79682,123,538,2821,10374,93538
2022-10-07,96287,234,253,3740,10202,110716
2022-10-08,112824,277,53,8547,21850,143551
2022-10-09,125211,265,64,3783,17378,146701
2022-10-10,75476,214,148,4995,10681,91514
2022-10-11,68063,29,133,9640,11021,88886
2022-10-12,68733,223,378,6205,9577,85116
2022-10-13,76372,173,96,3790,10291,90722
2022-10-14,93528,163,293,2240,9145,105369
2022-10-15,107086,941,167,6009,17452,131655
2022-10-16,127107,208,93,2736,15270,145414
2022-10-17,77756,196,254,2376,9038,89620
2022-10-18,63868,232,148,1161,9553,74962
2022-10-19,66991,274,361,1610,9033,78269
2022-10-20,70412,167,80,5035,9892,85586
2022-10-21,95475,203,203,434,7659,103974
2022-10-22,93111,164,280,7392,15274,116221
2022-10-23,115766,330,0,4289,13215,133600
2022-10-24,73871,225,263,1578,8305,84242
2022-10-25,64795,93,251,2153,9086,76378
2022-10-26,83935,107,0,3533,8920,96495
2022-10-27,83164,410,0,2804,11180,97558
2022-10-28,119101,276,180,2192,10509,132258
2022-10-29,152675,182,77,4587,16779,174300
2022-10-30,111952,222,0,4061,6727,122962
2022-10-31,114135,348,25,2709,4559,121776
2022-11-01,141198,313,0,95,3702,145308
2022-11-02,99060,119,0,376,3038,102593
2022-11-03,71067,131,116,1256,2613,75183
2022-11-04,84098,96,126,547,3610,88477
