,osobni automobili,vlakovi,teretna vozila,autobusi,plovila,zrakoplovi,UKUPNO
2013-01-01,20674,6,686,255,5,18,21644
2013-01-02,29674,11,1551,439,10,23,31708
2013-01-03,27661,10,1984,436,13,23,30127
2013-01-04,32659,13,1927,345,11,16,34971
2013-01-05,39205,9,1222,472,12,14,40934
2013-01-06,30558,7,1243,506,8,16,32338
2013-01-07,22515,11,2211,277,6,20,25040
2013-01-08,21841,11,2732,261,4,16,24865
2013-01-09,21762,11,3148,307,11,20,25259
2013-01-10,20608,12,2912,341,8,19,23900
2013-01-11,24338,14,2682,338,10,20,27402
2013-01-12,25194,13,1729,331,8,17,27292
2013-01-13,20763,9,1604,407,3,20,22806
2013-01-14,15179,9,2093,241,6,20,17548
2013-01-15,16345,12,3262,254,3,18,19894
2013-01-16,16389,12,3426,306,6,18,20157
2013-01-17,14871,9,3157,308,7,13,18365
2013-01-18,19030,13,2618,298,8,15,21982
2013-01-19,20017,14,2000,341,8,16,22396
2013-01-20,17413,8,1740,381,1,17,19560
2013-01-21,17580,8,3474,221,10,12,21305
2013-01-22,16997,15,3320,246,5,17,20600
2013-01-23,17440,12,3369,306,10,18,21155
2013-01-24,18159,15,3354,290,8,12,21838
2013-01-25,18038,11,2283,241,9,20,20602
2013-01-26,19219,12,2016,337,9,16,21609
2013-01-27,19224,9,1955,328,5,19,21540
2013-01-28,17936,14,3200,239,15,21,21425
2013-01-29,15650,13,3508,208,10,14,19403
2013-01-30,17908,12,3359,294,6,16,21595
2013-01-31,18760,10,3611,323,14,18,22736
2013-02-01,21986,17,2833,299,13,17,25165
2013-02-02,20121,13,1985,331,1,16,22467
2013-02-03,17851,7,1302,413,5,21,19599
2013-02-04,19473,9,3107,235,12,22,22858
2013-02-05,18223,12,3682,226,13,14,22170
2013-02-06,16738,12,3530,310,10,17,20617
2013-02-07,19757,14,3039,267,12,13,23102
2013-02-08,25369,14,2312,310,5,17,28027
2013-02-09,21022,12,2315,383,13,14,23759
2013-02-10,21662,11,1647,377,7,19,23723
2013-02-11,18115,10,3543,251,9,19,21947
2013-02-12,15953,9,3046,267,6,13,19294
2013-02-13,16165,11,3274,307,13,15,19785
2013-02-14,18738,11,3281,308,6,17,22361
2013-02-15,20983,12,2894,278,11,23,24201
2013-02-16,24193,9,2086,332,7,16,26643
2013-02-17,22101,9,1848,343,10,19,24330
2013-02-18,21440,10,3584,221,11,17,25283
2013-02-19,17163,13,3534,216,14,13,20953
2013-02-20,17576,10,3701,294,17,20,21618
2013-02-21,16984,12,3615,333,8,16,20968
2013-02-22,20361,12,2860,332,11,20,23596
2013-02-23,18476,11,2107,329,12,13,20948
2013-02-24,19333,9,1658,343,3,18,21364
2013-02-25,17785,11,3660,256,8,17,21737
2013-02-26,18402,16,3787,240,13,17,22475
2013-02-27,18257,11,3945,341,7,15,22576
2013-02-28,20657,12,3624,359,8,21,24681
2013-03-01,46231,14,3092,316,7,21,49681
2013-03-02,25769,15,1698,353,10,19,27864
2013-03-03,27806,5,1884,449,11,26,30181
2013-03-04,21560,12,3540,288,7,16,25423
2013-03-05,19502,11,3876,272,14,18,23693
2013-03-06,18986,13,3648,317,7,17,22988
2013-03-07,20077,15,3512,403,4,17,24028
2013-03-08,26349,13,3022,453,14,19,29870
2013-03-09,22795,13,1899,390,12,16,25125
2013-03-10,23185,7,1835,474,10,21,25532
2013-03-11,19410,12,3657,288,11,18,23396
2013-03-12,20035,16,3583,262,20,14,23930
2013-03-13,19640,13,4022,323,8,18,24024
2013-03-14,17807,16,3320,401,10,20,21574
2013-03-15,24337,12,3100,392,19,16,27876
2013-03-16,25805,14,2307,455,28,18,28627
2013-03-17,23022,10,1755,432,10,20,25249
2013-03-18,18909,12,3597,290,8,22,22838
2013-03-19,20753,14,3937,328,14,8,25054
2013-03-20,20131,19,4316,419,18,23,24926
2013-03-21,23114,17,3986,398,20,3,27538
2013-03-22,32392,18,3402,477,25,26,36340
2013-03-23,34162,15,2106,510,27,27,36847
2013-03-24,25636,9,1782,496,20,29,27972
2013-03-25,18773,13,2947,315,6,17,22071
2013-03-26,20341,17,3827,343,22,25,24575
2013-03-27,24541,13,3946,380,19,28,28927
2013-03-28,34196,15,4046,443,20,28,38748
2013-03-29,48712,14,2959,466,35,23,52209
2013-03-30,31917,14,1456,371,22,27,33807
2013-03-31,25139,6,725,323,25,32,26250
2013-04-01,38136,6,2061,495,21,41,40760
2013-04-02,26534,12,3702,399,13,43,30703
2013-04-03,22663,14,3836,399,26,30,26968
2013-04-04,22612,12,3909,439,28,32,27032
2013-04-05,28745,10,3412,433,10,39,32649
2013-04-06,28634,12,2039,546,33,40,31304
2013-04-07,26658,11,1896,531,15,37,29148
2013-04-08,19365,13,3407,336,28,37,23186
2013-04-09,20492,12,3989,360,22,40,24915
2013-04-10,21284,14,4138,419,23,36,25914
2013-04-11,21858,15,4078,443,34,37,26465
2013-04-12,26987,17,3326,438,26,23,30817
2013-04-13,31880,14,2439,495,33,56,34917
2013-04-14,29110,12,1880,508,37,44,31591
2013-04-15,20415,11,4160,315,33,51,24985
2013-04-16,19529,13,3915,393,38,40,23928
2013-04-17,23704,16,4371,475,39,41,28646
2013-04-18,23939,14,4026,431,35,44,28489
2013-04-19,30838,17,3439,433,32,57,34816
2013-04-20,30854,12,2271,581,36,74,33828
2013-04-21,30805,11,2120,598,21,42,33597
2013-04-22,22145,11,4278,392,31,37,26894
2013-04-23,21966,16,4273,387,29,43,26714
2013-04-24,26146,16,4069,503,54,41,30829
2013-04-25,35283,15,4705,619,236,45,40903
2013-04-26,42990,13,3778,587,66,61,47495
2013-04-27,66627,14,2072,872,46,101,69732
2013-04-28,41592,14,2526,876,56,62,45126
2013-04-29,29684,16,4032,527,64,60,34383
2013-04-30,48869,16,3930,570,68,51,53504
2013-05-01,60168,17,1515,850,120,64,62734
2013-05-02,36543,14,2302,563,136,52,39610
2013-05-03,38126,13,3062,740,69,74,42084
2013-05-04,45479,17,1891,947,64,134,48532
2013-05-05,39322,12,1445,738,48,81,41646
2013-05-06,31270,12,3292,543,37,50,35204
2013-05-07,27001,17,4023,463,50,63,31617
2013-05-08,30746,13,3650,497,62,68,35036
2013-05-09,38260,13,3993,601,88,112,43067
2013-05-10,34361,17,3505,549,73,60,38565
2013-05-11,35559,14,2273,591,54,123,38614
2013-05-12,36777,11,2075,747,61,67,39738
2013-05-13,26986,11,4260,509,34,55,31855
2013-05-14,24988,19,4513,408,36,66,30030
2013-05-15,25168,17,4531,549,69,50,30384
2013-05-16,29224,13,4453,626,20,57,34393
2013-05-17,49165,15,4102,649,43,73,54047
2013-05-18,52733,17,2441,742,116,170,56219
2013-05-19,38735,13,1902,705,69,69,41493
2013-05-20,34584,12,3834,564,60,50,39104
2013-05-21,28362,16,4599,484,66,62,33589
2013-05-22,26369,14,4434,566,70,58,31511
2013-05-23,29166,16,4271,659,36,57,34205
2013-05-24,40250,18,3783,627,38,57,44773
2013-05-25,39367,13,2487,842,65,150,42924
2013-05-26,33280,11,2113,725,48,81,36258
2013-05-27,26771,14,4210,470,63,58,31586
2013-05-28,25196,16,4577,456,54,66,30365
2013-05-29,37042,14,4393,642,66,63,42220
2013-05-30,37713,15,3138,686,59,64,41675
2013-05-31,36570,15,3632,725,62,66,41070
2013-06-01,43134,16,2356,797,82,170,46555
2013-06-02,42905,10,2054,770,104,84,45927
2013-06-03,28590,11,4196,603,73,76,33549
2013-06-04,26495,12,4372,567,60,78,31584
2013-06-05,27127,14,4278,535,78,63,32095
2013-06-06,30779,15,4196,614,74,67,35745
2013-06-07,42842,16,3593,683,130,99,47363
2013-06-08,47074,14,2669,827,158,199,50941
2013-06-09,40079,13,2015,757,73,104,43041
2013-06-10,30307,8,4113,574,69,76,35147
2013-06-11,28125,12,4057,488,70,75,32827
2013-06-12,28757,10,4671,546,74,84,34142
2013-06-13,35167,13,4095,546,84,99,40004
2013-06-14,50617,11,3553,838,153,102,55274
2013-06-15,56109,12,2200,1005,273,236,59835
2013-06-16,51061,12,2060,758,129,112,54132
2013-06-17,34779,13,4075,538,111,81,39597
2013-06-18,32283,12,4144,515,108,87,37149
2013-06-19,31963,13,4613,565,85,104,37343
2013-06-20,40686,11,4449,644,135,112,46037
2013-06-21,65743,11,3800,813,189,96,70652
2013-06-22,73259,11,2541,1275,280,228,77594
2013-06-23,55021,12,2188,875,192,118,58406
2013-06-24,45728,15,3736,564,94,77,50214
2013-06-25,41646,20,2908,621,106,82,45383
2013-06-26,37475,20,5095,673,71,99,43433
2013-06-27,40686,13,4660,687,76,97,46219
2013-06-28,59220,15,4236,781,110,95,64457
2013-06-29,76721,14,2221,1223,305,229,80713
2013-06-30,64163,16,1727,942,196,131,67175
2013-07-01,46798,14,3044,615,198,101,50770
2013-07-02,36204,17,3472,615,187,106,40601
2013-07-03,35027,15,4031,678,147,93,39991
2013-07-04,43232,11,4607,636,166,126,48778
2013-07-05,71263,14,3342,769,242,135,75765
2013-07-06,89955,15,2255,1118,321,224,93888
2013-07-07,67752,13,2069,773,125,126,70858
2013-07-08,52538,13,3714,637,153,115,57170
2013-07-09,43045,12,4101,600,113,110,47981
2013-07-10,42935,12,4417,698,141,110,48313
2013-07-11,51794,12,4406,667,157,116,57152
2013-07-12,74471,13,3780,724,175,108,79271
2013-07-13,95426,9,2656,952,279,248,99570
2013-07-14,78624,12,2102,832,207,138,81915
2013-07-15,58567,16,4361,575,240,103,63862
2013-07-16,47118,15,4202,598,128,116,52177
2013-07-17,46454,12,5457,741,161,118,52943
2013-07-18,53819,14,4622,597,178,122,59352
2013-07-19,74955,15,3630,721,164,98,79583
2013-07-20,124524,14,1945,1094,347,272,128196
2013-07-21,88380,11,2057,893,171,132,91644
2013-07-22,66383,15,4332,629,151,110,71620
2013-07-23,45683,15,4683,521,166,123,51191
2013-07-24,56458,16,4222,666,150,116,61628
2013-07-25,67737,14,4468,660,166,136,73181
2013-07-26,88732,15,3847,798,164,133,93689
2013-07-27,134099,16,2189,1100,375,245,138024
2013-07-28,93751,14,2184,841,337,153,97280
2013-07-29,60396,14,3943,590,151,109,65203
2013-07-30,57114,12,4446,677,162,120,62531
2013-07-31,61971,15,4482,755,151,126,67500
2013-08-01,84752,13,3990,822,207,155,89939
2013-08-02,99396,15,3622,742,349,138,104262
2013-08-03,141536,13,1846,1280,687,288,145650
2013-08-04,100707,11,1720,924,543,130,104035
2013-08-05,78333,14,3033,804,338,118,82640
2013-08-06,63794,15,4333,818,312,129,69401
2013-08-07,58774,16,4187,731,262,112,64082
2013-08-08,64129,16,3447,636,246,130,68604
2013-08-09,89394,13,2994,759,181,109,93450
2013-08-10,145086,13,1665,1176,192,237,148369
2013-08-11,103437,11,1765,925,539,154,106831
2013-08-12,73668,13,3434,636,420,118,78289
2013-08-13,65877,14,4052,633,330,113,71019
2013-08-14,79109,13,2975,815,115,128,83155
2013-08-15,93810,9,1950,759,171,174,96873
2013-08-16,97262,15,2903,811,245,108,101344
2013-08-17,142146,16,1503,1203,261,236,145365
2013-08-18,100557,14,1848,913,259,129,103720
2013-08-19,71970,13,3623,738,177,114,76635
2013-08-20,55592,13,3810,632,72,99,60218
2013-08-21,56739,13,3955,691,101,111,61610
2013-08-22,58988,15,3598,780,410,116,63907
2013-08-23,95916,13,3467,831,103,99,100429
2013-08-24,118920,14,1783,1340,105,213,122375
2013-08-25,79365,8,1769,1088,83,124,82437
2013-08-26,56436,12,4322,640,85,89,61584
2013-08-27,50493,14,4088,655,89,99,55438
2013-08-28,46295,15,4434,696,65,97,51602
2013-08-29,58573,16,4542,706,93,122,64052
2013-08-30,78461,14,3407,800,106,113,82901
2013-08-31,94414,12,2100,1190,146,252,98114
2013-09-01,77482,14,2090,1070,119,129,80904
2013-09-02,49367,16,4275,687,73,80,54498
2013-09-03,40039,12,4243,699,93,76,45162
2013-09-04,42152,11,4461,773,61,81,47539
2013-09-05,46566,12,4483,722,77,107,51967
2013-09-06,63342,13,3499,774,116,119,67863
2013-09-07,69937,12,2323,1224,168,206,73870
2013-09-08,56942,10,1986,931,84,114,60067
2013-09-09,39508,10,4043,601,41,71,44274
2013-09-10,33671,13,4361,627,35,79,38786
2013-09-11,34523,12,4348,815,33,76,39807
2013-09-12,38368,12,4531,740,45,74,43770
2013-09-13,46973,16,4191,789,66,86,52121
2013-09-14,52538,14,2379,1113,89,189,56322
2013-09-15,42493,11,2031,870,62,105,45572
2013-09-16,31708,14,4252,656,45,74,36749
2013-09-17,29071,12,4198,570,23,70,33944
2013-09-18,29559,13,4576,678,43,74,34943
2013-09-19,32782,12,4638,644,58,81,38215
2013-09-20,45619,13,3903,670,55,101,50361
2013-09-21,46687,9,2438,1008,98,196,50436
2013-09-22,37800,16,2046,833,58,106,40859
2013-09-23,28442,12,4671,649,50,80,33904
2013-09-24,26367,16,4447,593,49,75,31547
2013-09-25,26530,13,4707,642,33,62,31987
2013-09-26,31292,12,4919,796,44,78,37141
2013-09-27,39435,12,4192,769,43,74,44525
2013-09-28,41960,13,2837,1000,47,172,46029
2013-09-29,31550,11,2410,801,35,82,34889
2013-09-30,25938,15,4743,540,24,63,31323
2013-10-01,24831,11,4664,548,31,68,30153
2013-10-02,27479,13,5046,665,26,24,33253
2013-10-03,29438,12,4458,637,30,80,34655
2013-10-04,36561,11,3590,758,29,57,41006
2013-10-05,36265,13,2492,816,27,136,39749
2013-10-06,31428,10,2075,812,22,74,34421
2013-10-07,24065,12,4323,538,15,48,29001
2013-10-08,26432,13,4185,533,15,51,31229
2013-10-09,23142,13,5075,566,25,43,28864
2013-10-10,29818,12,4125,624,33,49,34661
2013-10-11,36841,15,3973,636,32,48,41545
2013-10-12,33655,11,2354,822,22,98,36962
2013-10-13,31235,10,1999,731,39,63,34077
2013-10-14,23027,12,4088,488,33,60,27708
2013-10-15,21987,15,4247,464,23,53,26789
2013-10-16,26585,13,4770,556,20,42,31986
2013-10-17,26898,12,4678,558,29,51,32226
2013-10-18,34489,11,4017,553,26,52,39148
2013-10-19,35393,14,2504,657,30,84,38682
2013-10-20,32396,14,2150,652,21,63,35296
2013-10-21,23456,16,4081,438,21,51,28063
2013-10-22,20961,13,4600,426,14,57,26071
2013-10-23,22314,15,4257,520,13,41,27160
2013-10-24,25187,14,4917,546,20,48,30732
2013-10-25,32827,11,4482,514,20,49,37903
2013-10-26,37048,13,2226,631,31,78,40027
2013-10-27,30596,17,2176,600,25,36,33450
2013-10-28,25053,11,4799,395,24,24,30306
2013-10-29,23907,15,5038,372,15,24,29371
2013-10-30,39377,12,5261,473,16,24,45163
2013-10-31,47791,14,3076,498,18,31,51428
2013-11-01,37390,17,2143,435,31,24,40040
2013-11-02,32814,12,2054,405,11,31,35327
2013-11-03,40985,12,2087,566,16,30,43696
2013-11-04,24003,14,4457,360,17,18,28869
2013-11-05,19986,15,4479,311,13,18,24822
2013-11-06,20651,13,4496,365,13,18,25556
2013-11-07,23172,12,4662,455,16,22,28339
2013-11-08,28278,14,4120,455,15,19,32901
2013-11-09,27459,14,2634,455,8,13,30583
2013-11-10,24887,11,2085,449,16,19,27467
2013-11-11,20310,13,4248,331,7,20,24929
2013-11-12,19469,13,4022,288,3,24,23819
2013-11-13,20165,12,4606,346,21,14,25164
2013-11-14,22704,13,4715,387,16,22,27857
2013-11-15,27822,15,4026,384,14,18,32279
2013-11-16,26047,10,2177,502,7,16,28759
2013-11-17,27487,9,2239,422,12,25,30194
2013-11-18,20523,12,4220,291,7,20,25073
2013-11-19,20574,13,5142,282,5,16,26032
2013-11-20,20329,11,4583,350,8,1,25282
2013-11-21,22881,10,4579,368,10,7,27855
2013-11-22,29317,13,3321,363,8,8,33030
2013-11-23,23198,14,2545,435,12,13,26217
2013-11-24,26145,12,2092,405,10,19,28683
2013-11-25,21645,14,3824,285,6,16,25790
2013-11-26,17776,13,4440,269,3,16,22517
2013-11-27,18109,12,4495,348,5,15,22984
2013-11-28,20468,13,4369,364,17,16,25247
2013-11-29,27646,8,4084,348,20,20,32126
2013-11-30,24844,15,2168,453,10,14,27504
2013-12-01,23352,16,2109,414,4,18,25913
2013-12-02,19171,12,3815,267,6,15,23286
2013-12-03,17875,13,4497,266,8,22,22681
2013-12-04,20018,14,4352,341,11,16,24752
2013-12-05,21310,14,4560,359,26,16,26285
2013-12-06,25512,17,3890,359,9,22,29809
2013-12-07,23265,13,2290,466,9,17,26060
2013-12-08,21373,11,2141,410,11,22,23968
2013-12-09,17880,12,4141,235,11,17,22296
2013-12-10,19732,9,4351,260,10,20,24382
2013-12-11,19366,10,4400,352,11,17,24156
2013-12-12,21067,10,4534,362,11,16,26000
2013-12-13,26888,14,4029,365,12,18,31326
2013-12-14,24937,10,2499,422,9,15,27892
2013-12-15,24081,12,2237,494,10,21,26855
2013-12-16,20093,14,4605,248,10,17,24987
2013-12-17,19773,16,4808,292,15,7,24911
2013-12-18,25210,13,4511,399,13,16,30162
2013-12-19,27685,10,4179,479,16,21,32390
2013-12-20,43242,16,4160,480,8,20,47926
2013-12-21,61147,14,1749,627,11,15,63563
2013-12-22,37517,11,1549,536,9,18,39640
2013-12-23,33685,11,2794,369,17,16,36892
2013-12-24,29096,12,1762,319,8,13,31210
2013-12-25,22483,7,541,318,5,8,23362
2013-12-26,23112,7,1237,364,1,11,24732
2013-12-27,31695,13,1606,340,11,12,33677
2013-12-28,30802,14,963,452,7,19,32257
2013-12-29,27960,10,1170,600,11,15,29766
2013-12-30,31227,12,1754,450,5,13,33461
2013-12-31,22705,10,841,270,4,10,23840
2014-01-01,18039,8,585,300,7,10,18949
2014-01-02,30264,10,1705,441,13,18,32451
2014-01-03,35787,10,2269,463,8,15,38552
2014-01-04,38077,12,1141,543,8,12,39793
2014-01-05,40894,9,937,552,4,16,42412
2014-01-06,29480,12,1798,432,6,17,31745
2014-01-07,21040,11,2728,288,6,19,24092
2014-01-08,24779,12,3311,337,9,16,28464
2014-01-09,22187,11,3460,357,8,14,26037
2014-01-10,26952,13,3091,353,8,18,30435
2014-01-11,29865,11,2252,420,12,18,32578
2014-01-12,25898,9,1979,459,8,19,28372
2014-01-13,19125,13,3933,271,6,15,23363
2014-01-14,18568,12,4032,243,8,20,22883
2014-01-15,18837,9,3950,340,14,15,23165
2014-01-16,19454,11,3784,346,10,14,23619
2014-01-17,26183,11,3636,317,7,21,30175
2014-01-18,25866,11,2046,400,11,12,28346
2014-01-19,21873,10,1888,391,7,17,24186
2014-01-20,20536,13,3584,276,2,17,24428
2014-01-21,19635,14,4298,263,8,18,24236
2014-01-22,20072,15,4295,324,15,15,24736
2014-01-23,19171,11,4279,299,7,19,23786
2014-01-24,21219,11,3373,299,15,13,24930
2014-01-25,19155,11,2193,358,4,9,21730
2014-01-26,17780,14,1935,350,13,21,20113
2014-01-27,17713,12,3616,242,8,16,21607
2014-01-28,15284,12,3807,266,12,14,19395
2014-01-29,16355,13,4175,331,7,14,20895
2014-01-30,15960,12,3618,301,6,15,19912
2014-01-31,21149,10,3079,305,6,18,24567
2014-02-01,19268,10,2158,385,4,11,21836
2014-02-02,16965,5,1904,422,5,22,19323
2014-02-03,15659,8,3618,256,8,16,19565
2014-02-04,15544,8,3962,258,5,15,19792
2014-02-05,17440,8,4418,326,8,17,22217
2014-02-06,18509,8,3752,305,13,16,22603
2014-02-07,23617,8,3293,306,13,17,27254
2014-02-08,19967,7,1978,343,2,11,22308
2014-02-09,20847,8,1910,371,6,19,23161
2014-02-10,18291,11,3704,243,14,16,22279
2014-02-11,17182,10,3699,272,10,15,21188
2014-02-12,17022,11,3945,300,7,20,21305
2014-02-13,22123,12,4268,325,9,19,26756
2014-02-14,26924,10,3118,329,8,20,30409
2014-02-15,26121,10,2115,381,10,20,28657
2014-02-16,23271,6,1975,386,2,21,25661
2014-02-17,19482,11,3315,253,11,17,23089
2014-02-18,18000,9,4103,262,11,17,22402
2014-02-19,18600,11,4344,335,9,15,23314
2014-02-20,21230,9,3992,330,11,18,25590
2014-02-21,26154,12,3377,335,9,15,29902
2014-02-22,24108,9,2284,377,12,14,26804
2014-02-23,23988,10,1486,337,6,23,25850
2014-02-24,18992,11,3804,244,10,17,23078
2014-02-25,18587,11,4175,236,9,20,23038
2014-02-26,19444,12,4158,340,9,18,23981
2014-02-27,19927,11,4057,387,10,15,24407
2014-02-28,27729,8,3711,359,16,16,31839
2014-03-01,26679,12,2438,422,13,12,29576
2014-03-02,24776,9,1898,442,9,18,27152
2014-03-03,20636,9,3853,299,7,18,24822
2014-03-04,19441,11,4140,291,8,14,23905
2014-03-05,20199,12,4600,374,9,16,25210
2014-03-06,20522,10,4044,440,4,19,25039
2014-03-07,29471,10,3636,458,8,20,33603
2014-03-08,26415,12,2179,457,9,23,29095
2014-03-09,29237,13,1895,507,4,25,31681
2014-03-10,20831,9,3914,285,5,19,25063
2014-03-11,19615,15,4358,288,4,18,24298
2014-03-12,20034,10,4350,352,7,25,24778
2014-03-13,22058,12,4177,369,15,7,26638
2014-03-14,32165,12,3863,409,7,29,36485
2014-03-15,28502,14,2102,447,16,18,31099
2014-03-16,29338,10,1914,477,13,23,31775
2014-03-17,21766,13,4573,275,14,22,26663
2014-03-18,19421,14,5056,315,13,15,24834
2014-03-19,21670,16,4510,416,14,23,26649
2014-03-20,22895,13,4574,429,12,21,27944
2014-03-21,30726,16,3953,357,19,28,35099
2014-03-22,29098,11,2249,461,16,18,31853
2014-03-23,26506,11,2084,465,4,20,29090
2014-03-24,20323,14,4407,287,21,23,25075
2014-03-25,19761,13,4528,340,11,21,24674
2014-03-26,20508,12,4827,398,11,20,25776
2014-03-27,22845,14,4576,419,14,21,27889
2014-03-28,29969,14,3980,434,17,29,34443
2014-03-29,29448,12,2563,518,33,33,32607
2014-03-30,30011,10,1960,517,27,28,32553
2014-03-31,21059,13,4287,313,18,24,25714
2014-04-01,20856,14,4477,333,19,42,25741
2014-04-02,21729,13,4333,449,20,39,26583
2014-04-03,22800,14,4681,483,16,33,28027
2014-04-04,32314,17,4037,475,8,31,36882
2014-04-05,29450,10,2382,577,24,51,32494
2014-04-06,29685,10,2072,559,18,32,32376
2014-04-07,22387,15,4357,361,22,43,27185
2014-04-08,20827,11,4688,348,29,39,25942
2014-04-09,21292,16,4765,425,20,32,26550
2014-04-10,26353,13,4689,535,17,51,31658
2014-04-11,41931,15,4441,522,33,92,47034
2014-04-12,46485,16,2570,635,50,95,49851
2014-04-13,36921,10,2272,578,45,54,39880
2014-04-14,25577,12,4545,357,23,45,30559
2014-04-15,27169,12,5209,378,43,40,32851
2014-04-16,32771,11,4725,503,18,25,38053
2014-04-17,46199,13,4290,661,28,42,51233
2014-04-18,65135,12,2913,749,50,47,68906
2014-04-19,37316,18,1081,481,55,70,39021
2014-04-20,30696,10,693,402,33,37,31871
2014-04-21,51439,9,2025,662,18,46,54199
2014-04-22,33648,12,4474,558,33,47,38772
2014-04-23,26648,12,4483,517,20,42,31722
2014-04-24,31267,16,4647,607,35,40,36612
2014-04-25,45786,11,4288,636,75,47,50843
2014-04-26,51369,14,2352,956,45,87,54823
2014-04-27,38561,11,1867,819,38,45,41341
2014-04-28,30470,12,4741,517,23,47,35810
2014-04-29,28748,13,4766,588,33,46,34194
2014-04-30,63915,11,4165,781,54,57,68983
2014-05-01,60521,12,1231,1020,94,57,62935
2014-05-02,37446,14,1844,566,112,51,40033
2014-05-03,42207,14,2239,828,27,110,45425
2014-05-04,50450,10,1962,1162,29,69,53682
2014-05-05,28729,11,4216,601,29,55,33641
2014-05-06,26276,13,4555,529,34,65,31472
2014-05-07,25712,14,4751,464,34,58,31033
2014-05-08,28968,16,4726,655,27,42,34434
2014-05-09,34684,14,3632,500,49,61,38940
2014-05-10,36729,12,2466,669,56,142,40074
2014-05-11,32139,8,2113,702,31,72,35065
2014-05-12,24219,13,4674,497,47,38,29488
2014-05-13,23175,11,4724,506,23,53,28492
2014-05-14,23661,13,4548,524,30,54,28830
2014-05-15,25495,11,4109,600,23,60,30298
2014-05-16,34735,9,3566,630,40,55,39035
2014-05-17,31164,7,2306,687,52,127,34343
2014-05-18,27085,7,1646,663,46,74,29521
2014-05-19,23535,7,3612,544,32,57,27787
2014-05-20,23283,10,3802,554,43,63,27755
2014-05-21,23395,12,4730,591,39,68,28835
2014-05-22,25995,13,3955,605,62,64,30694
2014-05-23,38728,9,3894,654,63,80,43428
2014-05-24,41073,11,2384,823,85,160,44536
2014-05-25,34587,9,2266,682,55,87,37686
2014-05-26,26414,10,4413,543,49,63,31492
2014-05-27,24323,9,4629,502,42,68,29573
2014-05-28,36041,8,4543,688,38,100,41418
2014-05-29,46487,11,4311,739,74,90,51712
2014-05-30,44865,10,3756,826,107,103,49667
2014-05-31,46503,9,2117,878,239,184,49930
2014-06-01,43220,9,2143,838,120,92,46422
2014-06-02,31921,7,4125,591,72,78,36794
2014-06-03,24624,12,4672,602,49,68,30027
2014-06-04,27157,10,4550,607,66,76,32466
2014-06-05,33584,12,4652,638,62,100,39048
2014-06-06,55779,12,4275,710,153,108,61037
2014-06-07,72203,11,2762,1149,228,224,76577
2014-06-08,52013,8,1435,744,123,143,54466
2014-06-09,39754,9,4051,610,101,83,44608
2014-06-10,30664,9,4975,558,91,85,36382
2014-06-11,32283,10,4747,584,103,99,37826
2014-06-12,33747,11,4673,572,82,94,39179
2014-06-13,45425,10,4104,648,125,92,50404
2014-06-14,62859,10,2541,972,77,191,66650
2014-06-15,45286,10,2248,819,81,104,48548
2014-06-16,33860,11,4298,579,68,77,38893
2014-06-17,32327,13,4946,562,75,71,37994
2014-06-18,43829,11,4754,678,92,101,49465
2014-06-19,51630,12,3417,759,150,139,56107
2014-06-20,56832,14,4066,791,170,113,61986
2014-06-21,64588,12,2606,1160,213,220,68799
2014-06-22,58626,7,2227,989,165,125,62139
2014-06-23,37376,12,4939,596,117,88,43128
2014-06-24,37522,8,5573,596,73,92,43864
2014-06-25,38434,15,3564,678,41,89,42821
2014-06-26,41155,15,5542,752,127,116,47707
2014-06-27,55588,13,4806,806,141,108,61462
2014-06-28,72637,16,2766,1105,300,232,77056
2014-06-29,58994,12,2668,857,87,124,62742
2014-06-30,43093,14,4656,656,84,94,48597
2014-07-01,39253,14,4882,687,195,123,45154
2014-07-02,37803,13,5230,665,140,101,43952
2014-07-03,42963,12,4984,769,152,139,49019
2014-07-04,65843,12,4668,835,216,125,71699
2014-07-05,95122,16,2547,1428,283,223,99619
2014-07-06,74095,14,2363,830,217,153,77672
2014-07-07,50986,15,4998,648,157,109,56913
2014-07-08,42898,16,4869,615,51,116,48565
2014-07-09,41916,17,5721,744,76,121,48595
2014-07-10,51839,15,5022,708,59,136,57779
2014-07-11,69883,15,4323,779,176,129,75305
2014-07-12,97238,13,2253,1141,244,217,101106
2014-07-13,69021,14,2253,779,120,126,72313
2014-07-14,59445,13,4943,676,125,116,65318
2014-07-15,49590,17,5301,607,244,134,55893
2014-07-16,50472,13,5229,776,173,152,56815
2014-07-17,58754,13,4766,771,173,149,64626
2014-07-18,89739,15,4622,766,294,137,95573
2014-07-19,116053,14,2810,1383,380,247,120887
2014-07-20,93233,13,2306,989,216,161,96918
2014-07-21,69160,12,5443,727,85,109,75536
2014-07-22,51726,16,5072,661,120,132,57727
2014-07-23,52964,16,5145,798,119,133,59175
2014-07-24,63192,15,4987,700,250,143,69287
2014-07-25,95919,17,4514,819,213,116,101598
2014-07-26,130970,15,2394,916,197,222,134714
2014-07-27,82518,16,2162,817,212,154,85879
2014-07-28,61311,15,4232,530,192,111,66391
2014-07-29,55621,17,5111,637,79,129,61594
2014-07-30,62123,13,5255,768,49,117,68325
2014-07-31,76682,21,4920,861,179,143,82806
2014-08-01,117617,17,4074,816,375,151,123050
2014-08-02,141893,13,1873,1272,562,239,145852
2014-08-03,118615,14,2556,858,328,154,122525
2014-08-04,74934,15,4052,614,364,115,80094
2014-08-05,65377,16,3735,642,185,127,70082
2014-08-06,63781,19,4583,820,243,144,69590
2014-08-07,72793,17,4152,710,257,148,78077
2014-08-08,102374,15,3749,902,308,153,107501
2014-08-09,143825,12,1872,1001,680,263,147653
2014-08-10,108643,12,1982,1177,480,183,112477
2014-08-11,79748,11,4124,650,332,127,84992
2014-08-12,69290,14,4410,708,160,134,74716
2014-08-13,64664,14,4138,720,128,134,69798
2014-08-14,96556,13,3850,881,133,138,101571
2014-08-15,104043,15,1581,926,212,147,106924
2014-08-16,133626,17,1707,1062,168,228,136808
2014-08-17,104329,13,1993,1091,262,177,107865
2014-08-18,80906,15,4326,700,171,95,86213
2014-08-19,61962,15,4167,671,102,116,67033
2014-08-20,60648,15,3770,717,89,142,65381
2014-08-21,65771,16,4755,761,73,121,71497
2014-08-22,84166,14,4077,756,90,119,89222
2014-08-23,118388,12,1983,1225,82,212,121902
2014-08-24,84089,13,2135,984,197,156,87574
2014-08-25,65398,12,4407,734,119,105,70775
2014-08-26,52668,14,5167,636,67,115,58667
2014-08-27,55065,16,4763,826,72,120,60862
2014-08-28,62551,16,4666,752,77,122,68184
2014-08-29,77668,16,4153,878,141,122,82978
2014-08-30,103735,13,2719,1466,122,230,108285
2014-08-31,75286,13,2372,1041,78,139,78929
2014-09-01,56742,15,4559,691,23,75,62105
2014-09-02,43303,18,5058,648,46,96,49169
2014-09-03,41769,17,5171,746,48,99,47850
2014-09-04,45410,15,5266,706,51,93,51541
2014-09-05,58687,15,4478,783,58,95,64116
2014-09-06,70166,13,2386,1210,99,194,74068
2014-09-07,56213,14,2339,911,115,127,59719
2014-09-08,41474,12,4999,721,58,79,47343
2014-09-09,33565,14,4839,647,47,91,39203
2014-09-10,34777,16,5242,692,31,95,40853
2014-09-11,37560,15,4927,701,31,94,43328
2014-09-12,51326,12,4402,801,67,79,56687
2014-09-13,54534,13,2407,1145,53,187,58339
2014-09-14,43962,12,2210,984,71,113,47352
2014-09-15,33409,16,4862,659,42,80,39068
2014-09-16,30186,13,5334,604,41,75,36253
2014-09-17,31214,13,5345,745,49,102,37468
2014-09-18,34257,14,5402,738,53,95,40559
2014-09-19,45289,17,4537,766,38,83,50730
2014-09-20,42312,13,2480,970,46,177,45998
2014-09-21,39653,12,2164,1032,46,102,43009
2014-09-22,28230,12,4927,707,29,65,33970
2014-09-23,25959,14,4473,565,29,79,31119
2014-09-24,32949,13,5171,665,38,87,38923
2014-09-25,31204,15,5116,696,26,78,37135
2014-09-26,44610,13,4564,773,52,82,50094
2014-09-27,43740,13,3050,1004,55,182,48044
2014-09-28,37826,9,2512,860,78,99,41384
2014-09-29,26593,11,5022,654,25,73,32378
2014-09-30,26882,14,5422,618,27,72,33035
2014-10-01,27348,16,5225,774,27,65,33455
2014-10-02,34342,10,5259,710,35,64,40420
2014-10-03,49675,13,4776,822,42,72,55400
2014-10-04,39523,13,2365,816,47,130,42894
2014-10-05,41163,9,2118,828,37,87,44242
2014-10-06,28584,12,4713,569,40,57,33975
2014-10-07,25554,12,5009,511,23,53,31162
2014-10-08,27969,10,4705,633,16,55,33388
2014-10-09,27825,13,5383,630,36,58,33945
2014-10-10,41028,13,4875,654,33,60,46663
2014-10-11,39688,11,2665,900,31,97,43392
2014-10-12,36019,9,2372,769,39,76,39284
2014-10-13,25912,10,4838,506,31,55,31352
2014-10-14,24092,13,5316,450,24,51,29946
2014-10-15,24934,12,4984,615,17,47,30609
2014-10-16,27842,11,4886,597,18,53,33407
2014-10-17,36513,10,4268,558,26,45,41420
2014-10-18,36857,11,2951,732,31,90,40672
2014-10-19,35175,9,2428,698,34,71,38415
2014-10-20,24389,10,4763,464,11,54,29691
2014-10-21,22942,11,5246,459,10,43,28711
2014-10-22,21962,11,5055,644,23,45,27740
2014-10-23,24973,11,4479,579,13,50,30105
2014-10-24,37669,10,4816,544,19,52,43110
2014-10-25,37009,7,2974,762,20,71,40843
2014-10-26,31043,9,2240,726,24,43,34085
2014-10-27,24819,12,4688,423,10,27,29979
2014-10-28,23800,11,5019,396,15,28,29269
2014-10-29,27229,13,5575,437,19,29,33302
2014-10-30,41057,13,5035,490,23,31,46649
2014-10-31,43988,11,2927,452,29,32,47439
2014-11-01,34655,14,2114,458,12,39,37292
2014-11-02,37150,15,2312,539,18,36,40070
2014-11-03,25182,15,5014,423,15,22,30671
2014-11-04,21910,10,5127,348,8,22,27425
2014-11-05,22776,12,5113,397,4,20,28322
2014-11-06,22782,12,4988,448,9,20,28259
2014-11-07,29480,13,4280,485,8,19,34285
2014-11-08,28698,12,2612,508,13,21,31864
2014-11-09,26379,11,2237,504,11,23,29165
2014-11-10,21961,10,4989,345,7,21,27333
2014-11-11,22442,12,4728,325,8,23,27538
2014-11-12,20292,11,4915,383,11,18,25630
2014-11-13,23295,14,4571,436,9,18,28343
2014-11-14,31213,15,4407,441,11,25,36112
2014-11-15,34216,10,2644,550,7,16,37443
2014-11-16,27615,12,2206,484,10,21,30348
2014-11-17,21754,12,4721,309,9,22,26827
2014-11-18,20266,13,4904,308,7,21,25519
2014-11-19,21049,12,4959,344,19,19,26402
2014-11-20,23788,10,4905,404,15,19,29141
2014-11-21,31798,14,4292,400,15,24,36543
2014-11-22,27776,9,2313,470,17,20,30605
2014-11-23,27760,6,2250,456,7,21,30500
2014-11-24,21486,13,4589,267,8,21,26384
2014-11-25,21101,13,4947,304,6,24,26395
2014-11-26,20584,9,5222,344,13,22,26194
2014-11-27,21453,11,5021,394,9,21,26909
2014-11-28,28224,14,4408,411,11,17,33085
2014-11-29,25064,14,2335,489,7,15,27924
2014-11-30,24027,12,2244,422,11,17,26733
2014-12-01,20655,10,4688,284,6,18,25661
2014-12-02,19726,16,4761,270,14,20,24807
2014-12-03,20190,12,5046,356,14,18,25636
2014-12-04,21223,11,4469,364,12,19,26098
2014-12-05,28553,12,3992,344,10,18,32929
2014-12-06,26286,15,2508,462,11,13,29295
2014-12-07,23379,11,1752,390,5,28,25565
2014-12-08,22861,12,4568,303,12,20,27776
2014-12-09,19869,12,4914,303,3,7,25108
2014-12-10,20328,12,4889,366,6,3,25604
2014-12-11,22220,16,4756,370,14,18,27394
2014-12-12,26926,13,4183,357,11,24,31514
2014-12-13,26707,12,2563,466,11,18,29777
2014-12-14,22538,15,1991,433,9,23,25009
2014-12-15,20401,21,4764,244,14,20,25464
2014-12-16,20714,20,5183,290,14,20,26241
2014-12-17,23907,21,5281,414,13,23,29659
2014-12-18,27734,19,5220,457,16,20,33466
2014-12-19,42219,20,4275,414,13,20,46961
2014-12-20,55254,19,3023,692,13,23,59024
2014-12-21,38587,16,2133,612,10,26,41384
2014-12-22,30539,21,4289,307,8,22,35186
2014-12-23,41956,20,3533,450,7,21,45987
2014-12-24,45817,17,2393,442,10,16,48695
2014-12-25,27170,12,641,304,6,11,28144
2014-12-26,27734,14,992,359,7,19,29125
2014-12-27,31025,17,924,425,7,18,32416
2014-12-28,21917,14,1549,501,5,20,24006
2014-12-29,24404,20,1929,464,5,17,26839
2014-12-30,30867,20,2113,588,5,22,33615
2014-12-31,24026,19,974,363,4,18,25404
2015-01-01,15679,12,511,281,3,13,16499
2015-01-02,30256,15,1173,510,13,24,31991
2015-01-03,34487,15,955,602,12,18,36089
2015-01-04,31464,12,1229,622,8,22,33357
2015-01-05,29724,17,1599,338,10,19,31707
2015-01-06,28213,17,1784,360,3,24,30401
2015-01-07,22752,19,2564,329,8,20,25692
2015-01-08,24865,15,3340,412,5,19,28656
2015-01-09,29927,20,3294,384,7,26,33658
2015-01-10,37145,11,2184,435,10,15,39800
2015-01-11,29365,15,1855,521,2,21,31779
2015-01-12,19848,16,4199,262,5,21,24351
2015-01-13,25369,19,4623,278,6,21,30316
2015-01-14,20353,21,4596,349,7,21,25347
2015-01-15,20536,21,4420,350,13,19,25359
2015-01-16,27378,22,4158,367,5,25,31955
2015-01-17,26214,15,2492,425,3,15,29164
2015-01-18,22997,15,2097,405,8,22,25544
2015-01-19,18883,19,4130,267,10,21,23330
2015-01-20,20330,23,4666,277,10,18,25324
2015-01-21,21029,20,4776,335,10,19,26189
2015-01-22,21987,19,4744,355,9,19,27133
2015-01-23,24679,19,4258,306,5,19,29286
2015-01-24,24449,17,2094,388,7,19,26974
2015-01-25,23336,13,2143,397,6,22,25917
2015-01-26,18722,19,4058,257,7,20,23083
2015-01-27,18183,16,4881,320,11,21,23432
2015-01-28,19829,23,4913,345,14,20,25144
2015-01-29,20076,19,4838,325,12,21,25291
2015-01-30,23777,21,3891,314,4,26,28033
2015-01-31,21551,13,2274,371,5,13,24227
2015-02-01,20349,17,2398,351,4,19,23138
2015-02-02,19538,17,4290,235,11,21,24112
2015-02-03,19189,16,4438,238,8,25,23914
2015-02-04,17171,17,4414,321,4,21,21948
2015-02-05,17530,22,3751,346,8,19,21676
2015-02-06,16968,19,1494,316,13,19,18829
2015-02-07,18213,15,2338,402,8,17,20993
2015-02-08,19018,14,2350,375,7,21,21785
2015-02-09,17859,19,4649,259,8,20,22814
2015-02-10,17515,20,4392,253,9,21,22210
2015-02-11,19638,20,4881,312,14,22,24887
2015-02-12,21341,21,4660,343,21,23,26409
2015-02-13,29718,18,3897,383,7,23,34046
2015-02-14,29271,15,2644,441,9,19,32399
2015-02-15,26784,13,2587,464,5,24,29877
2015-02-16,21499,20,4435,262,7,23,26246
2015-02-17,22739,18,4587,278,7,23,27652
2015-02-18,21636,20,4473,327,14,16,26486
2015-02-19,23522,20,4604,365,8,24,28543
2015-02-20,29224,19,4215,346,13,25,33842
2015-02-21,27647,16,2370,392,6,18,30449
2015-02-22,25380,13,2369,392,1,21,28176
2015-02-23,20698,15,4374,268,8,20,25383
2015-02-24,19206,16,4809,261,8,21,24321
2015-02-25,20167,17,4775,355,10,20,25344
2015-02-26,22562,20,5087,413,7,21,28110
2015-02-27,30208,20,4221,357,13,19,34838
2015-02-28,29292,14,2290,429,9,18,32052
2015-03-01,27919,14,2401,433,4,28,30799
2015-03-02,22126,18,5047,285,9,21,27506
2015-03-03,20511,19,5053,323,7,26,25939
2015-03-04,20666,14,5278,370,9,19,26356
2015-03-05,20523,26,4854,470,0,20,25893
2015-03-06,28265,20,4450,478,8,24,33245
2015-03-07,26727,13,2244,443,9,17,29453
2015-03-08,26925,16,2100,544,4,26,29615
2015-03-09,21635,20,5134,341,9,23,27162
2015-03-10,20711,20,5150,316,12,23,26232
2015-03-11,21837,17,4881,370,15,22,27142
2015-03-12,24134,20,4909,409,9,22,29503
2015-03-13,30909,19,4533,399,16,32,35908
2015-03-14,39503,15,2476,484,17,19,42514
2015-03-15,28248,14,2567,457,12,23,31321
2015-03-16,21886,21,4970,326,11,19,27233
2015-03-17,20802,20,5394,294,8,21,26539
2015-03-18,29048,18,5077,406,9,35,34593
2015-03-19,25697,19,5749,476,13,27,31981
2015-03-20,32327,19,4171,436,17,27,36997
2015-03-21,29843,16,2448,508,12,20,32847
2015-03-22,28394,13,2182,524,16,23,31152
2015-03-23,21589,18,5171,323,10,22,27133
2015-03-24,21627,19,5273,378,10,23,27330
2015-03-25,22729,17,5226,440,14,21,28447
2015-03-26,33474,20,5173,467,10,28,39172
2015-03-27,36600,22,4867,440,11,36,41976
2015-03-28,42921,14,2811,620,16,32,46414
2015-03-29,34549,13,2287,619,31,48,37547
2015-03-30,34526,20,5137,347,15,35,40080
2015-03-31,26660,20,5603,378,17,35,32713
2015-04-01,36516,20,4937,484,18,42,42017
2015-04-02,43768,22,4862,542,23,49,49266
2015-04-03,86457,19,3212,590,53,47,90378
2015-04-04,38582,16,1415,509,20,54,40596
2015-04-05,34167,15,870,433,10,43,35538
2015-04-06,48522,14,2723,558,23,39,51879
2015-04-07,39821,19,5316,472,24,47,45699
2015-04-08,27259,18,5088,487,14,45,32911
2015-04-09,29061,18,4916,544,23,49,34611
2015-04-10,43057,18,4578,537,31,47,48268
2015-04-11,43236,15,2381,693,32,70,46427
2015-04-12,32269,13,1482,454,26,54,34298
2015-04-13,29721,18,4105,421,26,46,34337
2015-04-14,24747,21,5098,462,18,48,30394
2015-04-15,25744,21,5428,498,22,47,31760
2015-04-16,28401,16,5677,528,32,51,34705
2015-04-17,37896,22,4954,562,32,36,43502
2015-04-18,36046,17,3136,610,19,85,39913
2015-04-19,43112,13,2469,626,33,64,46317
2015-04-20,24791,21,5393,464,30,42,30741
2015-04-21,24880,21,5574,442,23,80,31020
2015-04-22,25757,16,5899,582,25,53,32332
2015-04-23,28198,17,5720,605,18,47,34605
2015-04-24,44233,17,4653,603,32,60,49598
2015-04-25,53252,16,2611,827,64,83,56853
2015-04-26,36689,19,2321,685,30,60,39804
2015-04-27,31532,16,4164,466,22,40,36240
2015-04-28,28720,21,5709,461,24,52,34987
2015-04-29,40183,20,5205,674,43,57,46182
2015-04-30,68519,19,4429,820,82,74,73943
2015-05-01,59228,16,1198,891,69,70,61472
2015-05-02,43527,16,2454,708,120,107,46932
2015-05-03,50852,15,2930,950,23,88,54858
2015-05-04,32637,21,4839,673,33,59,38262
2015-05-05,27436,24,5649,513,40,64,33726
2015-05-06,29239,20,4734,600,34,65,34692
2015-05-07,31252,19,5434,638,45,65,37453
2015-05-08,43651,19,5039,666,46,76,49497
2015-05-09,44652,16,2853,699,61,123,48404
2015-05-10,41175,18,2381,756,53,84,44467
2015-05-11,27919,16,5311,542,42,68,33898
2015-05-12,29149,21,5658,500,45,67,35440
2015-05-13,50861,18,5592,632,40,74,57217
2015-05-14,44991,21,5109,731,67,97,51016
2015-05-15,42840,18,4658,630,23,62,48231
2015-05-16,40621,13,2950,728,43,116,44471
2015-05-17,42316,14,2557,712,69,101,45769
2015-05-18,27916,19,5020,608,37,59,33659
2015-05-19,26609,17,5361,522,30,56,32595
2015-05-20,28580,19,5688,642,43,67,35039
2015-05-21,31465,20,4767,543,36,81,36912
2015-05-22,52193,22,4919,799,25,65,58023
2015-05-23,53318,13,2418,900,53,145,56847
2015-05-24,42752,15,2151,731,86,94,45829
2015-05-25,48526,14,4297,635,66,70,53608
2015-05-26,29053,19,5855,544,44,78,35593
2015-05-27,30260,15,5039,608,40,77,36039
2015-05-28,34303,21,5289,640,55,97,40405
2015-05-29,53580,20,4888,716,122,96,59422
2015-05-30,60193,10,2611,1148,385,182,64529
2015-05-31,47287,11,2168,755,223,102,50546
2015-06-01,35955,21,4975,613,138,96,41798
2015-06-02,33957,16,5331,527,88,85,40004
2015-06-03,45599,17,4326,774,77,108,50901
2015-06-04,55369,19,3440,866,114,144,59952
2015-06-05,54384,19,5058,701,156,101,60419
2015-06-06,55466,10,2712,858,147,203,59396
2015-06-07,54561,13,2484,890,83,107,58138
2015-06-08,35467,18,4940,641,62,87,41215
2015-06-09,31656,17,5702,528,72,89,38064
2015-06-10,34895,16,5565,610,60,94,41240
2015-06-11,34794,22,4707,587,79,104,40293
2015-06-12,56932,17,4549,735,104,103,62440
2015-06-13,59234,16,3119,1055,105,189,63718
2015-06-14,48248,10,2453,782,63,121,51677
2015-06-15,37057,17,5217,627,79,85,43082
2015-06-16,33659,14,5425,585,61,91,39835
2015-06-17,36454,17,5448,688,52,92,42751
2015-06-18,39257,17,5636,610,107,111,45738
2015-06-19,50528,14,5306,752,108,94,56802
2015-06-20,66875,11,3234,1166,157,202,71645
2015-06-21,55623,14,2332,811,144,118,59042
2015-06-22,42015,18,4744,621,127,94,47619
2015-06-23,34112,20,5583,579,72,98,40464
2015-06-24,53123,19,5535,694,97,105,59573
2015-06-25,56909,19,4273,790,177,120,62288
2015-06-26,61222,20,4925,738,212,109,67226
2015-06-27,72713,15,2436,1234,218,223,76839
2015-06-28,64250,14,2623,869,153,126,68035
2015-06-29,48496,20,5554,629,128,89,54916
2015-06-30,41963,22,6001,581,115,116,48798
2015-07-01,48096,20,5071,785,131,128,54231
2015-07-02,49048,22,5506,737,191,138,55642
2015-07-03,74468,19,5093,821,247,148,80796
2015-07-04,89469,16,2685,1121,379,236,93906
2015-07-05,74700,15,2459,1020,216,144,78554
2015-07-06,54451,20,5037,712,161,104,60485
2015-07-07,46136,21,5693,650,117,130,52747
2015-07-08,47116,22,5163,695,99,116,53211
2015-07-09,52311,21,4947,746,84,144,58253
2015-07-10,75986,22,5034,713,197,156,82108
2015-07-11,108491,17,2826,1932,369,266,113901
2015-07-12,84978,16,2399,838,206,185,88622
2015-07-13,60060,20,5210,709,171,130,66300
2015-07-14,52100,21,5351,636,150,129,58387
2015-07-15,57211,19,5639,851,155,147,64022
2015-07-16,69298,21,5508,703,162,153,75845
2015-07-17,92355,20,4579,815,220,96,98085
2015-07-18,123407,21,2213,1322,336,242,127541
2015-07-19,100030,16,3002,1174,223,149,104594
2015-07-20,74695,20,5092,622,180,126,80735
2015-07-21,58114,24,5739,688,141,127,64833
2015-07-22,57761,21,4995,829,107,159,63872
2015-07-23,64824,21,5375,803,159,92,71274
2015-07-24,89245,16,4621,771,256,109,95018
2015-07-25,137074,15,2205,1465,227,236,141222
2015-07-26,88246,16,2804,941,115,195,92317
2015-07-27,74717,20,5596,753,263,119,81468
2015-07-28,59670,21,5716,617,152,126,66302
2015-07-29,60210,19,5400,766,135,111,66641
2015-07-30,76439,19,4780,838,103,154,82333
2015-07-31,110427,23,4014,965,116,146,115691
2015-08-01,164204,17,2224,1383,572,256,168656
2015-08-02,111842,15,2214,1147,524,152,115894
2015-08-03,86586,21,5228,766,391,128,93120
2015-08-04,64029,23,5370,697,286,137,70542
2015-08-05,71503,22,4485,761,265,152,77188
2015-08-06,74537,24,4818,947,300,151,80777
2015-08-07,106009,24,4484,1054,272,145,111988
2015-08-08,149481,16,3019,1626,628,255,155025
2015-08-09,110278,15,2230,1065,475,184,114247
2015-08-10,89970,18,4711,688,311,121,95819
2015-08-11,69621,23,4413,773,238,137,75205
2015-08-12,67980,22,4864,824,200,145,74035
2015-08-13,78835,24,4728,666,194,146,84593
2015-08-14,106820,21,4018,815,195,135,112004
2015-08-15,132275,18,2107,1267,171,240,136078
2015-08-16,101289,18,2110,1015,110,149,104691
2015-08-17,83100,21,5120,713,112,110,89176
2015-08-18,62597,19,5003,600,167,117,68503
2015-08-19,63514,21,4855,745,60,123,69318
2015-08-20,77020,21,4505,858,141,153,82698
2015-08-21,92806,22,4007,737,92,149,97813
2015-08-22,116262,18,2136,1464,156,227,120263
2015-08-23,88421,14,2468,1014,137,167,92221
2015-08-24,69267,22,5479,882,86,110,75846
2015-08-25,56370,21,5402,645,85,127,62650
2015-08-26,56107,18,5483,814,157,135,62714
2015-08-27,65161,23,4837,769,109,156,71055
2015-08-28,85330,23,4687,821,148,121,91130
2015-08-29,101033,18,2725,1146,173,243,105338
2015-08-30,82364,17,2699,986,104,152,86322
2015-08-31,57557,22,5399,691,84,104,63857
2015-09-01,52744,23,5542,627,44,111,59091
2015-09-02,48029,19,6005,670,52,116,54891
2015-09-03,49164,19,5305,721,46,116,55371
2015-09-04,62167,20,4953,839,48,97,68124
2015-09-05,75065,20,2669,1213,42,184,79193
2015-09-06,58592,16,2624,779,87,141,62239
2015-09-07,46885,20,5807,659,76,96,53543
2015-09-08,40902,23,5386,608,64,111,47094
2015-09-09,42155,22,6388,724,61,126,49476
2015-09-10,45142,22,5572,643,44,104,51527
2015-09-11,60734,21,5091,832,79,85,66842
2015-09-12,62538,15,3012,1074,90,204,66933
2015-09-13,54126,17,2304,895,62,116,57520
2015-09-14,37552,21,5795,602,28,83,44081
2015-09-15,35305,22,5856,624,35,93,41935
2015-09-16,39034,22,5811,681,40,93,45681
2015-09-17,40446,19,5900,697,49,99,47210
2015-09-18,52142,4,4793,729,57,98,57823
2015-09-19,49982,4,2860,1028,66,177,54117
2015-09-20,41230,1,2217,891,56,105,44500
2015-09-21,31459,2,4676,688,38,75,36938
2015-09-22,28429,6,3940,555,28,91,33049
2015-09-23,31961,4,4404,684,25,92,37170
2015-09-24,30540,1,3589,723,31,89,34973
2015-09-25,42691,6,3882,713,44,81,47417
2015-09-26,41426,2,2998,854,41,172,45493
2015-09-27,41929,2,2181,1200,32,104,45448
2015-09-28,27919,1,5118,605,28,110,33781
2015-09-29,24896,4,5381,665,18,81,31045
2015-09-30,25977,3,5698,728,18,75,32499
2015-10-01,31265,4,5029,737,26,78,37139
2015-10-02,39250,5,4630,673,39,71,44668
2015-10-03,40656,4,3083,855,29,140,44767
2015-10-04,34383,6,1871,827,30,87,37204
2015-10-05,26885,13,5240,657,32,57,32884
2015-10-06,24368,12,5671,586,30,57,30724
2015-10-07,25951,12,5602,605,25,58,32253
2015-10-08,31258,12,4774,621,24,59,36748
2015-10-09,37804,12,5025,675,32,62,43610
2015-10-10,33721,9,2638,836,19,100,37323
2015-10-11,32570,8,2342,772,25,65,35782
2015-10-12,26753,13,5418,516,23,52,32775
2015-10-13,23949,16,5099,452,22,58,29596
2015-10-14,24155,14,5193,512,19,57,29950
2015-10-15,27720,16,5367,568,19,59,33749
2015-10-16,37862,15,4571,538,21,47,43054
2015-10-17,35022,4,2505,796,28,101,38456
2015-10-18,32229,4,2181,758,17,63,35252
2015-10-19,24737,4,5345,518,22,58,30684
2015-10-20,23970,4,5593,438,17,52,30074
2015-10-21,23814,5,4865,522,29,58,29293
2015-10-22,31089,7,5815,601,14,60,37586
2015-10-23,45507,5,4010,590,30,52,50194
2015-10-24,41199,4,2839,666,20,102,44830
2015-10-25,35254,4,2263,649,19,41,38230
2015-10-26,31717,5,5143,458,17,33,37373
2015-10-27,26408,7,5754,385,23,34,32611
2015-10-28,27068,6,5715,437,17,28,33271
2015-10-29,29936,5,5434,451,16,36,35878
2015-10-30,42857,9,4968,440,15,37,48326
2015-10-31,41752,8,2590,538,15,46,44949
2015-11-01,36324,10,2557,420,4,40,39355
2015-11-02,27087,12,5274,354,15,32,32774
2015-11-03,25295,12,5683,378,12,28,31408
2015-11-04,24529,13,5887,426,18,29,30902
2015-11-05,26913,11,5474,454,13,27,32892
2015-11-06,36717,11,5124,469,11,32,42364
2015-11-07,34327,9,3052,528,16,28,37960
2015-11-08,33680,10,2747,448,16,29,36930
2015-11-09,23098,12,5439,310,11,28,28898
2015-11-10,23153,13,5574,328,12,32,29112
2015-11-11,24539,13,5577,443,13,23,30608
2015-11-12,25173,14,5554,455,9,28,31233
2015-11-13,31953,9,4497,406,12,25,36902
2015-11-14,31834,12,2727,543,17,25,35158
2015-11-15,29161,8,2143,483,11,27,31833
2015-11-16,21884,11,5580,286,11,24,27796
2015-11-17,28879,15,5611,298,12,22,34837
2015-11-18,23121,13,5367,426,16,26,28969
2015-11-19,25078,12,5654,376,11,23,31154
2015-11-20,32655,12,4899,380,18,21,37985
2015-11-21,26624,8,2833,442,5,14,29926
2015-11-22,26961,8,2340,417,8,22,29756
2015-11-23,22674,12,5259,281,5,20,28251
2015-11-24,20660,13,5506,268,7,22,26476
2015-11-25,23638,13,5519,379,15,21,29585
2015-11-26,22988,12,5033,358,9,23,28423
2015-11-27,30382,14,4932,397,9,21,35755
2015-11-28,27264,8,2895,470,9,16,30662
2015-11-29,26132,9,2274,390,8,31,28844
2015-11-30,22868,14,5304,320,9,23,28538
2015-12-01,21384,14,5779,274,4,24,27479
2015-12-02,22697,13,5649,368,15,23,28765
2015-12-03,22499,13,5456,358,13,24,28363
2015-12-04,34305,11,5156,402,6,27,39907
2015-12-05,29549,9,2344,535,17,19,32473
2015-12-06,25913,9,2475,446,6,24,28873
2015-12-07,21291,13,5199,281,7,25,26816
2015-12-08,24473,15,4948,307,7,25,29775
2015-12-09,23997,12,5430,389,3,25,29856
2015-12-10,22965,12,5520,381,8,23,28909
2015-12-11,29608,14,4988,350,10,22,34992
2015-12-12,27947,8,2766,484,13,16,31234
2015-12-13,27797,8,2180,443,7,22,30457
2015-12-14,22715,16,5535,271,8,21,28566
2015-12-15,22057,19,6224,284,7,22,28613
2015-12-16,25119,17,5437,407,10,24,31014
2015-12-17,28336,15,5190,432,8,23,34004
2015-12-18,37175,17,5141,404,16,20,42773
2015-12-19,48538,10,2669,582,8,15,51822
2015-12-20,33770,9,2315,556,5,23,36678
2015-12-21,31311,16,5421,317,12,24,37101
2015-12-22,34651,20,5086,374,3,19,40153
2015-12-23,51352,17,4069,513,8,23,55982
2015-12-24,49839,11,1849,506,8,16,52229
2015-12-25,31513,11,696,272,6,10,32508
2015-12-26,31988,10,697,387,5,21,33108
2015-12-27,34656,12,1965,464,6,23,37126
2015-12-28,31798,13,2972,369,14,21,35187
2015-12-29,32391,18,2855,535,12,24,35835
2015-12-30,42254,15,2206,735,4,18,45232
2015-12-31,29864,17,926,324,7,13,31151
2016-01-01,22264,9,464,289,7,10,23043
2016-01-02,40313,10,871,465,7,18,41684
2016-01-03,33791,10,1470,707,4,27,36009
2016-01-04,26181,16,2397,291,4,21,28910
2016-01-05,28849,11,2665,338,8,22,31893
2016-01-06,25727,15,2518,389,2,23,28674
2016-01-07,23695,14,2932,420,8,16,27085
2016-01-08,33902,17,2570,359,9,20,36877
2016-01-09,41142,9,1893,475,3,16,43538
2016-01-10,35224,11,2031,493,4,21,37784
2016-01-11,23655,14,4265,302,8,22,28266
2016-01-12,20968,18,4774,277,8,17,26062
2016-01-13,21946,16,4565,337,8,28,26900
2016-01-14,21490,17,4685,369,9,17,26587
2016-01-15,27228,16,4263,344,11,23,31885
2016-01-16,27550,11,2383,448,12,11,30415
2016-01-17,24490,10,2009,383,4,21,26917
2016-01-18,21345,16,4467,248,6,21,26103
2016-01-19,21580,15,4722,279,7,17,26620
2016-01-20,21830,16,4964,340,11,22,27183
2016-01-21,22291,12,4230,355,8,20,26916
2016-01-22,26723,16,4597,333,13,22,31704
2016-01-23,26295,11,2677,415,5,10,29413
2016-01-24,24778,12,2374,397,4,27,27592
2016-01-25,21506,14,4517,267,5,23,26332
2016-01-26,19543,15,4614,273,7,20,24472
2016-01-27,20637,16,5502,342,16,27,26540
2016-01-28,21969,15,5196,330,9,18,27537
2016-01-29,29618,14,4448,370,9,25,34484
2016-01-30,27663,12,2428,463,6,13,30585
2016-01-31,24668,12,2220,444,8,14,27366
2016-02-01,21394,15,5348,242,7,18,27024
2016-02-02,21517,10,5021,261,4,25,26838
2016-02-03,21004,16,4816,341,10,23,26210
2016-02-04,23142,15,4900,356,7,19,28439
2016-02-05,31720,12,4479,316,18,26,36571
2016-02-06,29843,9,2754,418,11,18,33053
2016-02-07,24507,12,2227,448,7,23,27224
2016-02-08,24910,9,3933,293,7,22,29174
2016-02-09,21667,16,5705,301,6,21,27716
2016-02-10,20596,10,4945,371,9,22,25953
2016-02-11,23917,14,4874,366,11,22,29204
2016-02-12,31436,14,4433,380,9,23,36295
2016-02-13,30369,10,2775,447,4,17,33622
2016-02-14,26708,9,2175,430,5,23,29350
2016-02-15,23375,13,4596,259,9,22,28274
2016-02-16,23061,13,4962,305,7,22,28370
2016-02-17,21986,15,5143,330,4,26,27504
2016-02-18,23736,13,5294,369,10,25,29447
2016-02-19,30591,13,4766,332,9,25,35736
2016-02-20,30527,10,3043,425,5,20,34030
2016-02-21,29472,12,2315,366,3,27,32195
2016-02-22,22288,11,4957,295,10,27,27588
2016-02-23,22006,13,5369,322,9,23,27742
2016-02-24,23072,10,5871,380,3,25,29361
2016-02-25,23988,14,5379,347,12,29,29769
2016-02-26,30117,11,4720,364,10,23,35245
2016-02-27,27951,9,2344,418,8,20,30750
2016-02-28,27286,12,2505,433,4,23,30263
2016-02-29,23083,13,4711,259,7,25,28098
2016-03-01,24127,12,5323,279,8,22,29771
2016-03-02,23503,13,5731,489,9,25,29770
2016-03-03,24045,15,5577,419,11,24,30091
2016-03-04,28798,10,5004,430,10,29,34281
2016-03-05,28323,7,2650,486,2,22,31490
2016-03-06,28377,9,2233,506,12,24,31161
2016-03-07,22727,13,5240,299,8,23,28310
2016-03-08,21817,13,5518,354,9,21,27732
2016-03-09,23310,12,5673,436,7,23,29461
2016-03-10,25625,14,5735,426,14,23,31837
2016-03-11,33655,10,5011,435,9,24,39144
2016-03-12,30541,11,3071,539,16,19,34197
2016-03-13,28863,7,2382,501,3,24,31780
2016-03-14,23420,11,5395,328,6,31,29191
2016-03-15,22421,16,5425,296,12,24,28194
2016-03-16,24115,13,6080,426,7,24,30665
2016-03-17,26884,12,5837,442,15,28,33218
2016-03-18,40172,14,5354,414,14,32,46000
2016-03-19,45504,11,3108,606,20,28,49277
2016-03-20,36127,9,2642,538,19,35,39370
2016-03-21,28060,11,5586,350,18,27,34052
2016-03-22,28082,18,5891,357,12,25,34385
2016-03-23,31726,16,6090,456,5,31,38324
2016-03-24,47093,14,5352,514,14,34,53021
2016-03-25,65155,10,3809,582,17,33,69606
2016-03-26,38890,10,1478,470,38,30,40916
2016-03-27,34952,10,1248,388,19,39,36656
2016-03-28,44261,9,2948,508,11,35,47772
2016-03-29,33816,16,5976,430,23,42,40303
2016-03-30,27204,17,5766,431,12,37,33467
2016-03-31,29368,14,6474,427,12,34,36329
2016-04-01,39118,12,5122,451,21,40,44764
2016-04-02,39574,9,2871,575,22,61,43112
2016-04-03,34992,10,2168,576,24,48,37818
2016-04-04,26094,14,5874,411,12,38,32443
2016-04-05,23901,13,5766,365,22,41,30108
2016-04-06,24437,12,5705,470,20,37,30681
2016-04-07,27062,15,5569,483,20,42,33191
2016-04-08,37587,14,5356,444,13,35,43449
2016-04-09,33951,11,3081,572,16,54,37685
2016-04-10,32566,8,2486,542,31,50,35683
2016-04-11,25447,15,5962,458,18,49,31949
2016-04-12,25390,15,6653,366,25,42,32491
2016-04-13,25461,12,6315,425,19,43,32275
2016-04-14,27645,14,5807,475,15,41,33997
2016-04-15,40994,16,5557,528,34,46,47175
2016-04-16,40195,10,3331,515,22,67,44140
2016-04-17,34776,11,2609,587,20,64,38067
2016-04-18,26188,14,5645,424,28,41,32340
2016-04-19,2579,3,594,8,5,0,3189
2016-04-20,26090,15,5177,432,16,22,31752
2016-04-21,28457,12,5582,466,30,55,34602
2016-04-22,42983,9,4768,609,34,47,48450
2016-04-23,38427,9,2628,757,43,52,41916
2016-04-24,34052,12,2403,633,25,59,37184
2016-04-25,32059,13,6321,541,24,48,39006
2016-04-26,35003,10,6417,490,17,47,41984
2016-04-27,40627,13,4621,538,26,44,45869
2016-04-28,43698,14,6102,656,32,56,50558
2016-04-29,63641,13,4549,659,44,60,68966
2016-04-30,57864,9,2517,774,55,87,61306
2016-05-01,35986,11,1399,651,70,84,38201
2016-05-02,42976,12,3470,540,27,56,47081
2016-05-03,35723,14,5233,517,33,74,41594
2016-05-04,40781,11,4901,701,35,69,46498
2016-05-05,49577,15,5615,701,51,111,56070
2016-05-06,45510,15,4924,543,73,98,51163
2016-05-07,48260,12,2880,640,76,130,51998
2016-05-08,49835,8,2434,770,50,108,53205
2016-05-09,30732,13,6215,500,41,61,37562
2016-05-10,28054,14,6164,455,28,67,34782
2016-05-11,28630,15,6597,541,22,71,35876
2016-05-12,32352,17,5649,565,26,84,38693
2016-05-13,52276,14,5823,649,32,67,58861
2016-05-14,52526,9,3176,749,52,126,56638
2016-05-15,42704,11,2383,636,57,108,45899
2016-05-16,39040,13,4949,618,71,81,44772
2016-05-17,30763,16,6040,564,44,78,37505
2016-05-18,31492,14,6574,652,54,89,38875
2016-05-19,33446,14,5838,571,30,80,39979
2016-05-20,50813,15,5339,734,91,76,57068
2016-05-21,51832,11,3335,837,99,175,56289
2016-05-22,47519,14,2551,1501,66,111,51762
2016-05-23,32144,15,6226,509,40,74,39008
2016-05-24,30120,14,5907,499,46,83,36669
2016-05-25,49474,15,6313,673,71,110,56656
2016-05-26,58120,16,4779,830,115,161,64021
2016-05-27,53559,16,5344,636,87,96,59738
2016-05-28,55853,9,2767,813,109,174,59725
2016-05-29,50462,13,2469,844,48,130,53966
2016-05-30,33930,18,5935,611,42,82,40618
2016-05-31,31298,17,6114,528,62,99,38118
2016-06-01,37842,14,6373,591,66,94,44980
2016-06-02,44043,16,5408,666,182,104,50419
2016-06-03,51600,17,5310,690,129,82,57828
2016-06-04,51329,11,3198,917,71,175,55701
2016-06-05,44553,10,2392,802,66,120,47943
2016-06-06,35073,17,5778,598,57,78,41601
2016-06-07,31366,16,5929,442,87,91,37931
2016-06-08,33514,15,6582,531,74,109,40825
2016-06-09,35762,17,5764,591,30,117,42281
2016-06-10,50680,15,5827,667,80,56,57325
2016-06-11,54018,11,3200,949,50,167,58395
2016-06-12,43431,14,2548,662,60,120,46835
2016-06-13,36407,11,5806,508,80,74,42886
2016-06-14,32409,15,6233,518,67,103,39345
2016-06-15,36135,14,6177,547,52,119,43044
2016-06-16,43346,17,6666,608,31,110,50778
2016-06-17,62175,13,5314,703,51,96,68352
2016-06-18,70999,12,2825,1134,207,206,75383
2016-06-19,54588,13,2592,810,79,132,58214
2016-06-20,42177,13,5735,585,83,95,48688
2016-06-21,35560,12,5619,600,133,114,42038
2016-06-22,39848,16,5240,649,88,127,45968
2016-06-23,47366,15,6418,681,128,146,54754
2016-06-24,70465,15,5896,696,167,101,77340
2016-06-25,82587,13,2068,1282,260,215,86425
2016-06-26,63491,13,2558,959,126,142,67289
2016-06-27,46595,18,6059,613,76,113,53474
2016-06-28,41131,18,6606,605,119,105,48584
2016-06-29,43018,13,6479,723,114,147,50494
2016-06-30,53270,18,6374,725,149,159,60695
2016-07-01,80423,17,5580,839,243,147,87249
2016-07-02,100213,13,2967,1299,300,191,104983
2016-07-03,71859,13,2630,986,96,167,75751
2016-07-04,56265,15,6011,641,163,148,63243
2016-07-05,48326,16,5714,680,182,143,55061
2016-07-06,51008,17,6223,703,134,160,58245
2016-07-07,57234,18,6176,685,141,161,64415
2016-07-08,84347,18,5778,762,215,104,91224
2016-07-09,110501,12,3026,1488,375,249,115651
2016-07-10,92240,12,2634,988,223,132,96229
2016-07-11,67553,14,5786,627,171,132,74283
2016-07-12,50770,22,5306,598,121,148,56965
2016-07-13,53389,18,6619,804,87,172,61089
2016-07-14,65078,19,5956,743,75,169,72040
2016-07-15,87391,17,5259,737,57,130,93591
2016-07-16,115160,13,2520,1152,272,249,119366
2016-07-17,84670,14,2950,1060,273,182,89149
2016-07-18,73590,16,6153,516,332,73,80680
2016-07-19,59832,16,6215,579,183,158,66983
2016-07-20,63005,20,6368,739,157,110,70399
2016-07-21,71510,16,6468,742,165,176,79077
2016-07-22,98682,16,5365,779,218,118,105178
2016-07-23,127464,13,2283,1206,320,239,131525
2016-07-24,95129,14,2621,960,241,158,99123
2016-07-25,79043,18,6148,745,199,144,86297
2016-07-26,61316,19,6152,566,164,161,68378
2016-07-27,60253,18,5714,749,141,169,67044
2016-07-28,72724,18,5922,831,172,172,79839
2016-07-29,108939,18,4811,709,314,147,114938
2016-07-30,146788,12,2598,1231,465,198,151292
2016-07-31,113387,13,2529,869,384,180,117362
2016-08-01,99455,19,5456,766,172,144,106012
2016-08-02,68344,17,5652,649,221,130,75013
2016-08-03,70860,17,5522,658,293,182,77532
2016-08-04,79459,15,5283,675,330,169,85931
2016-08-05,109891,17,4171,758,244,148,115229
2016-08-06,139291,10,2759,1258,225,249,143792
2016-08-07,112821,15,2669,886,206,204,116801
2016-08-08,87597,17,5852,528,525,155,94674
2016-08-09,70624,20,5024,627,429,160,76884
2016-08-10,75142,15,6075,872,195,178,82477
2016-08-11,93805,19,5286,656,123,170,100059
2016-08-12,110861,17,4475,747,208,145,116453
2016-08-13,140406,15,1888,1042,408,276,144035
2016-08-14,107897,14,1211,1036,334,176,110668
2016-08-15,95521,14,2443,565,219,136,98898
2016-08-16,77305,16,5833,661,200,153,84168
2016-08-17,67670,18,5346,735,133,162,74064
2016-08-18,78961,20,5048,765,108,164,85066
2016-08-19,90736,20,4613,963,133,141,96606
2016-08-20,124243,13,2372,1649,172,250,128699
2016-08-21,98635,15,1833,1075,141,191,101890
2016-08-22,78889,16,5412,820,114,127,85378
2016-08-23,64474,17,5258,709,108,141,70707
2016-08-24,64775,19,5493,781,85,163,71316
2016-08-25,75664,18,5762,744,116,124,82428
2016-08-26,93608,17,5084,901,137,147,99894
2016-08-27,108092,12,2742,1275,182,238,112541
2016-08-28,89612,12,2035,933,125,164,92881
2016-08-29,67010,17,5629,678,94,117,73545
2016-08-30,58385,17,5977,638,74,141,65232
2016-08-31,55524,17,5375,747,65,164,61892
2016-09-01,62199,19,5714,682,94,152,68860
2016-09-02,77759,21,5604,706,104,109,84303
2016-09-03,90839,14,3103,1283,144,224,95607
2016-09-04,76118,14,2312,872,94,153,79563
2016-09-05,54492,14,5204,637,56,97,60500
2016-09-06,45048,19,5705,597,53,112,51534
2016-09-07,48526,18,5839,664,35,127,55209
2016-09-08,49687,21,5648,625,78,139,56198
2016-09-09,70587,14,5321,780,98,104,76904
2016-09-10,76526,15,3312,1302,126,217,81498
2016-09-11,61520,14,2444,884,97,158,65117
2016-09-12,49213,16,5680,561,65,127,55662
2016-09-13,42374,15,6147,552,60,101,49249
2016-09-14,44198,16,6122,655,41,91,51123
2016-09-15,44224,17,6557,716,53,119,51686
2016-09-16,57576,15,5269,771,46,108,63785
2016-09-17,55619,10,3079,1028,30,184,59950
2016-09-18,50187,13,2519,922,44,140,53825
2016-09-19,41465,16,5461,633,37,95,47707
2016-09-20,35234,18,6330,604,57,92,42335
2016-09-21,36875,16,6482,656,41,98,44168
2016-09-22,40610,18,6214,708,58,156,47764
2016-09-23,48317,13,4973,704,67,94,54168
2016-09-24,59283,15,4317,1078,74,187,64954
2016-09-25,48116,12,2159,891,56,96,51330
2016-09-26,33964,14,6372,580,42,91,41063
2016-09-27,34722,17,6790,606,40,93,42268
2016-09-28,34723,17,6375,687,43,104,41949
2016-09-29,38073,15,6348,655,43,117,45251
2016-09-30,52925,16,6235,699,41,90,60006
2016-10-01,49899,11,6645,925,45,108,57633
2016-10-02,40138,11,2385,728,45,112,43419
2016-10-03,35852,13,6091,621,37,81,42695
2016-10-04,28532,14,6376,579,28,71,35600
2016-10-05,30958,15,6388,660,24,77,38122
2016-10-06,31879,18,6173,611,40,80,38801
2016-10-07,43057,15,5348,668,29,69,49186
2016-10-08,41642,12,3084,880,25,129,45772
2016-10-09,37496,11,2768,766,46,98,41185
2016-10-10,27345,10,6201,439,29,72,34096
2016-10-11,26523,13,5920,499,29,65,33049
2016-10-12,27450,13,6444,539,25,67,34538
2016-10-13,31918,12,6932,608,26,85,39581
2016-10-14,38589,15,5525,566,24,56,44775
2016-10-15,38355,10,3432,766,17,98,42678
2016-10-16,37400,11,3076,764,20,85,41356
2016-10-17,27992,15,5826,500,34,69,34436
2016-10-18,25007,18,6299,458,18,60,31860
2016-10-19,27505,14,6085,542,22,59,34227
2016-10-20,29610,16,6039,584,21,76,36346
2016-10-21,40622,13,5776,618,24,42,47095
2016-10-22,38835,14,3196,733,20,101,42899
2016-10-23,34319,10,2617,715,20,64,37745
2016-10-24,26357,18,6504,454,16,60,33409
2016-10-25,26029,14,5944,355,14,41,32397
2016-10-26,30513,16,5717,528,20,42,36836
2016-10-27,31159,14,6181,496,12,42,37904
2016-10-28,56336,11,6602,553,17,50,63569
2016-10-29,58289,9,3558,717,55,77,62705
2016-10-30,43219,13,2413,529,28,16,46218
2016-10-31,40555,13,3183,363,12,36,44162
2016-11-01,44167,14,3281,447,19,19,47947
2016-11-02,32527,15,7448,503,16,19,40528
2016-11-03,28878,19,6062,412,24,10,35405
2016-11-04,35602,16,5756,497,20,26,41917
2016-11-05,32949,14,3819,502,8,11,37303
2016-11-06,29441,12,2618,545,14,10,32640
2016-11-07,24093,17,5606,306,18,14,30054
2016-11-08,23492,17,5946,350,15,13,29833
2016-11-09,25607,17,5960,487,11,9,32091
2016-11-10,27307,15,5934,455,11,8,33730
2016-11-11,34241,16,4640,465,14,3,39379
2016-11-12,29343,14,2738,645,6,20,32766
2016-11-13,29069,13,2461,532,6,27,32108
2016-11-14,23547,491,5934,306,17,7,30302
2016-11-15,22827,18,6030,304,15,25,29219
2016-11-16,23945,15,6601,432,18,23,31034
2016-11-17,26268,17,5862,434,16,26,32623
2016-11-18,33829,13,4868,424,14,2,39150
2016-11-19,28690,11,3280,468,7,12,32468
2016-11-20,28107,12,2803,427,7,21,31377
2016-11-21,25543,16,5905,343,6,19,31832
2016-11-22,22346,17,7846,319,8,25,30561
2016-11-23,25287,16,6781,508,15,21,32628
2016-11-24,26010,17,5929,464,18,20,32458
2016-11-25,35488,16,5398,470,5,23,41400
2016-11-26,30461,9,3255,499,12,14,34250
2016-11-27,28813,12,2520,521,10,25,31901
2016-11-28,23193,15,5549,336,8,23,29124
2016-11-29,21384,18,6245,335,5,20,28007
2016-11-30,21937,14,6425,421,15,22,28834
2016-12-01,24599,17,6206,384,16,23,31245
2016-12-02,30881,13,5007,424,9,23,36357
2016-12-03,28988,13,2737,585,5,16,32344
2016-12-04,26417,12,2767,512,9,23,29740
2016-12-05,22666,16,5620,302,9,19,28632
2016-12-06,25714,15,5848,309,9,26,31921
2016-12-07,26978,15,6087,410,8,22,33520
2016-12-08,29428,19,5866,399,17,23,35752
2016-12-09,32942,14,5131,407,15,21,38530
2016-12-10,29601,8,3205,666,8,16,33504
2016-12-11,30462,10,2669,533,9,23,33706
2016-12-12,23230,13,6301,343,13,20,29920
2016-12-13,22017,12,6345,304,11,22,28711
2016-12-14,24044,13,6487,394,6,19,30963
2016-12-15,25345,11,6435,413,15,25,32244
2016-12-16,34458,14,5524,446,11,21,40474
2016-12-17,36024,9,3015,828,8,33,39917
2016-12-18,29903,8,3155,557,3,24,33650
2016-12-19,25684,13,5497,322,4,22,31542
2016-12-20,27365,12,6496,380,14,24,34291
2016-12-21,31960,16,6003,457,13,22,38471
2016-12-22,43408,12,5017,536,16,27,49016
2016-12-23,64937,13,4420,545,12,22,69949
2016-12-24,53036,11,2018,923,9,16,56013
2016-12-25,27587,9,571,365,1,7,28540
2016-12-26,33678,9,2399,387,11,16,36500
2016-12-27,33609,16,3608,337,10,4,37584
2016-12-28,33995,16,3820,554,9,14,38408
2016-12-29,37236,20,3491,686,14,26,41473
2016-12-30,46591,16,2011,675,1,23,49317
2016-12-31,29186,11,729,380,14,13,30333
2017-01-01,27087,14,625,429,7,17,28179
2017-01-02,38666,11,2337,442,17,24,41497
2017-01-03,29853,13,2702,406,1,23,32998
2017-01-04,30781,15,3200,497,8,20,34521
2017-01-05,34813,15,3472,443,9,16,38768
2017-01-06,34576,14,1276,347,2,17,36232
2017-01-07,36733,8,1411,917,7,9,39085
2017-01-08,39855,10,1846,627,4,19,42361
2017-01-09,29805,17,3410,420,5,24,33681
2017-01-10,24419,15,4158,324,4,24,28944
2017-01-11,21807,11,4330,371,11,22,26552
2017-01-12,23698,17,4465,397,14,18,28609
2017-01-13,25067,14,3844,340,3,16,29284
2017-01-14,27374,12,2715,461,7,10,30579
2017-01-15,24471,6,2400,466,3,22,27368
2017-01-16,20417,17,4792,302,7,19,25554
2017-01-17,17698,12,3940,329,1,21,22001
2017-01-18,18166,15,4431,338,4,18,22972
2017-01-19,21671,12,4277,377,7,23,26367
2017-01-20,27074,12,4598,329,13,25,32051
2017-01-21,26219,11,2701,425,14,11,29381
2017-01-22,25795,11,2514,406,6,25,28757
2017-01-23,20873,9,4917,264,8,24,26095
2017-01-24,19518,13,5394,312,3,20,25260
2017-01-25,20895,14,5767,392,11,21,27100
2017-01-26,21760,14,5224,367,6,21,27392
2017-01-27,28914,12,4960,356,15,18,34275
2017-01-28,25748,7,2755,462,16,11,28999
2017-01-29,24434,8,2802,428,9,21,27702
2017-01-30,20366,12,4925,258,2,15,25578
2017-01-31,20685,13,5479,326,8,21,26532
2017-02-01,19264,13,5518,422,8,20,25245
2017-02-02,22486,13,5548,364,13,19,28443
2017-02-03,30474,13,4661,321,10,15,35494
2017-02-04,26881,8,2776,417,5,11,30098
2017-02-05,25413,10,2573,384,11,20,28411
2017-02-06,21678,14,5212,248,3,16,27171
2017-02-07,21778,12,5519,296,7,22,27634
2017-02-08,23619,12,4700,365,6,17,28719
2017-02-09,24080,13,6067,380,14,17,30571
2017-02-10,31619,13,5349,376,4,20,37381
2017-02-11,29299,10,2820,435,13,12,32589
2017-02-12,28422,8,3059,458,5,22,31974
2017-02-13,24154,14,5354,290,14,21,29847
2017-02-14,24053,13,5690,331,7,20,30114
2017-02-15,25846,10,5784,387,10,22,32059
2017-02-16,25874,12,5167,378,7,19,31457
2017-02-17,35909,13,4991,396,5,20,41334
2017-02-18,32364,10,3085,480,11,22,35972
2017-02-19,32726,10,2579,456,3,23,35797
2017-02-20,24563,11,5439,274,9,20,30316
2017-02-21,23422,14,5870,321,7,21,29655
2017-02-22,24287,11,6464,419,5,20,31206
2017-02-23,26540,14,6485,399,14,24,33476
2017-02-24,34525,11,5382,351,8,18,40295
2017-02-25,32387,9,3056,461,13,16,35942
2017-02-26,33118,8,2836,525,9,28,36524
2017-02-27,25928,9,6150,324,13,24,32448
2017-02-28,23422,9,6080,307,14,22,29854
2017-03-01,26270,13,6402,428,10,21,33144
2017-03-02,26763,12,6145,418,5,26,33369
2017-03-03,35857,10,5215,410,14,27,41533
2017-03-04,32276,7,3052,449,10,16,35810
2017-03-05,30044,10,2471,513,9,22,33069
2017-03-06,23845,11,5705,303,13,23,29900
2017-03-07,22760,11,6267,330,10,21,29399
2017-03-08,24314,11,6275,432,9,25,31066
2017-03-09,26039,9,6041,456,11,20,32576
2017-03-10,36461,12,5493,447,15,24,42452
2017-03-11,33214,10,3294,501,11,21,37051
2017-03-12,33724,6,2641,581,5,27,36984
2017-03-13,24388,13,5914,380,16,23,30734
2017-03-14,23378,11,6403,365,10,23,30190
2017-03-15,25273,11,5852,383,14,20,31553
2017-03-16,26923,12,6061,479,13,24,33512
2017-03-17,38691,13,6113,469,18,23,45327
2017-03-18,34822,10,3245,522,13,20,38632
2017-03-19,34376,11,2683,538,13,27,37648
2017-03-20,25261,15,6208,364,9,24,31881
2017-03-21,23814,13,6726,350,8,25,30936
2017-03-22,24811,12,6586,458,12,20,31899
2017-03-23,27855,12,6593,470,12,35,34977
2017-03-24,36183,12,5735,460,19,26,42435
2017-03-25,35599,7,3338,539,21,20,39524
2017-03-26,31039,8,2692,543,5,10,34297
2017-03-27,25257,13,6019,361,8,54,31712
2017-03-28,23702,12,6585,363,11,44,30717
2017-03-29,25300,12,6874,467,19,20,32692
2017-03-30,29102,12,6518,504,17,20,36173
2017-03-31,39382,14,6334,440,33,19,46222
2017-04-01,39996,11,3776,646,27,54,44510
2017-04-02,34995,12,2857,589,21,12,38486
2017-04-03,26580,13,6392,496,19,15,33515
2017-04-04,25099,14,7099,367,23,21,32623
2017-04-05,26337,11,6928,508,28,45,33857
2017-04-06,30384,14,6915,539,21,52,37925
2017-04-07,45649,12,5263,668,29,49,51670
2017-04-08,51710,10,3700,771,32,86,56309
2017-04-09,38784,9,3036,760,34,63,42686
2017-04-10,30606,12,6060,546,33,56,37313
2017-04-11,29898,13,7296,481,34,45,37767
2017-04-12,37741,13,6956,622,26,62,45420
2017-04-13,54240,10,6360,667,41,68,61386
2017-04-14,73586,11,3125,810,37,59,77628
2017-04-15,39692,10,1824,525,54,77,42182
2017-04-16,35565,9,694,502,46,42,36858
2017-04-17,48689,7,3022,674,24,32,52448
2017-04-18,38714,14,6018,623,25,68,45462
2017-04-19,30762,15,7146,569,21,65,38578
2017-04-20,31441,12,6630,615,20,32,38750
2017-04-21,45474,14,6280,624,35,22,52449
2017-04-22,50925,10,3434,983,95,97,55544
2017-04-23,37582,12,3048,860,61,49,41612
2017-04-24,31398,12,6659,612,37,56,38774
2017-04-25,31369,13,6689,597,30,64,38762
2017-04-26,40068,16,7220,684,15,63,48066
2017-04-27,45970,12,5697,669,15,69,52432
2017-04-28,63685,13,5854,836,37,41,70466
2017-04-29,73063,8,2585,1235,102,119,77112
2017-04-30,49342,13,1259,857,142,105,51718
2017-05-01,42633,13,2406,805,59,52,45968
2017-05-02,41207,11,4176,684,34,63,46175
2017-05-03,33690,14,6274,770,42,82,40872
2017-05-04,33561,14,5439,710,32,36,39792
2017-05-05,40942,13,4999,699,43,28,46724
2017-05-06,42675,13,2948,795,35,119,46585
2017-05-07,36038,9,2686,789,32,75,39629
2017-05-08,31378,12,5579,564,26,36,37595
2017-05-09,28331,11,6957,561,33,41,35934
2017-05-10,29742,13,6683,598,46,66,37148
2017-05-11,31105,11,5970,687,34,71,37878
2017-05-12,41260,9,5675,646,40,22,47652
2017-05-13,40064,11,3130,799,50,89,44143
2017-05-14,37668,13,3051,723,60,109,41624
2017-05-15,30187,15,6691,690,34,47,37664
2017-05-16,29150,13,6880,645,50,51,36789
2017-05-17,29730,10,6914,710,35,40,37439
2017-05-18,34057,17,5705,713,54,107,40653
2017-05-19,49122,14,5035,758,58,69,55056
2017-05-20,45221,14,2823,915,38,160,49171
2017-05-21,42350,11,2775,928,68,62,46194
2017-05-22,31954,16,5667,618,56,59,38370
2017-05-23,31766,13,6679,672,38,85,39253
2017-05-24,46245,13,6593,896,55,55,53857
2017-05-25,58890,12,6183,838,68,102,66093
2017-05-26,55199,15,5358,691,86,88,61437
2017-05-27,49654,9,2354,1006,100,187,53310
2017-05-28,50763,10,2657,982,59,134,54605
2017-05-29,33313,15,6673,705,58,49,40813
2017-05-30,30938,16,6104,614,60,66,37798
2017-05-31,35841,14,6788,812,81,93,43629
2017-06-01,51324,14,5498,770,198,95,57899
2017-06-02,76035,15,4700,912,570,105,82337
2017-06-03,77900,13,2672,957,131,153,81826
2017-06-04,55670,10,2409,866,88,119,59162
2017-06-05,47139,13,5799,682,61,80,53774
2017-06-06,35211,14,7297,653,47,109,43331
2017-06-07,35589,14,7247,666,60,105,43681
2017-06-08,39670,16,6258,650,83,54,46731
2017-06-09,58349,13,5285,739,127,80,64593
2017-06-10,67510,9,3589,1113,132,220,72573
2017-06-11,54183,13,2924,785,127,94,58126
2017-06-12,41054,12,6426,612,65,76,48245
2017-06-13,35844,15,6435,634,79,75,43082
2017-06-14,51983,13,6631,763,73,116,59579
2017-06-15,64780,14,5050,867,118,143,70972
2017-06-16,64749,15,5816,756,146,63,71545
2017-06-17,64559,13,2480,1018,99,129,68298
2017-06-18,63558,10,2707,908,91,154,67428
2017-06-19,45848,15,7029,663,90,92,53737
2017-06-20,41231,15,6487,687,87,128,48635
2017-06-21,40506,14,6637,769,94,122,48142
2017-06-22,46748,10,5396,773,119,138,53184
2017-06-23,75321,16,4784,837,133,103,81194
2017-06-24,88859,9,2377,1496,209,210,93160
2017-06-25,66950,12,2677,955,79,155,70828
2017-06-26,59291,16,6409,746,127,95,66684
2017-06-27,44310,21,6853,735,88,140,52147
2017-06-28,46013,17,7015,879,46,101,54071
2017-06-29,51496,16,6610,771,46,152,59091
2017-06-30,73426,14,5783,795,84,157,80259
2017-07-01,102822,14,2958,1324,186,180,107484
2017-07-02,77123,14,2739,1126,168,112,81282
2017-07-03,63990,14,7159,684,170,126,72143
2017-07-04,50598,14,6462,651,145,155,58025
2017-07-05,56737,17,6955,872,170,103,64854
2017-07-06,56474,14,6226,735,224,101,63774
2017-07-07,84260,16,5347,791,230,141,90785
2017-07-08,103963,12,2603,1475,269,253,108575
2017-07-09,84809,13,2890,1014,214,144,89084
2017-07-10,73438,17,6344,732,135,122,80788
2017-07-11,56640,14,7152,692,121,153,64772
2017-07-12,58185,15,6745,789,117,171,66022
2017-07-13,63414,16,6066,923,139,119,70677
2017-07-14,94425,14,5418,824,103,149,100933
2017-07-15,126551,12,2961,1065,225,168,130982
2017-07-16,98819,11,3110,1016,130,193,103279
2017-07-17,79742,19,6600,709,177,124,87371
2017-07-18,62439,14,6380,711,207,174,69925
2017-07-19,64370,17,7094,912,194,178,72765
2017-07-20,73716,16,6374,905,158,161,81330
2017-07-21,101690,17,5182,813,206,123,108031
2017-07-22,133845,8,3009,1256,281,184,138583
2017-07-23,104073,11,2824,996,211,198,108313
2017-07-24,80429,18,6359,866,111,172,87955
2017-07-25,64797,14,6059,599,121,121,71711
2017-07-26,70623,16,6486,837,112,161,78235
2017-07-27,76232,15,6371,804,167,177,83766
2017-07-28,106718,16,5923,934,258,171,114020
2017-07-29,140269,13,2945,1236,317,201,144981
2017-07-30,101911,15,2884,1050,300,198,106358
2017-07-31,91189,15,6050,779,248,155,98436
2017-08-01,78534,18,7092,755,204,179,86782
2017-08-02,72710,14,6472,733,188,195,80312
2017-08-03,80214,14,6297,748,201,116,87590
2017-08-04,110535,16,5438,1226,245,167,117627
2017-08-05,138264,12,2555,1345,628,201,143005
2017-08-06,109289,14,2561,1091,394,128,113477
2017-08-07,95907,15,11840,793,143,143,108841
2017-08-08,72400,15,5920,648,264,175,79422
2017-08-09,83820,16,6885,806,175,110,91812
2017-08-10,83922,15,5365,796,162,116,90376
2017-08-11,110230,17,4235,745,136,128,115491
2017-08-12,142437,14,2119,1218,194,262,146244
2017-08-13,107114,14,2259,1036,304,210,110937
2017-08-14,101699,18,4256,775,163,109,107020
2017-08-15,82880,11,3627,713,214,177,87622
2017-08-16,75994,18,5949,764,147,178,83050
2017-08-17,76348,18,5612,748,118,168,83012
2017-08-18,101381,16,5143,759,113,111,107523
2017-08-19,117471,11,2329,1137,108,246,121302
2017-08-20,97517,16,2415,938,75,175,101136
2017-08-21,83228,16,5860,804,146,127,90181
2017-08-22,64765,13,6754,669,101,141,72443
2017-08-23,64047,14,5828,764,131,167,70951
2017-08-24,72241,16,5979,748,102,166,79252
2017-08-25,93393,17,5769,906,126,151,100362
2017-08-26,114356,13,2925,1290,106,222,118912
2017-08-27,89068,13,2754,955,120,169,93079
2017-08-28,69311,15,6537,688,71,113,76735
2017-08-29,57097,16,6968,662,58,167,64968
2017-08-30,59545,18,7261,790,78,177,67869
2017-08-31,66042,16,5749,731,58,146,72742
2017-09-01,75734,19,5825,793,36,100,82507
2017-09-02,86392,19,3066,1103,48,228,90856
2017-09-03,79230,14,2670,1069,72,170,83225
2017-09-04,59761,20,6011,690,86,97,66665
2017-09-05,47305,17,6866,719,52,94,55053
2017-09-06,46389,17,6610,656,51,113,53836
2017-09-07,51046,16,6282,718,43,134,58239
2017-09-08,68194,21,5508,820,44,84,74671
2017-09-09,70584,14,2272,1065,47,141,74123
2017-09-10,59805,14,2881,951,26,132,63809
2017-09-11,46270,15,6237,634,34,68,53258
2017-09-12,39166,16,6368,666,27,99,46342
2017-09-13,35625,16,6400,670,55,76,42842
2017-09-14,41005,19,6459,656,44,122,48305
2017-09-15,55712,16,5246,850,41,74,61939
2017-09-16,57069,11,3287,1101,48,185,61701
2017-09-17,50064,28,2977,936,37,82,54124
2017-09-18,39560,15,6261,609,46,82,46573
2017-09-19,34362,13,6651,626,28,102,41782
2017-09-20,35635,14,6456,744,39,95,42983
2017-09-21,40636,14,6271,819,49,107,47896
2017-09-22,53840,17,5690,814,47,91,60499
2017-09-23,49628,12,3328,960,75,136,54139
2017-09-24,43221,13,2719,928,34,114,47029
2017-09-25,34169,16,6318,666,36,61,41266
2017-09-26,31775,15,6914,582,35,68,39389
2017-09-27,33780,17,6998,660,41,94,41590
2017-09-28,36899,16,6604,709,35,108,44371
2017-09-29,56131,17,6684,839,27,74,63772
2017-09-30,52267,12,3510,1057,48,140,57034
2017-10-01,46233,11,3205,895,33,135,50512
2017-10-02,33563,13,6352,600,36,60,40624
2017-10-03,30960,14,6985,695,18,85,38757
2017-10-04,29709,14,6466,728,30,46,36993
2017-10-05,33038,12,6921,671,23,52,40717
2017-10-06,42558,13,5571,679,33,43,48897
2017-10-07,44300,10,3407,1007,22,154,48900
2017-10-08,40486,13,2817,807,37,61,44221
2017-10-09,30186,9,6806,593,34,36,37664
2017-10-10,29220,10,7305,600,19,61,37215
2017-10-11,29337,13,7457,664,26,64,37561
2017-10-12,32977,12,6656,662,21,43,40371
2017-10-13,44758,14,6092,639,37,62,51602
2017-10-14,43585,6,3410,982,45,123,48151
2017-10-15,43203,8,2933,833,26,91,47094
2017-10-16,30006,15,6732,548,29,35,37365
2017-10-17,26633,11,6779,467,28,69,33987
2017-10-18,28870,11,7067,622,21,57,36648
2017-10-19,32765,13,6810,620,21,72,40301
2017-10-20,44684,16,6627,676,17,43,52063
2017-10-21,41817,6,3762,799,25,102,46511
2017-10-22,36600,9,2394,815,14,75,39907
2017-10-23,29000,14,5909,542,19,47,35531
2017-10-24,26444,15,7405,481,8,45,34398
2017-10-25,33658,13,6982,603,13,53,41322
2017-10-26,43196,13,6879,635,15,73,50811
2017-10-27,50016,14,6073,627,30,43,56803
2017-10-28,56164,10,3581,765,27,72,60619
2017-10-29,49717,8,2626,629,20,56,53056
2017-10-30,39325,15,6542,435,17,26,46360
2017-10-31,41683,11,4355,546,16,26,46637
2017-11-01,39864,12,3848,498,16,21,44259
2017-11-02,35122,13,6496,478,20,24,42153
2017-11-03,39600,16,5845,511,12,28,46012
2017-11-04,40217,8,3827,687,10,26,44775
2017-11-05,38643,10,2780,578,11,23,42045
2017-11-06,23943,15,6265,358,7,12,30600
2017-11-07,25137,10,6586,393,1,17,32144
2017-11-08,25240,17,7339,506,18,10,33130
2017-11-09,28312,12,6924,564,16,13,35841
2017-11-10,36571,12,6383,511,19,16,43512
2017-11-11,35430,8,3413,621,21,17,39510
2017-11-12,30327,9,2694,613,11,14,33668
2017-11-13,23703,13,6073,342,21,9,30161
2017-11-14,24031,16,6945,360,7,18,31377
2017-11-15,25512,16,6108,460,7,10,32113
2017-11-16,26560,12,6822,424,11,15,33844
2017-11-17,34929,11,5968,425,7,11,41351
2017-11-18,32434,8,3634,589,17,16,36698
2017-11-19,32712,6,2601,548,5,15,35887
2017-11-20,25653,10,6259,335,17,15,32289
2017-11-21,25747,12,7012,351,9,11,33142
2017-11-22,24392,11,6878,417,14,11,31723
2017-11-23,27112,12,6515,433,11,16,34099
2017-11-24,37948,13,5769,432,7,15,44184
2017-11-25,32552,6,3403,543,15,14,36533
2017-11-26,30130,5,2529,518,2,12,33196
2017-11-27,24645,12,6080,331,10,7,31085
2017-11-28,23079,12,6743,356,9,14,30213
2017-11-29,23094,12,7159,384,3,7,30659
2017-11-30,24359,8,6527,408,4,12,31318
2017-12-01,34067,9,5987,460,7,14,40544
2017-12-02,28414,4,3429,651,4,14,32516
2017-12-03,27725,5,2646,529,4,11,30920
2017-12-04,24178,11,6228,321,7,9,30754
2017-12-05,22587,11,7015,361,16,14,30004
2017-12-06,25215,13,7091,402,13,16,32750
2017-12-07,31199,10,6698,439,9,11,38366
2017-12-08,35743,15,5218,495,9,9,41489
2017-12-09,26130,6,3347,692,7,11,30193
2017-12-10,30266,7,2451,546,7,12,33289
2017-12-11,23540,13,6438,299,6,9,30305
2017-12-12,23841,13,6765,331,8,11,30969
2017-12-13,24159,14,6545,468,4,10,31200
2017-12-14,26400,14,6751,441,10,14,33630
2017-12-15,34105,15,6455,445,10,16,41046
2017-12-16,34991,10,3836,759,9,11,39616
2017-12-17,31935,8,2841,597,6,13,35400
2017-12-18,27017,15,6288,326,6,17,33669
2017-12-19,27982,13,6587,376,13,13,34984
2017-12-20,32499,12,6955,493,7,13,39979
2017-12-21,44246,12,6705,564,8,12,51547
2017-12-22,63758,12,4439,572,11,11,68803
2017-12-23,76078,11,2296,919,4,13,79321
2017-12-24,34659,11,723,493,6,9,35901
2017-12-25,26349,7,890,284,4,7,27541
2017-12-26,36529,11,2752,535,1,14,39842
2017-12-27,34978,20,3876,434,3,11,39322
2017-12-28,35679,15,3722,462,10,15,39903
2017-12-29,42455,13,3143,658,13,15,46297
2017-12-30,48568,13,1349,762,14,17,50723
2017-12-31,25513,11,467,371,4,8,26374
2018-01-01,28188,9,856,365,4,9,29431
2018-01-02,42339,7,2174,567,5,12,45104
2018-01-03,35598,13,3738,607,8,12,39976
2018-01-04,36963,16,4130,558,7,14,41688
2018-01-05,46925,16,3666,449,6,12,51074
2018-01-06,45081,7,1633,658,7,15,47401
2018-01-07,38295,28,1815,561,4,11,40714
2018-01-08,36407,14,4979,434,6,12,41852
2018-01-09,30201,15,5346,360,5,15,35942
2018-01-10,27888,11,5557,446,5,8,33915
2018-01-11,27004,15,5731,414,4,11,33179
2018-01-12,35083,17,5073,356,8,12,40549
2018-01-13,39965,9,3070,539,5,13,43601
2018-01-14,31376,4,2400,507,2,11,34300
2018-01-15,18845,13,4829,298,8,8,24001
2018-01-16,18160,10,4664,318,7,11,23170
2018-01-17,21568,12,5661,376,5,16,27638
2018-01-18,23530,12,5243,373,5,12,29175
2018-01-19,30325,11,4051,405,2,13,34807
2018-01-20,27966,8,2853,501,9,11,31348
2018-01-21,29238,11,2511,487,4,12,32263
2018-01-22,22562,11,4973,297,4,7,27854
2018-01-23,18292,10,5421,301,7,17,24048
2018-01-24,20429,14,6438,460,6,10,27357
2018-01-25,19958,12,5644,376,10,12,26012
2018-01-26,27033,13,4391,369,7,12,31825
2018-01-27,24509,7,2753,472,5,11,27757
2018-01-28,25658,7,2504,442,4,18,28633
2018-01-29,20147,15,6031,283,7,10,26493
2018-01-30,20488,14,6016,354,11,11,26894
2018-01-31,20795,13,5424,408,6,8,26654
2018-02-01,22804,12,5762,386,6,11,28981
2018-02-02,25529,12,3720,412,5,14,29692
2018-02-03,20822,5,2732,487,3,7,24056
2018-02-04,23044,9,2382,432,2,15,25884
2018-02-05,20363,13,5301,308,11,10,26006
2018-02-06,19380,17,4936,291,12,17,24653
2018-02-07,17655,9,4498,345,4,11,22522
2018-02-08,21265,12,3948,349,10,13,25597
2018-02-09,28027,12,4153,404,5,15,32616
2018-02-10,29965,7,2739,498,12,14,33235
2018-02-11,27768,6,3135,486,6,15,31416
2018-02-12,19963,12,5177,276,8,13,25449
2018-02-13,18428,13,4901,315,7,15,23679
2018-02-14,24291,13,6200,459,4,14,30981
2018-02-15,22918,10,4212,433,13,14,27600
2018-02-16,28950,14,5385,369,12,15,34745
2018-02-17,29138,9,2794,488,10,16,32455
2018-02-18,28370,8,2213,507,5,11,31114
2018-02-19,22336,13,5726,322,9,12,28418
2018-02-20,20394,13,6922,351,7,17,27704
2018-02-21,19328,12,5099,387,5,14,24845
2018-02-22,21371,12,5602,390,10,15,27400
2018-02-23,25499,11,4125,418,5,13,30071
2018-02-24,24317,8,2534,498,5,12,27374
2018-02-25,23271,10,2451,452,2,12,26198
2018-02-26,18755,11,4929,262,4,9,23970
2018-02-27,13963,8,3438,308,16,11,17744
2018-02-28,17514,11,5460,380,10,16,23391
2018-03-01,18814,10,4587,394,14,11,23830
2018-03-02,21704,13,4883,381,8,12,27001
2018-03-03,21834,5,2773,507,10,15,25144
2018-03-04,24621,8,2386,474,7,18,27514
2018-03-05,20746,9,5327,328,7,15,26432
2018-03-06,18856,11,6211,358,3,14,25453
2018-03-07,20715,14,5829,512,18,16,27104
2018-03-08,21611,10,6108,478,14,16,28237
2018-03-09,30301,14,5167,521,10,12,36025
2018-03-10,28746,6,3331,529,16,14,32642
2018-03-11,27186,7,2961,640,5,11,30810
2018-03-12,21397,11,6027,368,12,13,27828
2018-03-13,19634,12,6052,338,8,19,26063
2018-03-14,22259,13,7056,431,8,14,29781
2018-03-15,25961,13,6253,509,10,12,32758
2018-03-16,35715,11,6095,428,4,13,42266
2018-03-17,30233,7,3004,582,7,15,33848
2018-03-18,27041,7,2564,557,9,12,30190
2018-03-19,23834,11,6186,439,10,11,30491
2018-03-20,22646,10,6690,400,10,18,29774
2018-03-21,23077,13,6775,505,5,53,30428
2018-03-22,26245,11,6339,445,9,14,33063
2018-03-23,39505,13,5863,518,22,17,45938
2018-03-24,44372,8,3791,736,21,30,48958
2018-03-25,36389,9,2696,689,37,36,39856
2018-03-26,28111,12,6769,417,19,38,35366
2018-03-27,28904,12,6760,455,17,34,36182
2018-03-28,34550,13,7657,598,19,47,42884
2018-03-29,47995,14,6488,636,12,50,55195
2018-03-30,68150,12,4547,609,11,36,73365
2018-03-31,36144,9,1748,709,9,57,38676
2018-04-01,36583,7,1061,589,31,41,38312
2018-04-02,51813,8,3071,677,23,47,55639
2018-04-03,39552,9,7148,652,17,42,47420
2018-04-04,32636,13,7000,583,11,49,40292
2018-04-05,35429,14,6378,674,14,41,42550
2018-04-06,48664,11,5607,630,25,44,54981
2018-04-07,48831,8,3049,758,21,62,52729
2018-04-08,39179,9,1733,741,27,41,41730
2018-04-09,35008,11,5834,511,11,46,41421
2018-04-10,28739,12,6453,511,12,44,35771
2018-04-11,27560,15,7409,577,25,46,35632
2018-04-12,30420,11,7283,631,19,36,38400
2018-04-13,43084,13,6657,596,25,46,50421
2018-04-14,41158,10,3691,774,20,65,45718
2018-04-15,36836,11,2650,744,16,54,40311
2018-04-16,28993,12,6187,551,18,28,35789
2018-04-17,26661,15,7666,490,19,50,34901
2018-04-18,27504,12,7549,648,16,57,35786
2018-04-19,29428,11,7943,617,17,64,38080
2018-04-20,43096,10,6891,627,32,45,50701
2018-04-21,43322,10,3584,829,36,93,47874
2018-04-22,39645,12,2755,782,56,80,43330
2018-04-23,30333,9,7439,572,35,48,38436
2018-04-24,30398,9,7904,549,28,58,38946
2018-04-25,33567,13,7573,622,60,67,41902
2018-04-26,51495,11,7212,621,60,61,59460
2018-04-27,87259,13,4679,887,55,63,92956
2018-04-28,78770,7,3356,1458,141,101,83833
2018-04-29,59977,10,2469,949,112,87,63604
2018-04-30,51863,13,4643,800,41,61,57421
2018-05-01,50124,11,2065,698,34,71,53003
2018-05-02,42211,11,4432,918,24,41,47637
2018-05-03,36359,9,6834,720,19,66,44007
2018-05-04,47008,12,6419,755,47,68,54309
2018-05-05,49289,8,3824,841,37,96,54095
2018-05-06,42708,10,2445,855,46,108,46172
2018-05-07,33557,12,6534,582,27,64,40776
2018-05-08,33630,14,7541,645,35,81,41946
2018-05-09,42862,12,7267,619,37,68,50865
2018-05-10,48969,12,6578,758,58,140,56515
2018-05-11,46319,11,6203,646,60,81,53320
2018-05-12,43398,10,3561,886,51,171,48077
2018-05-13,44944,7,2724,877,32,77,48661
2018-05-14,32508,12,6679,609,24,78,39910
2018-05-15,29013,12,7392,603,30,83,37133
2018-05-16,31167,11,7537,695,42,87,39539
2018-05-17,36248,12,7357,679,41,66,44403
2018-05-18,57777,13,4960,816,71,92,63729
2018-05-19,64429,11,4035,1072,103,222,69872
2018-05-20,51501,8,2217,830,60,122,54738
2018-05-21,47743,10,6019,787,58,76,54693
2018-05-22,34004,10,7691,682,33,63,42483
2018-05-23,33109,11,7223,821,50,88,41302
2018-05-24,36637,14,7203,758,57,110,44779
2018-05-25,55028,15,6857,823,81,83,62887
2018-05-26,53388,8,3084,1098,80,209,57867
2018-05-27,50039,7,2689,954,80,132,53901
2018-05-28,38426,11,6139,681,52,86,45395
2018-05-29,32441,16,7670,634,54,105,40920
2018-05-30,50905,12,7335,809,62,119,59242
2018-05-31,66973,11,5087,918,120,154,73263
2018-06-01,62302,13,6055,816,213,110,69509
2018-06-02,60377,8,3369,932,142,159,64987
2018-06-03,58148,12,2641,918,72,99,61890
2018-06-04,42048,13,6140,760,56,97,49114
2018-06-05,33073,12,7105,619,60,122,40991
2018-06-06,34101,10,6563,648,71,112,41505
2018-06-07,40350,12,7593,717,61,85,48818
2018-06-08,55794,13,6782,795,60,103,63547
2018-06-09,51232,10,3810,987,118,203,56360
2018-06-10,55693,9,2833,784,95,163,59577
2018-06-11,38159,10,6878,694,92,105,45938
2018-06-12,36322,13,7680,599,63,118,44795
2018-06-13,40884,13,7558,670,62,86,49273
2018-06-14,49197,13,6942,733,69,138,57092
2018-06-15,64114,13,5800,810,92,119,70948
2018-06-16,73524,11,3257,1075,134,229,78230
2018-06-17,67150,6,2515,847,96,162,70776
2018-06-18,48064,15,6759,658,89,96,55681
2018-06-19,37718,12,7343,657,67,141,45938
2018-06-20,44586,14,7539,722,83,147,53091
2018-06-21,49506,12,6888,740,113,152,57411
2018-06-22,72987,12,5075,855,67,113,79109
2018-06-23,97648,11,3660,1387,180,152,103038
2018-06-24,65065,12,2164,976,138,188,68543
2018-06-25,60268,15,4262,778,74,126,65523
2018-06-26,47723,17,8156,710,77,158,56841
2018-06-27,47769,20,7616,792,63,134,56394
2018-06-28,48573,17,7191,803,111,120,56815
2018-06-29,77419,18,6498,861,176,167,85139
2018-06-30,94319,13,3157,1323,298,300,99410
2018-07-01,81586,13,2738,997,124,221,85679
2018-07-02,60726,18,6909,656,197,132,68638
2018-07-03,51299,18,7340,777,133,164,59731
2018-07-04,50573,18,7606,724,118,147,59186
2018-07-05,59911,17,7414,767,155,213,68477
2018-07-06,82339,21,6054,792,161,158,89525
2018-07-07,104969,16,2918,1230,269,277,109679
2018-07-08,88571,17,2953,1042,206,240,93029
2018-07-09,69071,17,6902,693,148,168,76999
2018-07-10,56876,17,7296,696,153,138,65176
2018-07-11,55361,16,7223,741,79,199,63619
2018-07-12,65433,17,7204,872,134,195,73855
2018-07-13,90790,14,6105,762,204,176,98051
2018-07-14,129463,12,2755,1185,310,231,133956
2018-07-15,104138,15,2630,1029,186,204,108202
2018-07-16,80184,15,11015,705,114,172,92205
2018-07-17,65016,20,7220,769,138,189,73352
2018-07-18,65366,17,6791,725,161,155,73215
2018-07-19,70234,17,6831,767,152,194,78195
2018-07-20,105815,19,6299,799,187,195,113314
2018-07-21,135143,15,3133,1255,186,260,139992
2018-07-22,109081,15,3128,960,178,161,113523
2018-07-23,86288,15,6731,717,134,164,94049
2018-07-24,67510,21,7382,679,109,187,75888
2018-07-25,64264,14,6087,807,145,196,71513
2018-07-26,81080,19,6784,757,244,156,89040
2018-07-27,109148,19,6272,890,187,214,116730
2018-07-28,135489,14,2875,1130,322,300,140130
2018-07-29,113118,17,2653,1088,253,154,117283
2018-07-30,87129,19,6230,714,191,65,94348
2018-07-31,73621,18,7064,751,168,137,81759
2018-08-01,80616,20,7067,784,201,215,88903
2018-08-02,82040,16,5853,755,201,152,89017
2018-08-03,75985,19,3159,765,225,189,80342
2018-08-04,146345,19,2910,1201,457,291,151223
2018-08-05,113620,15,2657,1341,503,208,118344
2018-08-06,98104,15,5727,886,394,174,105300
2018-08-07,76783,21,6234,726,253,136,84153
2018-08-08,72213,20,6385,767,226,199,79810
2018-08-09,83777,17,6114,751,224,215,91098
2018-08-10,113598,17,4888,846,295,177,119821
2018-08-11,121798,19,2853,1471,345,212,126698
2018-08-12,104423,15,2437,1098,276,235,108484
2018-08-13,92303,21,5502,681,276,148,98931
2018-08-14,81177,15,5509,669,81,175,87626
2018-08-15,83651,13,3135,832,106,145,87882
2018-08-16,85236,19,5730,824,137,136,92082
2018-08-17,102311,21,4818,799,212,171,108332
2018-08-18,121353,15,2541,1091,179,280,125459
2018-08-19,105472,14,2237,1020,170,141,109054
2018-08-20,88819,17,5045,762,119,114,94876
2018-08-21,64779,17,6017,648,123,191,71775
2018-08-22,68346,19,6082,727,98,178,75450
2018-08-23,78244,14,5855,813,99,138,85163
2018-08-24,94275,18,5173,990,70,104,100630
2018-08-25,108197,17,2779,1213,59,268,112533
2018-08-26,89038,15,2570,1038,32,185,92878
2018-08-27,69954,18,6118,723,128,166,77107
2018-08-28,57291,23,6403,679,88,178,64662
2018-08-29,58716,19,6713,791,85,193,66517
2018-08-30,63755,15,6316,785,69,115,71055
2018-08-31,80393,17,5770,836,63,145,87224
2018-09-01,90744,13,2738,1314,50,183,95042
2018-09-02,76456,19,2627,1045,79,171,80397
2018-09-03,62121,19,6645,749,69,78,69681
2018-09-04,47658,20,7047,658,69,96,55548
2018-09-05,48130,19,7343,750,59,120,56421
2018-09-06,54708,17,6968,733,61,155,62642
2018-09-07,69298,17,6259,825,60,117,76576
2018-09-08,74491,21,3405,1628,81,179,79805
2018-09-09,68164,15,2904,1093,71,119,72366
2018-09-10,49639,14,6857,756,48,118,57432
2018-09-11,43113,19,7069,668,71,143,51083
2018-09-12,43286,17,7179,699,44,152,51377
2018-09-13,46063,16,6991,742,52,110,53974
2018-09-14,63467,20,5932,835,83,120,70457
2018-09-15,65558,18,3555,1172,91,231,70625
2018-09-16,58549,15,2231,918,63,165,61941
2018-09-17,43467,15,7268,715,47,86,51598
2018-09-18,38074,19,7562,617,59,130,46461
2018-09-19,43501,20,7477,766,42,125,51931
2018-09-20,51408,20,7653,864,50,89,60084
2018-09-21,59864,25,8179,851,67,99,69085
2018-09-22,61174,12,4932,1203,56,210,67587
2018-09-23,45089,14,2686,908,32,167,48896
2018-09-24,48568,34,7699,954,32,449,57736
2018-09-25,32644,18,7438,630,36,115,40881
2018-09-26,34895,14,7051,753,33,155,42901
2018-09-27,41976,14,7258,760,42,138,50188
2018-09-28,53509,18,6465,730,34,111,60867
2018-09-29,51038,11,3745,1046,26,141,56007
2018-09-30,46931,10,2718,844,48,155,50706
2018-10-01,35043,11,6823,749,33,81,42740
2018-10-02,27792,21,6582,588,21,96,35100
2018-10-03,33934,15,6952,783,32,101,41817
2018-10-04,34684,17,6615,775,31,118,42240
2018-10-05,48389,15,6141,746,27,79,55397
2018-10-06,41591,13,3989,853,21,113,46580
2018-10-07,40659,12,2195,910,24,133,43933
2018-10-08,35459,11,5481,599,31,67,41648
2018-10-09,31741,13,7427,583,30,87,39881
2018-10-10,31238,14,7403,722,40,74,39491
2018-10-11,33800,14,7425,744,25,95,42103
2018-10-12,47285,13,7096,671,17,91,55173
2018-10-13,46755,8,3956,1127,26,158,52030
2018-10-14,43753,11,2602,886,39,121,47412
2018-10-15,31065,10,6998,663,38,75,38849
2018-10-16,23205,20,6682,519,19,74,30519
2018-10-17,36477,9,7747,570,21,68,44892
2018-10-18,32452,15,7101,580,20,92,40260
2018-10-19,46087,12,6610,734,26,53,53522
2018-10-20,45323,11,3527,858,16,137,49872
2018-10-21,40189,10,2586,804,19,65,43673
2018-10-22,31588,12,7343,510,12,58,39523
2018-10-23,27560,19,6936,648,24,70,35257
2018-10-24,30048,16,7831,638,23,63,38619
2018-10-25,40219,14,7332,710,20,84,48379
2018-10-26,47404,16,6335,680,12,38,54485
2018-10-27,45803,11,4109,831,10,122,50886
2018-10-28,42696,15,3005,678,6,49,46449
2018-10-29,31101,14,7611,459,6,20,39211
2018-10-30,41054,18,7458,474,11,22,49037
2018-10-31,54382,11,4575,565,26,30,59589
2018-11-01,39995,14,3069,510,11,21,43620
2018-11-02,44272,14,5408,451,14,15,50174
2018-11-03,44133,12,3233,626,12,37,48053
2018-11-04,50522,14,2737,733,9,26,54041
2018-11-05,30977,16,7253,419,9,16,38690
2018-11-06,24980,15,7654,381,9,17,33056
2018-11-07,25655,15,7715,477,10,24,33896
2018-11-08,28290,19,7582,521,12,20,36444
2018-11-09,37932,18,6782,543,12,18,45305
2018-11-10,33060,11,3800,618,7,18,37514
2018-11-11,32372,12,2905,563,7,13,35872
2018-11-12,27267,15,7249,383,13,16,34943
2018-11-13,25294,16,7481,430,11,13,33245
2018-11-14,27738,16,7411,476,17,13,35671
2018-11-15,28414,20,7662,506,10,16,36628
2018-11-16,40494,17,6955,501,11,23,48001
2018-11-17,32979,12,3792,648,10,18,37459
2018-11-18,32145,8,2719,565,5,11,35453
2018-11-19,25930,14,6745,370,13,17,33089
2018-11-20,21845,16,7294,370,4,14,29543
2018-11-21,24758,13,5635,426,13,9,30854
2018-11-22,28000,11,7213,441,16,14,35695
2018-11-23,39347,9,6667,442,17,14,46496
2018-11-24,32501,10,3493,592,8,15,36619
2018-11-25,31257,9,3061,476,10,11,34824
2018-11-26,27870,10,6624,375,13,13,34905
2018-11-27,22696,14,7325,352,5,12,30404
2018-11-28,23539,16,7141,427,3,13,31139
2018-11-29,25731,17,7517,463,9,14,33751
2018-11-30,36570,11,6949,451,10,18,44009
2018-12-01,29740,7,3436,632,5,13,33833
2018-12-02,28694,8,3016,523,6,12,32259
2018-12-03,24945,12,6722,330,6,13,32028
2018-12-04,24626,17,7316,350,9,16,32334
2018-12-05,25235,19,7323,406,17,16,33016
2018-12-06,26271,18,7136,403,6,14,33848
2018-12-07,37936,13,6727,463,13,17,45169
2018-12-08,32806,11,3180,818,10,15,36840
2018-12-09,30822,17,2842,519,5,14,34219
2018-12-10,25386,20,7214,315,12,17,32964
2018-12-11,24236,25,7249,336,8,16,31870
2018-12-12,26126,17,7627,417,12,15,34214
2018-12-13,26257,23,6882,458,8,16,33644
2018-12-14,32576,18,6208,451,10,13,39276
2018-12-15,31101,20,3334,726,10,16,35207
2018-12-16,29818,14,2638,611,7,11,33099
2018-12-17,24876,18,6120,317,7,13,31351
2018-12-18,26675,21,6687,363,7,11,33764
2018-12-19,31255,20,6766,496,5,14,38556
2018-12-20,40535,20,6034,568,11,13,47181
2018-12-21,62400,17,4592,600,9,15,67633
2018-12-22,75564,16,2690,967,9,13,79259
2018-12-23,47322,18,1233,699,6,12,49290
2018-12-24,31044,18,2163,353,7,11,33596
2018-12-25,24453,12,871,316,8,10,25670
2018-12-26,36041,15,2394,468,1,16,38935
2018-12-27,38541,16,3254,447,12,17,42287
2018-12-28,43933,22,2877,454,10,14,47310
2018-12-29,47482,19,1384,776,9,20,49690
2018-12-30,41041,18,806,753,2,17,42637
2018-12-31,27858,17,948,341,6,8,29178
2019-01-01,23648,6,781,343,4,8,24790
2019-01-02,43210,18,1970,642,8,13,45861
2019-01-03,40651,22,3304,569,6,14,44566
2019-01-04,45535,17,3338,456,8,12,49366
2019-01-05,55183,17,1807,661,7,14,57689
2019-01-06,35907,13,1730,708,3,11,38372
2019-01-07,29275,23,3638,414,7,11,33368
2019-01-08,31173,17,5618,396,4,12,37220
2019-01-09,25354,18,5682,413,6,17,31490
2019-01-10,25662,20,4922,440,3,15,31062
2019-01-11,32378,19,4463,407,8,20,37295
2019-01-12,35867,13,3020,519,5,15,39439
2019-01-13,29041,15,2476,457,3,17,32009
2019-01-14,24160,18,5966,334,4,17,30499
2019-01-15,22636,17,6280,322,9,17,29281
2019-01-16,23535,18,6242,397,7,20,30219
2019-01-17,25013,20,6310,396,6,15,31760
2019-01-18,32804,19,5371,362,3,15,38574
2019-01-19,27742,13,3127,495,7,16,31400
2019-01-20,27654,13,2567,439,4,21,30698
2019-01-21,24422,19,5960,318,8,13,30740
2019-01-22,31830,15,6846,436,15,73,39215
2019-01-23,18963,19,6222,405,3,20,25632
2019-01-24,21193,14,6364,394,7,14,27986
2019-01-25,28396,16,5110,375,6,13,33916
2019-01-26,24538,15,3261,462,13,13,28302
2019-01-27,25393,14,2672,434,4,17,28534
2019-01-28,21816,12,5928,318,11,15,28100
2019-01-29,20885,16,6695,301,8,12,27917
2019-01-30,21344,19,6774,387,6,17,28547
2019-01-31,23737,17,6017,359,4,15,30149
2019-02-01,32186,17,4991,384,7,17,37602
2019-02-02,27056,16,3244,441,6,9,30772
2019-02-03,27193,11,2661,481,7,13,30366
2019-02-04,23722,23,5806,337,8,16,29912
2019-02-05,22889,19,6291,309,9,15,29532
2019-02-06,24770,22,6256,403,3,12,31466
2019-02-07,32000,16,6670,376,12,20,39094
2019-02-08,37930,13,3961,379,9,19,42311
2019-02-09,32268,13,3701,466,9,17,36474
2019-02-10,33794,13,2703,463,8,14,36995
2019-02-11,24496,18,6328,328,13,13,31196
2019-02-12,23731,18,6307,320,6,15,30397
2019-02-13,24451,19,6511,434,5,17,31437
2019-02-14,29051,20,6350,440,6,19,35886
2019-02-15,39313,19,5614,397,8,19,45370
2019-02-16,36299,13,3131,525,8,26,40002
2019-02-17,36877,14,2667,497,9,14,40078
2019-02-18,26916,19,6138,355,9,12,33449
2019-02-19,23402,20,6821,343,6,16,30608
2019-02-20,26394,20,6932,397,11,18,33772
2019-02-21,28561,18,6883,454,8,14,35938
2019-02-22,30242,21,5724,343,10,20,36360
2019-02-23,32309,15,3775,510,6,14,36629
2019-02-24,32718,15,2873,465,2,19,36092
2019-02-25,26561,16,6524,369,6,13,33489
2019-02-26,23371,22,7140,311,7,18,30869
2019-02-27,24241,22,7355,409,10,19,32056
2019-02-28,30394,23,6975,451,11,21,37875
2019-03-01,44381,21,5771,434,9,19,50635
2019-03-02,36736,11,3678,566,8,14,41013
2019-03-03,37003,15,2575,557,5,21,40176
2019-03-04,28233,20,6531,368,11,17,35180
2019-03-05,24375,16,6923,364,5,18,31701
2019-03-06,25983,22,7133,472,12,24,33646
2019-03-07,27245,21,6715,513,3,24,34521
2019-03-08,39702,17,5910,533,11,20,46193
2019-03-09,34884,13,3604,554,6,18,39079
2019-03-10,35598,17,2688,583,4,16,38906
2019-03-11,26200,19,6927,385,16,19,33566
2019-03-12,24006,21,7339,340,8,19,31733
2019-03-13,24617,19,7297,462,12,26,32433
2019-03-14,28924,21,7424,498,7,33,36907
2019-03-15,40065,23,5677,482,18,23,46288
2019-03-16,36580,14,3608,544,7,20,40773
2019-03-17,36749,13,3091,603,10,11,40477
2019-03-18,27464,20,6904,422,9,15,34834
2019-03-19,25917,22,7071,414,9,21,33454
2019-03-20,25891,19,7248,486,8,20,33672
2019-03-21,29693,19,7237,513,9,13,37484
2019-03-22,41279,15,6152,498,15,37,47996
2019-03-23,36540,18,4337,578,14,31,41518
2019-03-24,38308,14,2640,574,17,28,41581
2019-03-25,28168,18,7401,404,16,12,36019
2019-03-26,24133,17,7661,380,9,19,32219
2019-03-27,26509,22,7442,510,19,28,34530
2019-03-28,29426,23,7241,457,13,30,37190
2019-03-29,43980,23,6304,518,21,21,50867
2019-03-30,38083,14,3486,672,21,25,42301
2019-03-31,39815,13,2711,682,17,43,43281
2019-04-01,29437,17,7138,438,18,46,37094
2019-04-02,26663,20,7226,434,15,55,34413
2019-04-03,27894,19,7184,515,22,47,35681
2019-04-04,28606,17,6997,607,13,56,36296
2019-04-05,41026,19,5925,569,19,33,47591
2019-04-06,38222,14,4159,702,23,87,43207
2019-04-07,36401,15,2644,681,20,60,39821
2019-04-08,27829,16,7102,495,19,45,35506
2019-04-09,25415,24,7294,420,19,36,33208
2019-04-10,28385,20,7547,581,13,60,36606
2019-04-11,32147,21,7514,608,30,69,40389
2019-04-12,49126,19,6487,645,25,52,56354
2019-04-13,55111,13,3862,836,36,59,59917
2019-04-14,43771,18,2986,889,20,72,47756
2019-04-15,34799,18,7310,484,21,58,42690
2019-04-16,34093,22,7406,535,44,66,42166
2019-04-17,42311,19,7734,635,31,68,50798
2019-04-18,56214,19,7094,738,38,55,64158
2019-04-19,82006,22,4858,693,54,70,87703
2019-04-20,59592,16,2245,701,78,78,62710
2019-04-21,48210,15,1268,592,47,93,50225
2019-04-22,56197,15,3578,701,27,53,60571
2019-04-23,45302,22,7211,734,17,72,53358
2019-04-24,40211,15,7630,640,19,64,48579
2019-04-25,49154,21,7296,720,43,90,57324
2019-04-26,68662,16,6055,804,50,68,75655
2019-04-27,75498,17,2625,1096,41,126,79403
2019-04-28,51621,18,2506,924,37,97,55203
2019-04-29,49352,16,7108,686,24,83,57269
2019-04-30,66727,15,5846,850,39,84,73561
2019-05-01,65380,16,1929,794,68,114,68301
2019-05-02,52399,15,3858,708,35,105,57120
2019-05-03,52337,22,6140,749,82,76,59406
2019-05-04,53987,18,3683,971,31,160,58850
2019-05-05,50717,14,2806,886,7,127,54557
2019-05-06,37927,22,6853,614,49,71,45536
2019-05-07,34817,21,7451,531,27,109,42956
2019-05-08,31866,22,7680,626,36,73,40303
2019-05-09,35021,20,7108,616,23,129,42917
2019-05-10,44410,18,6391,690,44,74,51627
2019-05-11,44435,16,4003,807,26,176,49463
2019-05-12,37040,18,2809,722,26,84,40699
2019-05-13,31168,19,6792,567,22,75,38643
2019-05-14,26803,23,7854,594,36,94,35404
2019-05-15,30139,21,7082,657,37,61,37997
2019-05-16,33347,20,7393,647,50,64,41521
2019-05-17,50186,21,7130,690,55,73,58155
2019-05-18,42747,16,3812,913,35,180,47703
2019-05-19,41987,15,2867,829,38,132,45868
2019-05-20,32597,16,7026,648,21,78,40386
2019-05-21,30966,19,7297,640,37,109,39068
2019-05-22,31621,19,8067,829,45,101,40682
2019-05-23,36731,22,7078,693,49,89,44662
2019-05-24,52978,19,6523,695,56,68,60339
2019-05-25,54352,18,3831,971,69,234,59475
2019-05-26,41248,16,2693,836,49,151,44993
2019-05-27,33392,20,6951,566,30,55,41014
2019-05-28,31662,18,7694,578,38,77,40067
2019-05-29,47493,22,8261,715,46,104,56641
2019-05-30,62747,18,7900,847,90,140,71742
2019-05-31,57583,19,6570,728,126,108,65134
2019-06-01,56589,15,3912,894,134,196,61740
2019-06-02,53155,13,2936,970,80,171,57325
2019-06-03,38847,16,6578,684,63,101,46289
2019-06-04,34915,20,6711,673,73,129,42521
2019-06-05,39432,21,7209,654,54,129,47499
2019-06-06,46125,25,6981,685,44,172,54032
2019-06-07,77801,24,6246,766,103,169,85109
2019-06-08,83624,16,3950,996,151,282,89019
2019-06-09,66872,14,2279,770,102,177,70214
2019-06-10,54908,25,6344,728,88,137,62230
2019-06-11,41959,20,7787,605,53,111,50535
2019-06-12,42141,23,7456,1282,66,134,51102
2019-06-13,46929,19,7177,724,91,167,55107
2019-06-14,68828,21,6527,717,155,129,76377
2019-06-15,80743,19,4006,1104,166,253,86291
2019-06-16,63716,16,2554,827,113,183,67409
2019-06-17,50036,22,6821,618,65,116,57678
2019-06-18,44735,19,7409,648,82,145,53038
2019-06-19,59233,20,7166,722,92,154,67387
2019-06-20,70741,22,4866,705,112,192,76638
2019-06-21,78859,22,6312,783,155,115,86246
2019-06-22,93373,20,3324,1104,105,275,98201
2019-06-23,79377,19,2623,876,141,191,83227
2019-06-24,60691,23,6259,721,143,176,68013
2019-06-25,54686,19,4719,686,88,179,60377
2019-06-26,48942,27,8362,785,99,124,58339
2019-06-27,50941,26,7207,820,141,190,59325
2019-06-28,78808,21,6858,773,169,203,86832
2019-06-29,90642,13,3677,1092,211,281,95916
2019-06-30,82792,21,2865,1050,196,220,87144
2019-07-01,68301,25,7012,731,179,133,76381
2019-07-02,52940,24,7460,680,135,196,61435
2019-07-03,54542,26,7581,829,93,194,63265
2019-07-04,61440,24,7481,849,107,199,70100
2019-07-05,88764,22,6490,869,251,178,96574
2019-07-06,100899,19,3238,1214,225,287,105882
2019-07-07,80616,16,2610,1000,117,216,84575
2019-07-08,69961,23,6966,656,143,179,77928
2019-07-09,56366,21,7599,677,84,139,64886
2019-07-10,59887,21,7586,736,52,196,68478
2019-07-11,58655,22,6149,727,182,210,65945
2019-07-12,92026,21,6875,801,178,179,100080
2019-07-13,119938,14,3233,1008,175,215,124583
2019-07-14,95521,18,2960,913,236,240,99888
2019-07-15,84489,21,6822,690,125,179,92326
2019-07-16,63149,26,7255,707,149,204,71490
2019-07-17,64416,21,7934,794,1364,123,74652
2019-07-18,73196,24,7296,748,131,216,81611
2019-07-19,103727,22,6335,835,192,202,111313
2019-07-20,126768,16,2936,1031,333,307,131391
2019-07-21,102722,16,2893,880,204,232,106947
2019-07-22,86400,19,6954,627,192,187,94379
2019-07-23,65110,24,7349,622,132,201,73438
2019-07-24,70214,21,7333,753,131,215,78667
2019-07-25,79946,24,6910,801,164,217,88062
2019-07-26,105214,21,6279,820,162,198,112694
2019-07-27,111750,19,2613,1076,129,282,115869
2019-07-28,103023,15,3054,862,28,229,107211
2019-07-29,89566,21,6221,667,310,188,96973
2019-07-30,75004,22,7498,709,307,206,83746
2019-07-31,74567,24,7042,801,180,196,82810
2019-08-01,98534,22,7006,820,246,218,106846
2019-08-02,119574,21,5873,789,214,175,126646
2019-08-03,140409,18,3386,1080,461,330,145684
2019-08-04,112686,19,2261,926,489,241,116622
2019-08-05,101031,18,4869,618,350,198,107084
2019-08-06,71207,24,5787,787,293,200,78298
2019-08-07,77921,23,6455,781,161,204,85545
2019-08-08,87067,24,6417,809,148,210,94675
2019-08-09,116578,18,5815,789,345,193,123738
2019-08-10,139388,16,2543,1042,412,319,143720
2019-08-11,109272,17,1973,824,405,171,112662
2019-08-12,95093,23,5063,711,284,163,101337
2019-08-13,81286,20,6069,692,184,187,88438
2019-08-14,104081,20,5259,822,71,207,110460
2019-08-15,105825,19,2978,768,222,155,109967
2019-08-16,111540,23,4760,843,141,126,117433
2019-08-17,139518,19,1926,1091,213,235,143002
2019-08-18,125302,20,2274,1072,171,233,129072
2019-08-19,92710,21,5707,662,183,177,99460
2019-08-20,68118,26,5614,754,124,69,74705
2019-08-21,72980,23,6258,814,89,188,80352
2019-08-22,79672,24,5785,810,85,201,86577
2019-08-23,103592,28,5592,822,89,157,110280
2019-08-24,107306,18,2435,1128,107,190,111184
2019-08-25,95157,17,2487,1121,105,159,99046
2019-08-26,79571,22,6285,687,106,158,86829
2019-08-27,64503,20,6751,713,91,176,72254
2019-08-28,66483,24,6992,745,96,127,74467
2019-08-29,71792,23,7263,797,87,193,80155
2019-08-30,86203,22,5977,786,86,121,93195
2019-08-31,100079,23,2923,1148,101,219,104493
2019-09-01,82493,19,2586,966,67,202,86333
2019-09-02,63327,27,6302,650,61,118,70485
2019-09-03,53639,24,7212,756,43,141,61815
2019-09-04,51610,27,7122,770,52,102,59683
2019-09-05,53353,26,7024,793,64,154,61414
2019-09-06,70995,23,6668,785,57,121,78649
2019-09-07,69364,17,3450,1038,46,249,74164
2019-09-08,67028,16,2577,947,41,120,70729
2019-09-09,55220,24,6406,737,54,102,62543
2019-09-10,46651,25,7167,639,57,152,54691
2019-09-11,44546,23,7534,685,53,145,52986
2019-09-12,47802,20,7312,694,60,160,56048
2019-09-13,70984,26,6740,821,78,143,78792
2019-09-14,69195,17,3072,1018,122,251,73675
2019-09-15,61818,16,2588,934,63,193,65612
2019-09-16,47454,22,7011,774,60,95,55416
2019-09-17,40012,24,7717,654,42,133,48582
2019-09-18,40687,21,7547,784,37,127,49203
2019-09-19,44320,22,7450,825,35,156,52808
2019-09-20,61895,21,6624,883,49,99,69571
2019-09-21,59372,11,3604,1018,55,215,64275
2019-09-22,52503,14,2428,979,36,170,56130
2019-09-23,35477,23,6052,713,25,99,42389
2019-09-24,33424,18,7622,663,37,126,41890
2019-09-25,36678,18,7362,734,36,81,44909
2019-09-26,41596,23,6880,844,61,132,49536
2019-09-27,49558,21,6547,727,37,104,56994
2019-09-28,52145,14,3590,1001,33,167,56950
2019-09-29,48640,14,2684,918,32,164,52452
2019-09-30,37134,19,6717,670,42,88,44670
2019-10-01,32467,20,6625,706,18,111,39947
2019-10-02,32542,21,6166,722,29,64,39544
2019-10-03,42746,16,7081,843,29,116,50831
2019-10-04,51288,22,6043,722,37,87,58199
2019-10-05,45277,9,3686,1018,42,133,50165
2019-10-06,44951,12,2718,910,35,154,48780
2019-10-07,35022,15,6403,642,28,74,42184
2019-10-08,31478,16,5927,620,41,90,38172
2019-10-09,29930,22,7482,660,31,57,38182
2019-10-10,37414,20,6950,701,23,68,45176
2019-10-11,52424,21,6266,738,39,73,59561
2019-10-12,47538,14,3699,925,32,178,52386
2019-10-13,46386,13,2500,814,47,139,49899
2019-10-14,33621,23,6272,582,39,47,40584
2019-10-15,29564,19,7213,555,21,84,37456
2019-10-16,32072,22,7332,641,24,70,40161
2019-10-17,35041,19,7148,692,30,67,42997
2019-10-18,50026,22,6521,677,34,63,57343
2019-10-19,43785,11,3897,911,18,140,48762
2019-10-20,43875,14,2411,782,20,106,47208
2019-10-21,31836,20,6659,594,24,63,39196
2019-10-22,29378,21,7427,496,21,64,37407
2019-10-23,31207,17,6771,635,16,65,38711
2019-10-24,35851,21,7464,603,33,105,44077
2019-10-25,55285,18,6984,664,36,57,63044
2019-10-26,52730,16,3462,817,19,92,57136
2019-10-27,45078,14,2532,664,16,27,48331
2019-10-28,34456,22,7165,455,25,32,42155
2019-10-29,33526,24,7560,483,20,29,41642
2019-10-30,45357,22,7108,542,17,18,53064
2019-10-31,59623,14,4425,543,13,38,64656
2019-11-01,45867,12,2756,446,12,18,49111
2019-11-02,42349,15,2887,536,17,45,45849
2019-11-03,51848,14,2736,711,6,17,55332
2019-11-04,35558,20,6729,425,23,17,42772
2019-11-05,28502,22,7168,390,14,21,36117
2019-11-06,27791,22,7381,459,11,18,35682
2019-11-07,29062,19,7026,496,13,13,36629
2019-11-08,38643,17,6378,584,16,14,45652
2019-11-09,35024,17,2989,608,12,15,38665
2019-11-10,34314,12,2543,527,7,11,37414
2019-11-11,29181,21,6299,355,15,11,35882
2019-11-12,23719,24,7000,392,9,16,31160
2019-11-13,24947,21,6933,479,6,13,32399
2019-11-14,27264,19,6811,440,9,18,34561
2019-11-15,39277,21,6007,488,7,13,45813
2019-11-16,31195,13,3093,633,6,16,34956
2019-11-17,33509,10,2633,465,2,15,36634
2019-11-18,28125,19,6626,358,7,15,35150
2019-11-19,24431,24,7220,343,11,12,32041
2019-11-20,26002,22,7158,394,7,15,33598
2019-11-21,30787,21,6721,424,17,18,37988
2019-11-22,39626,19,6457,421,18,23,46564
2019-11-23,34661,18,3334,574,10,12,38609
2019-11-24,35082,17,2799,479,6,13,38396
2019-11-25,30369,27,6014,384,15,18,36827
2019-11-26,26150,23,7023,326,8,15,33545
2019-11-27,25967,28,7245,447,13,13,33713
2019-11-28,26932,28,7198,433,11,17,34619
2019-11-29,39962,23,6176,431,10,16,46618
2019-11-30,31042,16,3640,612,6,16,35332
2019-12-01,32383,15,2687,510,4,12,35611
2019-12-02,26159,23,6360,328,6,11,32887
2019-12-03,23827,17,6959,337,12,13,31165
2019-12-04,24668,18,6886,400,15,14,32001
2019-12-05,28213,19,6979,414,14,16,35655
2019-12-06,36306,21,6272,454,16,15,43084
2019-12-07,32420,12,3505,737,5,20,36699
2019-12-08,30772,16,2847,565,5,16,34221
2019-12-09,25485,16,6735,348,9,11,32604
2019-12-10,22382,20,6986,353,7,18,29766
2019-12-11,26169,16,6560,392,4,16,33157
2019-12-12,25528,20,6822,465,17,11,32863
2019-12-13,35565,16,6369,453,12,9,42424
2019-12-14,35986,16,3996,914,11,13,40936
2019-12-15,33570,20,2990,582,7,17,37186
2019-12-16,26660,27,6953,336,4,10,33990
2019-12-17,26825,23,7516,357,7,12,34740
2019-12-18,31687,20,7377,523,6,11,39624
2019-12-19,35643,21,6632,545,7,10,42858
2019-12-20,63804,25,6579,553,6,12,70979
2019-12-21,73936,15,3689,995,4,11,78650
2019-12-22,41304,20,2882,750,5,14,44975
2019-12-23,43447,22,4883,457,14,9,48832
2019-12-24,38665,20,2684,363,10,11,41753
2019-12-25,28711,14,969,409,6,11,30120
2019-12-26,37120,18,1668,471,8,13,39298
2019-12-27,45502,25,2567,367,12,14,48487
2019-12-28,43657,17,1787,581,14,14,46070
2019-12-29,40984,19,1269,792,5,17,43086
2019-12-30,45903,22,2241,573,9,10,48758
2019-12-31,33671,22,1117,345,11,14,35180
2020-01-01,26871,14,651,416,7,16,27975
2020-01-02,46461,19,1613,594,6,16,48709
2020-01-03,52917,21,2470,558,7,17,55990
2020-01-04,55041,19,1549,678,9,17,57313
2020-01-05,54468,12,1206,688,8,10,56392
2020-01-06,38077,22,2290,541,4,11,40945
2020-01-07,29199,22,3630,359,9,14,33233
2020-01-08,33094,20,5039,455,4,11,38623
2020-01-09,29462,26,5108,390,5,13,35004
2020-01-10,34552,20,5241,405,10,11,40239
2020-01-11,39452,10,3290,554,7,12,43325
2020-01-12,34724,16,2558,494,3,12,37807
2020-01-13,24030,19,5929,347,8,10,30343
2020-01-14,23354,23,6479,323,11,12,30202
2020-01-15,23763,20,6687,398,10,12,30890
2020-01-16,25519,22,6402,398,16,12,32369
2020-01-17,34968,18,5874,363,10,11,41244
2020-01-18,30605,18,3280,508,7,10,34428
2020-01-19,28827,15,2396,442,2,10,31692
2020-01-20,25448,26,5824,321,6,8,31633
2020-01-21,24515,22,6450,318,2,10,31317
2020-01-22,24293,21,6931,390,10,12,31657
2020-01-23,24681,21,6499,382,4,8,31595
2020-01-24,32874,19,6138,361,10,12,39414
2020-01-25,27905,15,3079,464,2,18,31483
2020-01-26,27468,17,2577,437,3,9,30511
2020-01-27,23836,24,6031,317,16,7,30231
2020-01-28,21902,23,6582,322,10,11,28850
2020-01-29,21626,21,6809,386,8,11,28861
2020-01-30,24261,20,6973,389,8,12,31663
2020-01-31,34921,19,6282,400,13,1,41636
2020-02-01,30883,16,3564,484,14,14,34975
2020-02-02,29965,16,2794,412,11,13,33211
2020-02-03,24505,25,6226,332,8,9,31105
2020-02-04,20704,20,6683,325,10,11,27753
2020-02-05,20656,21,6711,388,9,11,27796
2020-02-06,23062,21,6829,365,7,15,30299
2020-02-07,32527,17,6363,368,14,11,39300
2020-02-08,31710,18,2856,474,9,11,35078
2020-02-09,33299,14,2709,437,8,16,36483
2020-02-10,24418,19,6409,305,7,11,31169
2020-02-11,23221,24,6930,302,12,13,30502
2020-02-12,24047,25,7128,374,7,12,31593
2020-02-13,25855,21,6800,408,11,14,33109
2020-02-14,38035,23,6235,414,5,16,44728
2020-02-15,32911,21,3313,566,15,20,36846
2020-02-16,36111,14,2543,431,2,14,39115
2020-02-17,29084,22,6385,326,9,18,35844
2020-02-18,25124,26,6815,332,8,18,32323
2020-02-19,25667,22,7113,393,11,11,33217
2020-02-20,28146,25,6104,418,13,14,34720
2020-02-21,40244,24,5995,414,8,15,46700
2020-02-22,36793,19,2770,550,4,17,40153
2020-02-23,38879,17,3045,503,11,17,42472
2020-02-24,28211,21,6646,335,16,10,35239
2020-02-25,23598,28,7232,319,7,17,31201
2020-02-26,22144,22,6074,354,5,13,28612
2020-02-27,25821,20,6953,385,10,15,33204
2020-02-28,34553,23,6220,376,7,17,41196
2020-02-29,27749,19,3583,482,10,15,31858
2020-03-01,29791,22,2663,409,2,19,32906
2020-03-02,25633,25,6132,310,10,22,32132
2020-03-03,21563,18,6162,294,4,14,28055
2020-03-04,22597,24,6768,357,15,16,29777
2020-03-05,24817,20,6729,378,11,20,31975
2020-03-06,34826,26,6100,435,6,17,41410
2020-03-07,27088,12,3277,425,6,9,30817
2020-03-08,29685,21,2413,423,11,19,32572
2020-03-09,24454,18,6273,300,9,13,31067
2020-03-10,21756,22,6299,282,13,22,28394
2020-03-11,21846,23,6123,343,14,13,28362
2020-03-12,21936,23,5522,304,10,24,27819
2020-03-13,20534,15,4577,230,8,13,25377
2020-03-14,13705,18,2567,244,6,16,16556
2020-03-15,10760,14,1862,196,8,14,12854
2020-03-16,6180,8,3639,194,11,10,10042
2020-03-17,4324,8,4127,127,8,12,8606
2020-03-18,3831,7,4572,45,6,8,8469
2020-03-19,2626,5,3704,17,7,5,6364
2020-03-20,2196,5,3084,14,8,5,5312
2020-03-21,1239,4,1801,44,9,4,3101
2020-03-22,856,6,1585,0,4,4,2455
2020-03-23,1447,9,3868,1,6,2,5333
2020-03-24,1591,7,3222,5,7,2,4834
2020-03-25,1355,8,3660,2,6,2,5033
2020-03-26,1103,10,4233,0,1,1,5348
2020-03-27,1246,5,3886,1,6,2,5146
2020-03-28,787,7,1802,0,10,3,2609
2020-03-29,584,7,1977,1,3,1,2573
2020-03-30,1086,7,4178,1,7,2,5281
2020-03-31,1184,6,4263,0,3,1,5457
2020-04-01,1193,8,4117,1,11,1,5331
2020-04-02,1049,9,4078,4,4,1,5145
2020-04-03,1516,6,3090,16,3,0,4631
2020-04-04,857,7,1844,2,7,0,2717
2020-04-05,599,7,2116,1,6,0,2729
2020-04-06,1223,7,4087,5,5,0,5327
2020-04-07,1121,7,4601,2,11,0,5742
2020-04-08,1313,7,4272,2,4,0,5598
2020-04-09,1302,6,4012,2,4,2,5328
2020-04-10,1176,4,2481,1,11,0,3673
2020-04-11,452,5,1192,1,6,0,1656
2020-04-12,292,1,901,0,5,0,1199
2020-04-13,791,7,2170,1,9,0,2978
2020-04-14,1268,10,4042,0,5,0,5325
2020-04-15,1296,9,4471,0,8,0,5784
2020-04-16,1372,5,4493,9,5,0,5884
2020-04-17,1341,5,3627,2,4,0,4979
2020-04-18,876,6,1868,5,7,0,2762
2020-04-19,556,7,1407,2,3,0,1975
2020-04-20,1512,6,3952,5,6,1,5482
2020-04-21,1718,4,4256,3,7,3,5991
2020-04-22,1432,9,4656,4,10,1,6112
2020-04-23,1646,4,4786,1,7,0,6444
2020-04-24,2058,7,3998,3,6,1,6073
2020-04-25,1067,6,2370,1,6,0,3450
2020-04-26,740,6,2000,0,6,0,2752
2020-04-27,1538,5,3945,7,11,0,5506
2020-04-28,1898,8,5334,0,7,1,7248
2020-04-29,1996,5,5073,1,7,0,7082
2020-04-30,2353,6,3990,15,7,0,6371
2020-05-01,1189,3,1628,4,4,0,2828
2020-05-02,930,4,1511,8,3,1,2457
2020-05-03,1207,6,2108,3,2,1,3327
2020-05-04,2607,7,4391,2,6,1,7014
2020-05-05,2311,4,5082,1,6,0,7404
2020-05-06,2279,5,5372,3,7,1,7667
2020-05-07,2438,4,4810,6,4,0,7262
2020-05-08,2704,6,4648,1,10,1,7370
2020-05-09,1725,6,2441,3,6,1,4182
2020-05-10,1613,8,2411,0,12,0,4044
2020-05-11,3265,7,5020,1,7,3,8303
2020-05-12,3135,8,5787,0,8,0,8938
2020-05-13,4009,8,5546,3,12,2,9580
2020-05-14,4054,8,5851,5,7,1,9926
2020-05-15,7531,8,4501,18,8,6,12072
2020-05-16,6225,7,2764,2,8,2,9008
2020-05-17,4383,6,2303,7,4,6,6709
2020-05-18,6029,6,5552,4,10,2,11603
2020-05-19,6287,5,6642,3,7,1,12945
2020-05-20,8911,7,6623,17,9,11,15578
2020-05-21,15018,4,5488,7,13,8,20538
2020-05-22,16354,4,5266,11,11,10,21656
2020-05-23,11003,8,2455,19,9,10,13504
2020-05-24,11168,7,2401,4,8,7,13595
2020-05-25,14512,7,5607,20,24,4,20174
2020-05-26,12866,6,6623,31,16,6,19548
2020-05-27,12972,10,6735,33,12,9,19771
2020-05-28,15304,3,5634,32,7,6,20986
2020-05-29,24260,5,5464,24,12,16,29781
2020-05-30,19885,9,2766,34,21,10,22725
2020-05-31,19735,7,2243,16,12,6,22019
2020-06-01,23471,8,5157,16,18,10,28680
2020-06-02,17573,4,5948,17,15,7,23564
2020-06-03,20000,4,6196,37,17,11,26265
2020-06-04,21966,3,5449,50,8,17,27493
2020-06-05,30806,5,5551,32,7,15,36416
2020-06-06,29358,7,3255,108,21,17,32766
2020-06-07,27415,8,2546,45,9,14,30037
2020-06-08,21880,5,6258,35,21,14,28213
2020-06-09,20816,8,6410,36,12,8,27290
2020-06-10,28075,8,6093,107,20,29,34332
2020-06-11,29270,3,4220,70,19,26,33608
2020-06-12,42761,8,5147,47,43,36,48042
2020-06-13,35856,9,2351,59,37,19,38331
2020-06-14,37257,6,2552,74,20,18,39927
2020-06-15,30365,5,5823,73,29,16,36311
2020-06-16,25335,10,6531,91,25,30,32022
2020-06-17,29431,8,7133,168,38,24,36802
2020-06-18,35232,8,6170,213,31,28,41682
2020-06-19,44984,8,5833,186,51,48,51110
2020-06-20,43712,7,3431,264,70,63,47547
2020-06-21,30712,8,2162,206,55,30,33173
2020-06-22,28013,18,4574,147,57,31,32840
2020-06-23,26986,20,6976,115,46,29,34172
2020-06-24,40913,16,6901,171,92,44,48137
2020-06-25,38543,16,5132,159,78,43,43971
2020-06-26,38770,19,6264,140,117,54,45364
2020-06-27,36558,12,3394,257,122,74,40417
2020-06-28,33103,13,2529,239,76,45,36005
2020-06-29,27128,14,6262,135,50,18,33607
2020-06-30,23060,17,7063,119,64,49,30372
2020-07-01,32790,20,6889,196,80,65,40040
2020-07-02,37403,23,6201,213,97,60,43997
2020-07-03,48611,20,6107,184,49,52,55023
2020-07-04,51520,21,3074,338,128,122,55203
2020-07-05,47257,22,3078,330,106,260,51053
2020-07-06,36364,22,6747,146,93,77,43449
2020-07-07,28640,22,7107,137,36,43,35985
2020-07-08,31171,22,6903,217,82,73,38468
2020-07-09,35083,20,7500,268,91,61,43023
2020-07-10,47151,22,6330,212,135,100,53950
2020-07-11,50047,14,3584,311,134,88,54178
2020-07-12,45217,16,2617,205,56,100,48211
2020-07-13,34943,21,6372,135,84,60,41615
2020-07-14,28259,22,6875,133,80,64,35433
2020-07-15,30013,21,6632,199,105,66,37036
2020-07-16,33958,20,6366,195,101,79,40719
2020-07-17,47254,17,6018,212,97,104,53702
2020-07-18,58692,20,2990,369,191,145,62407
2020-07-19,48035,18,2733,205,132,103,51226
2020-07-20,41870,23,6942,143,140,72,49190
2020-07-21,32319,23,6660,131,111,77,39321
2020-07-22,31780,22,6954,190,87,83,39116
2020-07-23,39836,22,6567,182,74,84,46765
2020-07-24,50513,22,5943,193,81,90,56842
2020-07-25,58408,19,2748,306,156,118,61755
2020-07-26,48797,22,2653,193,189,123,51977
2020-07-27,44646,18,6813,124,151,65,51817
2020-07-28,33575,16,7071,133,116,88,40999
2020-07-29,35764,25,6673,210,96,90,42858
2020-07-30,46300,19,5320,192,134,94,52059
2020-07-31,54306,18,4946,187,163,76,59696
2020-08-01,70665,21,2471,342,371,205,74075
2020-08-02,58779,15,2469,258,199,108,61828
2020-08-03,47823,27,6028,168,79,88,54213
2020-08-04,39406,18,6454,157,63,79,46177
2020-08-05,39937,24,5344,214,75,108,45702
2020-08-06,44486,25,6281,220,162,113,51287
2020-08-07,55598,27,3985,231,216,144,60201
2020-08-08,68301,21,2605,324,332,191,71774
2020-08-09,58489,17,2321,254,421,154,61656
2020-08-10,51338,18,5713,144,279,105,57597
2020-08-11,38844,18,6030,151,208,99,45350
2020-08-12,42063,18,6083,223,137,105,48629
2020-08-13,47027,32,5468,196,105,115,52943
2020-08-14,58768,16,4834,236,78,123,64055
2020-08-15,66125,19,1490,339,58,190,68221
2020-08-16,51031,16,2204,253,75,158,53737
2020-08-17,41443,23,6115,250,51,88,47970
2020-08-18,32564,22,6105,132,29,79,38931
2020-08-19,35164,19,5847,229,46,115,41420
2020-08-20,36353,18,5371,229,41,104,42116
2020-08-21,35482,19,4749,256,23,111,40640
2020-08-22,45267,21,2640,338,41,166,48473
2020-08-23,35946,15,2276,228,27,137,38629
2020-08-24,27869,17,5707,209,32,83,33917
2020-08-25,23186,21,6730,127,26,91,30181
2020-08-26,24947,19,6872,195,16,81,32130
2020-08-27,26699,18,5895,200,27,90,32929
2020-08-28,31739,21,4787,224,26,78,36875
2020-08-29,34120,18,3087,288,17,148,37678
2020-08-30,28309,19,2394,225,12,122,31081
2020-08-31,23541,20,6205,135,18,56,29975
2020-09-01,21359,21,6169,153,18,50,27770
2020-09-02,20129,19,6725,186,22,54,27135
2020-09-03,21288,24,6296,169,32,78,27887
2020-09-04,28714,23,5262,183,32,73,34287
2020-09-05,30383,16,3316,274,40,107,34136
2020-09-06,26127,18,2331,225,16,89,28806
2020-09-07,20437,18,6435,136,30,49,27105
2020-09-08,18256,22,6372,155,16,53,24874
2020-09-09,19031,21,6818,208,25,29,26132
2020-09-10,21333,24,6731,187,26,45,28346
2020-09-11,28122,20,5598,186,31,53,34010
2020-09-12,28883,19,3107,282,38,105,32434
2020-09-13,25670,15,2626,200,16,60,28587
2020-09-14,19497,24,6268,143,20,36,25988
2020-09-15,18115,23,6899,134,21,43,25235
2020-09-16,19153,27,6502,202,21,34,25939
2020-09-17,19606,22,7151,155,19,32,26985
2020-09-18,27074,21,5796,168,13,59,33131
2020-09-19,22753,16,3107,257,27,97,26257
2020-09-20,22410,16,2611,186,15,60,25298
2020-09-21,17314,27,6300,127,25,14,23807
2020-09-22,15958,22,7377,121,13,27,23518
2020-09-23,15179,24,6994,173,13,30,22413
2020-09-24,17324,23,6614,170,15,26,24172
2020-09-25,22270,23,5484,164,7,22,27970
2020-09-26,19006,15,3748,243,11,67,23090
2020-09-27,19635,15,2667,197,6,45,22565
2020-09-28,16087,24,6798,117,8,14,23048
2020-09-29,17186,24,7228,141,13,21,24613
2020-09-30,18499,19,7193,202,26,25,25964
2020-10-01,19541,22,7304,165,23,21,27076
2020-10-02,27001,20,6508,172,15,16,33732
2020-10-03,24199,17,3371,231,11,38,27867
2020-10-04,23461,14,2541,228,6,32,26282
2020-10-05,19152,23,7012,131,16,15,26349
2020-10-06,17454,18,7782,141,28,10,25433
2020-10-07,18130,22,7310,189,13,10,25674
2020-10-08,21427,20,7099,180,12,20,28758
2020-10-09,31210,24,6435,170,12,13,37864
2020-10-10,25641,22,3032,233,22,36,28986
2020-10-11,25946,21,2620,277,9,16,28889
2020-10-12,18140,23,6959,121,15,12,25270
2020-10-13,17328,19,6951,133,9,9,24449
2020-10-14,17373,22,7104,188,16,12,24715
2020-10-15,19411,19,6988,190,7,10,26625
2020-10-16,27069,21,6556,215,19,25,33905
2020-10-17,23362,18,3575,239,16,27,27237
2020-10-18,24306,16,2794,242,19,29,27406
2020-10-19,18585,20,6594,132,15,13,25359
2020-10-20,14947,24,7680,131,16,11,22809
2020-10-21,15654,21,7246,195,12,21,23149
2020-10-22,19322,24,6770,176,16,20,26328
2020-10-23,26250,15,6225,182,14,12,32698
2020-10-24,19625,18,4228,220,11,37,24139
2020-10-25,19253,12,2551,203,7,10,22036
2020-10-26,17889,24,6785,134,12,5,24849
2020-10-27,13906,23,7302,124,10,3,21368
2020-10-28,14287,24,7746,165,9,11,22242
2020-10-29,15514,21,7069,181,11,5,22801
2020-10-30,21649,26,5674,158,10,16,27533
2020-10-31,17641,21,3162,222,16,13,21075
2020-11-01,18321,20,2889,205,5,10,21450
2020-11-02,16268,21,6949,129,14,6,23387
2020-11-03,13133,19,6664,125,11,2,19954
2020-11-04,14265,19,7087,168,16,8,21563
2020-11-05,14076,20,7067,166,12,11,21352
2020-11-06,19706,21,6838,123,13,13,26714
2020-11-07,15021,17,3804,188,8,16,19054
2020-11-08,15979,10,2800,178,6,3,18976
2020-11-09,13410,21,6958,101,12,4,20506
2020-11-10,12448,22,7373,107,5,6,19961
2020-11-11,12720,18,7873,144,11,6,20772
2020-11-12,14657,22,7252,164,8,8,22111
2020-11-13,20905,20,6743,150,17,10,27845
2020-11-14,13850,17,3654,186,10,11,17728
2020-11-15,16641,13,2543,161,7,6,19371
2020-11-16,12230,17,6747,86,15,6,19101
2020-11-17,11021,19,6991,89,10,12,18142
2020-11-18,10080,16,6244,150,8,8,16506
2020-11-19,12931,16,6393,132,12,3,19487
2020-11-20,14662,18,6119,124,13,5,20941
2020-11-21,11051,11,4124,163,6,7,15362
2020-11-22,11127,13,2766,150,6,14,14076
2020-11-23,11914,17,6538,83,14,20,18586
2020-11-24,11364,17,7371,102,13,2,18869
2020-11-25,13218,16,6639,122,15,9,20019
2020-11-26,11994,15,7016,131,15,6,19177
2020-11-27,15567,17,6091,123,10,4,21812
2020-11-28,10960,16,3743,166,11,2,14898
2020-11-29,11120,14,2785,143,4,3,14069
2020-11-30,12368,20,6807,85,10,4,19294
2020-12-01,8759,22,7117,93,14,7,16012
2020-12-02,7531,15,6597,134,3,5,14285
2020-12-03,8093,15,6304,138,9,1,14560
2020-12-04,10850,15,6164,124,8,6,17167
2020-12-05,7253,13,3221,173,1,1,10662
2020-12-06,7899,11,2688,154,2,2,10756
2020-12-07,8985,15,6432,86,16,7,15541
2020-12-08,8775,16,6342,98,11,2,15244
2020-12-09,8347,14,7271,159,8,6,15805
2020-12-10,9691,15,6253,139,8,4,16110
2020-12-11,12483,21,6152,127,13,8,18804
2020-12-12,9133,17,3820,176,11,4,13161
2020-12-13,8940,16,2842,169,5,5,11977
2020-12-14,9210,15,6780,91,8,6,16110
2020-12-15,9336,19,7153,107,9,2,16626
2020-12-16,10841,21,7475,197,13,7,18554
2020-12-17,13396,24,7425,360,15,2,21222
2020-12-18,20554,25,6580,181,7,6,27353
2020-12-19,23548,16,3583,439,6,3,27595
2020-12-20,13577,16,3343,277,5,8,17226
2020-12-21,11083,22,6500,135,16,3,17759
2020-12-22,12208,20,4233,153,8,2,16624
2020-12-23,19568,18,5812,207,14,6,25625
2020-12-24,16782,10,2985,179,12,0,19968
2020-12-25,11073,9,1411,123,5,3,12624
2020-12-26,6144,10,1468,145,3,1,7771
2020-12-27,7215,14,2013,142,4,5,9393
2020-12-28,8307,17,3437,84,5,3,11853
2020-12-29,9742,13,3454,104,4,1,13318
2020-12-30,12005,19,2863,131,8,3,15029
2020-12-31,9380,14,1232,65,8,1,10700
2021-01-01,10293,13,620,39,3,0,10968
2021-01-02,14257,13,1006,175,10,4,15465
2021-01-03,15748,16,1820,179,8,5,17776
2021-01-04,14463,17,3526,132,3,3,18144
2021-01-05,13467,20,3341,122,7,1,16958
2021-01-06,11642,20,2158,219,6,3,14048
2021-01-07,12268,14,3168,173,7,2,15632
2021-01-08,17634,21,3884,147,9,7,21702
2021-01-09,15230,19,2736,238,6,1,18230
2021-01-10,17820,12,2531,276,3,9,20651
2021-01-11,12616,20,5041,133,7,4,17821
2021-01-12,10335,10,6185,113,6,4,16653
2021-01-13,9726,20,6392,181,11,3,16333
2021-01-14,9891,20,5855,160,5,3,15934
2021-01-15,11486,18,4933,139,16,6,16598
2021-01-16,9729,18,3023,198,9,1,12978
2021-01-17,9445,15,2603,212,7,3,12285
2021-01-18,9105,18,5812,103,8,3,15049
2021-01-19,9521,17,6338,97,13,5,15991
2021-01-20,9135,21,6498,170,10,4,15838
2021-01-21,11538,19,5738,155,9,0,17459
2021-01-22,11696,17,5622,140,5,2,17482
2021-01-23,10550,13,3151,184,8,0,13906
2021-01-24,10919,17,2652,188,9,2,13787
2021-01-25,10504,17,5773,95,11,3,16403
2021-01-26,9541,22,6547,96,7,1,16214
2021-01-27,10249,21,6716,158,11,5,17160
2021-01-28,10909,18,6127,166,5,6,17231
2021-01-29,13351,22,5263,123,5,5,18769
2021-01-30,10682,14,3030,174,6,2,13908
2021-01-31,9920,15,2734,174,6,3,12852
2021-02-01,10026,21,5854,103,9,5,16018
2021-02-02,10514,18,6620,99,5,0,17256
2021-02-03,10088,19,6370,148,5,12,16642
2021-02-04,11174,22,6143,180,7,2,17528
2021-02-05,14629,18,5309,144,11,7,20118
2021-02-06,11452,11,3291,163,15,2,14934
2021-02-07,10737,15,2676,177,2,4,13611
2021-02-08,12691,16,5094,89,10,3,17903
2021-02-09,10944,19,7090,92,2,0,18147
2021-02-10,10878,21,6589,168,9,2,17667
2021-02-11,11783,18,5913,180,8,4,17906
2021-02-12,15383,17,5114,132,6,6,20658
2021-02-13,11500,17,3259,177,2,2,14957
2021-02-14,11620,13,2646,154,6,3,14442
2021-02-15,11817,20,6696,101,9,9,18652
2021-02-16,11292,17,6584,90,10,2,17995
2021-02-17,11183,22,6071,174,10,4,17464
2021-02-18,12168,17,6328,175,21,3,18712
2021-02-19,18192,21,5677,147,7,5,24049
2021-02-20,13577,14,3832,178,9,6,17616
2021-02-21,14777,13,3566,186,7,4,18553
2021-02-22,13506,13,7008,109,5,8,20649
2021-02-23,11534,20,7173,89,8,0,18824
2021-02-24,12226,16,7152,163,9,7,19573
2021-02-25,14272,22,7026,166,6,8,21500
2021-02-26,17703,21,5919,158,9,10,23820
2021-02-27,14052,14,3642,193,8,3,17912
2021-02-28,15331,15,2962,169,5,6,18488
2021-03-01,14562,21,6825,110,10,8,21536
2021-03-02,12736,18,6828,104,11,7,19704
2021-03-03,12585,19,7231,193,7,9,20044
2021-03-04,14428,19,7225,158,12,5,21847
2021-03-05,16422,17,5251,123,14,8,21835
2021-03-06,13233,11,3165,202,4,2,16617
2021-03-07,15300,11,2874,188,5,7,18385
2021-03-08,12381,22,7318,95,10,10,19836
2021-03-09,11742,14,7692,111,9,1,19569
2021-03-10,13496,19,6915,166,13,10,20619
2021-03-11,11056,20,6252,137,19,13,17497
2021-03-12,15193,23,5694,113,11,11,21045
2021-03-13,10416,13,3542,140,16,9,14136
2021-03-14,10248,9,2034,129,10,5,12435
2021-03-15,11044,18,5818,110,9,4,17003
2021-03-16,11692,18,7498,97,11,8,19324
2021-03-17,11616,19,7392,166,8,12,19213
2021-03-18,12998,21,6957,160,7,5,20148
2021-03-19,17893,19,6194,142,10,15,24273
2021-03-20,12204,12,3832,205,15,5,16273
2021-03-21,13621,14,2797,183,6,8,16629
2021-03-22,12571,25,6656,110,4,6,19372
2021-03-23,11045,20,7302,106,8,7,18488
2021-03-24,12658,22,7323,164,10,11,20188
2021-03-25,13665,16,7379,194,4,13,21271
2021-03-26,21633,18,6454,140,11,10,28266
2021-03-27,20771,13,3828,221,15,15,24863
2021-03-28,15273,10,3135,175,12,13,18618
2021-03-29,12496,24,6873,111,17,29,19550
2021-03-30,14360,20,7225,109,14,13,21741
2021-03-31,17387,19,7158,162,22,18,24766
2021-04-01,20186,19,7047,179,10,26,27467
2021-04-02,22354,21,4906,159,20,20,27480
2021-04-03,13144,18,2240,175,8,16,15601
2021-04-04,12470,13,1365,149,7,11,14015
2021-04-05,18022,13,3547,332,3,18,21935
2021-04-06,14781,18,6332,129,7,6,21273
2021-04-07,13270,18,7272,166,3,13,20742
2021-04-08,13586,19,6980,159,18,14,20776
2021-04-09,20347,21,6320,143,13,13,26857
2021-04-10,17171,14,4243,215,9,21,21673
2021-04-11,14488,12,2934,209,13,17,17673
2021-04-12,12975,19,6540,94,9,7,19644
2021-04-13,11814,21,6835,132,6,5,18813
2021-04-14,13372,16,6679,175,12,17,20271
2021-04-15,14715,14,7197,159,18,16,22119
2021-04-16,20150,15,6011,136,11,21,26344
2021-04-17,15491,12,3529,169,12,16,19229
2021-04-18,15577,13,3186,142,4,18,18940
2021-04-19,14535,20,6878,87,10,6,21536
2021-04-20,12806,18,6947,91,12,16,19890
2021-04-21,14120,21,7703,147,16,15,22022
2021-04-22,15671,19,7047,156,12,11,22916
2021-04-23,28684,21,6210,139,17,21,35092
2021-04-24,23352,12,3635,170,12,33,27214
2021-04-25,19022,14,3574,173,17,15,22815
2021-04-26,16436,18,7081,103,18,11,23667
2021-04-27,16123,17,6102,99,13,7,22361
2021-04-28,16862,18,7853,183,20,14,24950
2021-04-29,22700,22,6618,176,20,20,29556
2021-04-30,30993,17,5282,134,17,27,36470
2021-05-01,21787,13,1699,214,22,26,23761
2021-05-02,17512,16,1765,200,9,19,19521
2021-05-03,19354,18,6158,101,18,16,25665
2021-05-04,17089,19,5916,101,21,10,23156
2021-05-05,17647,16,7288,179,16,17,25163
2021-05-06,18197,19,6576,171,23,25,25011
2021-05-07,26860,20,5828,158,14,23,32903
2021-05-08,27732,16,3930,205,25,41,31949
2021-05-09,23190,11,3055,259,21,27,26563
2021-05-10,18177,21,6828,124,22,22,25194
2021-05-11,18831,16,7674,132,30,14,26697
2021-05-12,28211,24,7237,172,22,26,35692
2021-05-13,28391,18,5884,157,23,19,34492
2021-05-14,26506,16,4726,151,25,18,31442
2021-05-15,27628,16,3303,195,15,23,31180
2021-05-16,33607,15,2974,281,18,31,36926
2021-05-17,21014,16,7136,141,18,16,28341
2021-05-18,18549,15,7518,133,27,22,26264
2021-05-19,19039,16,7605,185,13,13,26871
2021-05-20,23897,13,6621,184,26,35,30776
2021-05-21,37635,21,6094,165,23,37,43975
2021-05-22,38882,16,3692,259,18,50,42917
2021-05-23,27358,10,3312,221,19,22,30942
2021-05-24,26278,16,5659,174,11,32,32170
2021-05-25,20609,18,7352,123,36,28,28166
2021-05-26,21567,18,7609,210,31,40,29475
2021-05-27,23875,18,7379,189,29,45,31535
2021-05-28,35070,21,6629,205,39,51,42015
2021-05-29,34059,16,4293,265,79,51,38763
2021-05-30,28812,13,3063,247,17,35,32187
2021-05-31,21841,20,7124,148,23,36,29192
2021-06-01,22968,19,7313,140,33,45,30518
2021-06-02,32022,18,6857,343,72,62,39374
2021-06-03,41333,17,4851,218,48,74,46541
2021-06-04,38273,23,5988,239,54,48,44625
2021-06-05,39481,18,3789,279,50,77,43694
2021-06-06,37104,15,3216,277,32,66,40710
2021-06-07,26418,20,6886,190,47,42,33603
2021-06-08,22052,18,7826,147,40,49,30132
2021-06-09,25001,19,7359,219,34,55,32687
2021-06-10,30089,20,7110,219,43,56,37537
2021-06-11,45776,18,6501,244,50,83,52672
2021-06-12,39811,14,3899,323,66,95,44208
2021-06-13,35591,15,2740,285,55,77,38763
2021-06-14,31272,17,7064,167,26,52,38598
2021-06-15,27956,18,7744,168,59,49,35994
2021-06-16,29005,15,7885,264,53,46,37268
2021-06-17,35866,21,6931,254,61,90,43223
2021-06-18,53125,17,6229,264,87,72,59794
2021-06-19,54843,15,3990,423,99,143,59513
2021-06-20,51237,10,3231,358,76,74,54986
2021-06-21,34849,20,6464,236,85,61,41715
2021-06-22,29508,24,6053,250,73,67,35975
2021-06-23,38135,21,7645,353,95,66,46315
2021-06-24,58287,18,7065,306,92,92,65860
2021-06-25,60162,14,4804,296,117,122,65515
2021-06-26,59296,17,3646,594,145,153,63851
2021-06-27,58548,10,3019,456,93,113,62239
2021-06-28,41366,19,6557,264,85,73,48364
2021-06-29,33079,20,7320,223,55,77,40774
2021-06-30,40273,19,6753,368,65,79,47557
2021-07-01,54268,19,6739,406,84,131,61647
2021-07-02,66822,21,6044,460,138,114,73599
2021-07-03,70657,19,3566,705,196,222,75365
2021-07-04,69250,14,2914,385,89,138,72790
2021-07-05,48508,24,6805,258,99,121,55815
2021-07-06,36486,19,6793,256,159,102,43815
2021-07-07,37566,25,6915,346,130,130,45112
2021-07-08,49163,15,6117,386,109,82,55872
2021-07-09,64103,20,6244,375,163,162,71067
2021-07-10,80663,17,3693,537,214,201,85325
2021-07-11,63772,17,3817,414,149,156,68325
2021-07-12,55289,22,7406,238,128,114,63197
2021-07-13,44483,21,7331,269,55,104,52263
2021-07-14,49154,23,6942,371,77,113,56680
2021-07-15,53724,17,7815,406,116,126,62204
2021-07-16,77409,21,5917,372,107,139,83965
2021-07-17,88593,21,3602,575,86,188,93065
2021-07-18,72744,17,2874,448,164,163,76410
2021-07-19,72236,18,6025,264,189,137,78869
2021-07-20,52471,20,6609,223,189,132,59644
2021-07-21,54179,20,7139,393,137,133,62001
2021-07-22,59829,15,6509,378,126,164,67021
2021-07-23,85623,23,5842,471,216,183,92358
2021-07-24,104164,19,3899,545,273,231,109131
2021-07-25,87703,11,2738,3798,93,202,94545
2021-07-26,68192,15,6339,258,89,114,75007
2021-07-27,57327,16,6583,317,99,138,64480
2021-07-28,54000,21,7182,402,168,126,61899
2021-07-29,68655,23,6366,382,171,168,75765
2021-07-30,98000,16,5586,475,234,181,104492
2021-07-31,129844,12,3601,675,430,279,134841
2021-08-01,112605,11,3417,586,131,192,116942
2021-08-02,83037,19,6612,294,268,167,90397
2021-08-03,61608,24,6976,254,239,114,69215
2021-08-04,62555,16,6875,369,143,153,70111
2021-08-05,71466,18,5611,387,95,129,77706
2021-08-06,99559,16,5874,569,297,191,106506
2021-08-07,114238,16,2757,585,524,203,118323
2021-08-08,103361,13,2760,533,203,216,107086
2021-08-09,88512,20,6472,292,375,125,95796
2021-08-10,72179,16,7465,312,342,175,80489
2021-08-11,66871,21,6534,345,177,147,74095
2021-08-12,80024,25,6109,474,168,215,87015
2021-08-13,96905,22,5759,394,192,156,103428
2021-08-14,122516,16,2466,649,253,304,126204
2021-08-15,99449,17,2276,507,213,203,102665
2021-08-16,88525,19,6186,358,146,148,95382
2021-08-17,64183,22,6681,354,74,133,71447
2021-08-18,68478,19,6528,405,79,143,75652
2021-08-19,75444,21,5886,382,156,170,82059
2021-08-20,90670,20,5441,479,143,238,96991
2021-08-21,108276,15,3745,703,125,236,113100
2021-08-22,97309,13,2587,649,113,214,100885
2021-08-23,77583,18,6197,342,67,101,84308
2021-08-24,61470,19,7816,311,91,143,69850
2021-08-25,59720,22,6806,384,42,150,67124
2021-08-26,68550,22,6635,413,79,167,75866
2021-08-27,79762,19,6036,441,63,126,86447
2021-08-28,84657,13,2804,571,58,196,88299
2021-08-29,73992,15,3086,460,78,171,77802
2021-08-30,62804,18,6918,311,100,133,70284
2021-08-31,50625,21,7106,291,59,142,58244
2021-09-01,51576,23,7191,364,66,156,59376
2021-09-02,53079,11,6814,368,72,145,60489
2021-09-03,69845,18,6303,398,82,178,76824
2021-09-04,68414,16,3181,523,110,195,72439
2021-09-05,66991,10,2796,467,58,186,70508
2021-09-06,50973,18,7048,290,59,88,58476
2021-09-07,41651,17,7361,308,65,129,49531
2021-09-08,40398,20,6962,354,48,98,47880
2021-09-09,46680,15,6856,363,79,145,54138
2021-09-10,61574,15,6571,393,93,146,68792
2021-09-11,64092,13,3695,588,75,227,68690
2021-09-12,56214,15,3256,422,52,138,60097
2021-09-13,41275,20,6679,289,49,118,48430
2021-09-14,33778,16,7742,260,38,92,41926
2021-09-15,36729,22,7313,382,38,109,44593
2021-09-16,35918,19,6980,337,43,101,43398
2021-09-17,46019,21,6325,401,32,110,52908
2021-09-18,45452,18,3484,450,38,194,49636
2021-09-19,45859,15,2967,413,40,142,49436
2021-09-20,34553,21,7055,289,29,91,42038
2021-09-21,29418,20,7405,303,37,104,37287
2021-09-22,29764,19,7642,345,36,96,37902
2021-09-23,34910,16,7472,363,33,130,42924
2021-09-24,46832,20,6125,325,45,123,53470
2021-09-25,44271,10,3367,508,48,196,48400
2021-09-26,39391,15,3100,400,31,133,43070
2021-09-27,29975,12,6921,248,35,102,37293
2021-09-28,26034,18,7322,257,26,101,33758
2021-09-29,26503,17,7427,342,13,89,34391
2021-09-30,28904,19,7520,348,19,87,36897
2021-10-01,42395,15,7145,305,44,107,50011
2021-10-02,38905,12,3901,411,22,141,43392
2021-10-03,34547,11,2980,374,21,112,38045
2021-10-04,27646,17,7753,226,19,53,35714
2021-10-05,22921,15,7644,231,18,71,30900
2021-10-06,23044,23,7623,297,22,56,31065
2021-10-07,25155,17,7019,353,12,64,32620
2021-10-08,36466,21,5964,306,14,69,42840
2021-10-09,34430,17,3665,403,13,122,38650
2021-10-10,31389,10,2971,542,6,85,35003
2021-10-11,25058,16,6628,237,21,71,32031
2021-10-12,23012,15,7272,244,28,57,30628
2021-10-13,752368,12,299216,9044,14,55,1060709
2021-10-14,821355,18,325100,9846,17,60,1156396
2021-10-15,38505,14,6570,312,35,84,45520
2021-10-16,34363,10,3555,388,25,110,38451
2021-10-17,34256,9,2752,336,25,84,37462
2021-10-18,25444,14,7038,227,33,66,32822
2021-10-19,22161,13,7724,229,21,71,30219
2021-10-20,24062,16,7332,281,23,56,31770
2021-10-21,26936,14,7451,274,20,57,34752
2021-10-22,43529,15,6407,341,17,54,50363
2021-10-23,39279,13,3954,464,15,110,43835
2021-10-24,34434,12,2995,320,15,75,37851
2021-10-25,28505,17,7081,228,20,55,35906
2021-10-26,28824,18,7135,219,18,56,36270
2021-10-27,29109,15,7972,279,14,52,37441
2021-10-28,31500,18,7541,304,23,56,39442
2021-10-29,46677,18,6829,291,21,57,53893
2021-10-30,39552,12,3949,362,20,64,43959
2021-10-31,32685,10,1806,258,11,33,34803
2021-11-01,36296,16,3432,229,9,13,39995
2021-11-02,28895,18,7243,210,9,23,36398
2021-11-03,21296,17,7520,263,12,15,29123
2021-11-04,22619,19,7582,279,14,10,30523
2021-11-05,27953,16,6425,282,14,19,34709
2021-11-06,26623,12,3893,321,10,35,30894
2021-11-07,25308,11,3076,308,11,19,28733
2021-11-08,19875,19,7109,171,9,12,27195
2021-11-09,17516,16,6981,179,9,11,24712
2021-11-10,20526,16,6608,253,15,19,27437
2021-11-11,23638,20,7140,246,16,14,31074
2021-11-12,29115,16,6970,234,14,12,36361
2021-11-13,22793,11,3420,325,16,17,26582
2021-11-14,26266,10,2846,282,10,17,29431
2021-11-15,19627,19,6668,171,9,14,26508
2021-11-16,18248,16,7476,174,6,13,25933
2021-11-17,20196,13,7367,245,7,13,27841
2021-11-18,20562,16,6016,233,10,16,26853
2021-11-19,30853,17,6476,219,16,15,37596
2021-11-20,24394,9,3511,294,6,12,28226
2021-11-21,26093,10,3020,276,4,10,29413
2021-11-22,21889,15,6224,170,10,14,28322
2021-11-23,18261,15,7211,170,7,5,25669
2021-11-24,19540,10,7409,216,13,14,27202
2021-11-25,23223,20,6764,268,9,10,30294
2021-11-26,26081,15,6151,221,12,6,32486
2021-11-27,19117,11,3214,306,4,11,22663
2021-11-28,23637,9,2993,247,8,10,26904
2021-11-29,19168,16,6914,154,7,11,26270
2021-11-30,17488,16,7157,156,18,11,24846
2021-12-01,18089,17,7368,229,5,15,25723
2021-12-02,18231,15,6696,213,7,12,25174
2021-12-03,26056,15,5673,219,11,9,31983
2021-12-04,21078,6,3602,329,11,17,25043
2021-12-05,19869,9,2831,243,7,15,22974
2021-12-06,17949,12,6611,159,6,14,24751
2021-12-07,18598,13,7758,157,5,8,26539
2021-12-08,18926,16,6953,218,10,19,26142
2021-12-09,16858,16,5485,229,7,16,22611
2021-12-10,24998,14,5862,197,6,10,31087
2021-12-11,21901,10,3453,334,8,14,25720
2021-12-12,22191,7,2719,257,2,14,25190
2021-12-13,17320,17,6380,171,10,12,23910
2021-12-14,18015,16,7793,155,6,9,25994
2021-12-15,20610,22,7095,259,6,12,28004
2021-12-16,23742,15,6650,247,11,13,30678
2021-12-17,32174,16,6335,262,5,17,38809
2021-12-18,33924,8,3607,423,5,17,37984
2021-12-19,26908,13,3212,320,4,16,30473
2021-12-20,23965,15,8041,212,10,14,32257
2021-12-21,25046,18,7131,241,11,14,32461
2021-12-22,36490,20,6585,410,15,16,43536
2021-12-23,48786,23,5840,373,14,13,55049
2021-12-24,51962,16,3392,388,6,12,55776
2021-12-25,26936,9,994,343,6,7,28295
2021-12-26,26598,9,2093,341,7,17,29065
2021-12-27,27629,20,5075,188,16,13,32941
2021-12-28,28445,14,3745,206,7,17,32434
2021-12-29,30152,18,3469,339,7,19,34004
2021-12-30,41254,16,2652,315,11,19,44267
2021-12-31,28582,18,1031,170,4,13,29818
2022-01-01,27573,8,488,171,4,14,28258
2022-01-02,37373,16,1563,331,4,18,39305
2022-01-03,31611,24,3719,208,6,16,35584
2022-01-04,27699,15,3937,199,9,12,31871
2022-01-05,31556,13,3062,289,10,13,34943
2022-01-06,29930,17,1939,279,3,13,32181
2022-01-07,35468,16,2890,245,11,15,38645
2022-01-08,45904,8,2398,374,5,15,48704
2022-01-09,44924,5,2724,461,4,19,48137
2022-01-10,28033,17,5223,317,7,13,33610
2022-01-11,18850,14,6649,216,9,7,25745
2022-01-12,18237,14,6345,257,7,10,24870
2022-01-13,19345,14,6241,249,5,8,25862
2022-01-14,27016,13,5253,216,11,14,32523
2022-01-15,23929,8,2817,292,8,13,27067
2022-01-16,22942,8,3049,305,6,12,26322
2022-01-17,19324,16,6425,163,14,12,25954
2022-01-18,17078,18,6036,172,15,6,23325
2022-01-19,17387,12,6816,238,13,7,24473
2022-01-20,18198,11,6435,219,8,10,24881
2022-01-21,24393,14,5113,211,12,10,29753
2022-01-22,21863,7,2603,283,4,13,24773
2022-01-23,21945,8,3081,257,5,12,25308
2022-01-24,17663,13,6386,160,10,9,24241
2022-01-25,16126,16,6966,158,5,7,23278
2022-01-26,16724,12,6343,242,10,10,23341
2022-01-27,17963,18,6803,215,11,9,25019
2022-01-28,25038,16,5467,216,14,8,30759
2022-01-29,21143,10,2652,269,5,13,24092
2022-01-30,22413,9,2969,251,2,14,25658
2022-01-31,17740,19,6961,162,11,9,24902
2022-02-01,16584,15,6437,168,6,4,23214
2022-02-02,17245,14,6362,236,9,11,23877
2022-02-03,19727,18,7072,229,8,15,27069
2022-02-04,28616,14,4920,200,12,18,33780
2022-02-05,26926,9,4442,276,10,11,31674
2022-02-06,23716,9,3000,233,12,16,26986
2022-02-07,20750,17,6838,155,2,12,27774
2022-02-08,22927,11,4937,160,9,11,28055
2022-02-09,19593,13,7745,218,14,9,27592
2022-02-10,21781,16,6807,221,8,17,28850
2022-02-11,28295,13,6023,217,13,14,34575
2022-02-12,27013,8,3270,287,5,13,30596
2022-02-13,26765,7,3228,273,9,19,30301
2022-02-14,21051,12,6188,156,3,10,27420
2022-02-15,19248,18,6581,154,2,11,26014
2022-02-16,19562,13,6658,215,17,11,26476
2022-02-17,23708,15,7042,227,8,10,31010
2022-02-18,33244,14,5430,209,14,16,38927
2022-02-19,28157,8,2931,288,5,16,31405
2022-02-20,31483,7,3018,261,5,12,34786
2022-02-21,22698,14,6882,172,7,11,29784
2022-02-22,20387,15,6856,180,11,8,27457
2022-02-23,23553,16,7577,277,5,15,31443
2022-02-24,26172,18,7151,260,7,18,33626
2022-02-25,34459,17,6253,219,9,15,40972
2022-02-26,32860,7,3191,318,2,12,36390
2022-02-27,32560,11,2926,298,2,16,35813
2022-02-28,24761,16,6332,164,5,13,31291
2022-03-01,22068,13,6731,175,5,11,29003
2022-03-02,21666,13,6992,243,10,14,28938
2022-03-03,24869,13,7051,269,8,21,32231
2022-03-04,32727,17,6518,264,13,13,39552
2022-03-05,29946,7,3262,339,6,11,33571
2022-03-06,29441,9,2910,336,3,15,32714
2022-03-07,22744,14,6112,174,11,15,29070
2022-03-08,18505,17,7130,178,5,13,25848
2022-03-09,19153,12,6977,232,11,10,26395
2022-03-10,23436,14,7321,257,14,13,31055
2022-03-11,34120,16,6136,268,16,23,40579
2022-03-12,28328,13,2924,352,9,15,31641
2022-03-13,31035,13,2958,311,8,15,34340
2022-03-14,21828,15,6836,186,12,21,28898
2022-03-15,21538,16,6590,184,15,16,28359
2022-03-16,20930,17,7721,244,15,14,28941
2022-03-17,25472,13,7237,274,14,16,33026
2022-03-18,34387,14,7056,264,13,17,41751
2022-03-19,30055,10,2889,347,12,20,33333
2022-03-20,32858,11,2914,327,9,20,36139
2022-03-21,23829,12,7339,176,14,17,31387
2022-03-22,21316,17,7818,180,12,13,29356
2022-03-23,22100,14,7315,241,9,20,29699
2022-03-24,24817,14,7585,238,11,23,32688
2022-03-25,37545,15,6386,298,23,27,44294
2022-03-26,31146,8,3782,378,19,25,35358
2022-03-27,33356,14,2848,319,20,54,36611
2022-03-28,22947,15,7295,195,8,29,30489
2022-03-29,20547,20,7901,175,15,34,28692
2022-03-30,20827,15,7946,244,15,40,29087
2022-03-31,24071,17,7497,253,6,39,31883
2022-04-01,30787,19,6698,242,22,40,37808
2022-04-02,27129,14,3534,350,20,42,31089
2022-04-03,29723,12,3024,344,15,58,33176
2022-04-04,23828,13,9042,205,15,39,33142
2022-04-05,20755,19,8177,199,16,39,29205
2022-04-06,23141,18,8011,279,12,30,31491
2022-04-07,26676,17,7668,300,16,44,34721
2022-04-08,41037,15,6431,301,14,47,47845
2022-04-09,43627,11,3883,404,15,87,48027
2022-04-10,39327,12,3179,390,27,71,43006
2022-04-11,29743,16,8027,217,27,56,38086
2022-04-12,29032,19,8138,242,32,47,37510
2022-04-13,33586,17,8144,325,27,62,42161
2022-04-14,49315,13,7248,390,42,59,57067
2022-04-15,76905,18,3853,344,49,62,81231
2022-04-16,46053,8,2503,346,19,85,49014
2022-04-17,39261,7,1664,323,5,66,41326
2022-04-18,54767,9,3768,394,28,50,59016
2022-04-19,39260,15,7493,329,13,53,47163
2022-04-20,30676,16,7612,316,13,56,38689
2022-04-21,35650,22,7354,352,19,75,43472
2022-04-22,48869,20,6095,293,17,37,55331
2022-04-23,52166,14,3429,513,28,99,56249
2022-04-24,39023,14,1917,428,22,89,41493
2022-04-25,40230,17,7089,314,34,58,47742
2022-04-26,40732,21,7243,281,22,52,48351
2022-04-27,50281,13,6228,375,45,64,57006
2022-04-28,43904,19,8228,380,34,81,52646
2022-04-29,66913,14,6729,388,35,72,74151
2022-04-30,58713,10,3352,575,40,124,62814
2022-05-01,42141,11,2214,405,35,111,44917
2022-05-02,39698,13,3958,250,31,65,44015
2022-05-03,36352,12,6380,312,24,71,43151
2022-05-04,31266,14,6512,357,36,71,38256
2022-05-05,33712,21,7478,433,30,86,41760
2022-05-06,42311,22,6121,400,39,68,48961
2022-05-07,40829,10,3301,481,37,113,44771
2022-05-08,45766,14,3067,505,23,110,49485
2022-05-09,35006,15,7293,315,31,67,42727
2022-05-10,27908,19,7600,293,35,73,35928
2022-05-11,27837,13,8086,394,29,99,36458
2022-05-12,33704,16,7784,384,43,97,42028
2022-05-13,47280,20,6939,413,46,83,54781
2022-05-14,43747,11,3169,501,41,161,47630
2022-05-15,43352,14,2859,478,61,125,46889
2022-05-16,31698,18,7575,336,48,70,39745
2022-05-17,28478,20,8301,283,35,78,37195
2022-05-18,29679,19,7844,371,37,84,38034
2022-05-19,33238,16,7263,437,42,106,41102
2022-05-20,49400,14,6317,419,63,93,56306
2022-05-21,55061,11,3559,659,54,211,59555
2022-05-22,52728,14,2925,544,48,148,56407
2022-05-23,34974,17,7432,336,43,83,42885
2022-05-24,32540,14,7811,326,24,82,40797
2022-05-25,50437,17,7817,456,54,115,58896
2022-05-26,60201,16,7298,447,70,152,68184
2022-05-27,51293,15,5771,397,71,95,57642
2022-05-28,43740,13,3529,581,48,135,48046
2022-05-29,50421,15,2711,498,30,151,53826
2022-05-30,36226,15,5783,338,68,79,42509
2022-05-31,33759,17,8012,289,73,97,42247
2022-06-01,40189,16,7848,393,121,128,48695
2022-06-02,54816,15,6846,467,372,126,62642
2022-06-03,77632,15,5457,453,139,134,83830
2022-06-04,83866,14,3522,643,125,207,88377
2022-06-05,65607,15,2679,490,91,148,69030
2022-06-06,51684,20,6187,448,86,95,58520
2022-06-07,38601,19,7912,332,61,115,47040
2022-06-08,38460,18,7391,383,67,118,46437
2022-06-09,44287,17,7382,411,53,98,52248
2022-06-10,69186,18,6632,474,123,140,76573
2022-06-11,72066,12,3651,659,101,221,76710
2022-06-12,70346,14,2956,520,96,174,74106
2022-06-13,46319,15,7397,368,99,90,54288
2022-06-14,38805,16,7912,360,80,127,47300
2022-06-15,57845,17,7175,415,93,150,65695
2022-06-16,75018,18,5321,509,137,182,81185
2022-06-17,71346,23,6634,517,123,129,78772
2022-06-18,81031,13,3420,730,144,229,85567
2022-06-19,81392,16,2985,644,111,175,85323
2022-06-20,56945,18,7379,485,95,132,65054
2022-06-21,42175,17,7539,439,93,124,50387
2022-06-22,42418,15,6603,526,110,134,49806
2022-06-23,51502,19,7216,476,105,164,59482
2022-06-24,75963,18,6139,596,133,158,83007
2022-06-25,89059,13,3962,864,163,227,94288
2022-06-26,76613,14,3086,667,117,191,80688
2022-06-27,62979,17,7397,511,125,158,71187
2022-06-28,44215,20,6848,410,76,164,51733
2022-06-29,45100,23,7646,487,75,156,53487
2022-06-30,56887,20,7225,504,148,152,64936
2022-07-01,86578,17,6368,765,142,201,94071
2022-07-02,81297,14,3306,885,231,261,85994
2022-07-03,79199,17,3172,622,179,226,83415
2022-07-04,59970,17,6781,413,165,152,67498
2022-07-05,48462,25,7079,380,83,146,56175
2022-07-06,51260,19,6940,484,81,183,58967
2022-07-07,63546,20,6938,586,70,147,71307
2022-07-08,90032,22,5849,545,94,180,96722
2022-07-09,94511,14,2357,735,163,256,98036
2022-07-10,87022,14,3278,578,209,223,91324
2022-07-11,78143,21,6791,411,115,146,85627
2022-07-12,53501,21,7285,392,134,172,61505
2022-07-13,57035,18,7445,521,109,161,65289
2022-07-14,66731,17,6945,478,150,185,74506
2022-07-15,95959,24,6249,509,180,173,103094
2022-07-16,127436,15,2918,687,274,218,131548
2022-07-17,107237,13,3143,642,112,226,111373
2022-07-18,86870,18,6925,389,182,172,94556
2022-07-19,59266,25,7144,366,156,160,67117
2022-07-20,63275,14,6751,460,189,181,70870
2022-07-21,71129,16,5852,505,149,195,77846
2022-07-22,102687,14,5494,615,206,197,109213
2022-07-23,128318,13,3010,764,253,267,132625
2022-07-24,102877,16,2816,655,165,239,106768
2022-07-25,89959,18,6163,339,152,146,96777
2022-07-26,70007,22,7124,375,84,180,77792
2022-07-27,69814,23,7078,475,89,173,77652
2022-07-28,80998,18,5974,513,146,198,87847
2022-07-29,127866,21,5699,581,249,183,134599
2022-07-30,139531,15,2770,774,263,287,143640
2022-07-31,120266,19,2730,748,299,218,124280
2022-08-01,103697,17,6032,415,284,221,110666
2022-08-02,70867,19,6980,357,195,223,78641
2022-08-03,75815,16,6454,478,194,221,83178
2022-08-04,88210,26,5958,439,193,229,95055
2022-08-05,106811,22,3700,577,341,236,111687
2022-08-06,131690,18,2781,1081,507,337,136414
2022-08-07,109089,13,2603,696,157,290,112848
2022-08-08,99157,20,6777,394,253,180,106781
2022-08-09,73065,18,6474,426,161,240,80384
2022-08-10,76420,15,6097,496,116,227,83371
2022-08-11,86952,22,6231,508,242,232,94187
2022-08-12,114116,22,4882,514,184,186,119904
2022-08-13,133986,11,2476,805,188,309,137775
2022-08-14,113617,16,1544,615,365,258,116415
2022-08-15,106495,11,3511,464,217,213,110911
2022-08-16,77003,26,6536,436,100,203,84304
2022-08-17,76944,11,5752,527,172,172,83578
2022-08-18,81861,19,5909,508,82,211,88590
2022-08-19,105642,21,4937,530,59,162,111351
2022-08-20,114395,13,2432,1033,129,303,118305
2022-08-21,102269,16,2460,831,134,255,105965
2022-08-22,84799,17,6167,520,98,200,91801
2022-08-23,65470,21,6664,420,82,203,72860
2022-08-24,69483,22,6340,526,69,189,76629
2022-08-25,83055,16,5680,531,89,232,89603
2022-08-26,88746,18,5217,613,83,196,94873
2022-08-27,106036,15,2974,838,90,249,110202
2022-08-28,96251,20,2947,698,81,239,100236
2022-08-29,76552,15,6751,469,88,157,84032
2022-08-30,57902,19,7086,408,63,204,65682
2022-08-31,31830,15,6846,436,15,73,39215
2022-09-01,65216,26,6257,431,42,175,72147
2022-09-02,81102,16,5664,552,71,182,87587
2022-09-03,89478,15,3277,752,67,273,93862
2022-09-04,83971,15,2890,622,76,244,87818
2022-09-05,59931,17,7239,428,75,154,67844
2022-09-06,48603,21,6438,425,58,154,55699
2022-09-07,41388,21,6930,479,44,153,49015
2022-09-08,52594,16,6651,570,47,156,60034
2022-09-09,65472,26,5905,590,27,160,72180
2022-09-10,73823,10,3323,780,77,219,78232
2022-09-11,66171,18,2729,618,81,203,69820
2022-09-12,48762,17,6598,481,54,165,56077
2022-09-13,38835,21,7206,402,42,132,46638
2022-09-14,41311,24,6420,458,40,109,48362
2022-09-15,42067,16,6745,483,37,162,49510
2022-09-16,55913,19,5436,604,24,122,62118
2022-09-17,52634,15,3454,787,17,702,57609
2022-09-18,59769,15,2961,562,58,170,63535
2022-09-19,41700,19,6315,484,58,113,48689
2022-09-20,37479,17,6779,463,48,158,44944
2022-09-21,36853,23,6694,510,32,127,44239
2022-09-22,41742,13,6492,529,25,140,48941
2022-09-23,54281,17,6466,551,26,168,61509
2022-09-24,48716,15,3632,723,31,164,53281
2022-09-25,45011,18,2804,609,17,198,48657
2022-09-26,35606,17,6863,465,28,117,43096
2022-09-27,29378,16,7526,400,19,138,37477
2022-09-28,31449,16,7099,502,18,125,39209
2022-09-29,33945,23,6880,486,22,135,41491
2022-09-30,48216,18,5973,495,28,120,54850
2022-10-01,46191,10,3407,608,51,211,50478
2022-10-02,47257,9,2734,578,36,173,50787
2022-10-03,36118,19,7124,393,30,87,43771
2022-10-04,29436,19,7451,407,35,114,37462
2022-10-05,30552,18,6941,554,36,80,38181
2022-10-06,35377,14,7026,449,35,127,43028
2022-10-07,46925,20,6177,421,27,107,53677
2022-10-08,43727,10,3833,660,29,155,48414
2022-10-09,40545,14,3101,506,25,118,44309
2022-10-10,29582,17,6971,363,35,106,37074
2022-10-11,26238,21,7296,350,32,102,34039
2022-10-12,27192,20,7331,430,29,70,35072
2022-10-13,32739,18,8548,440,25,85,41855
2022-10-14,46827,20,6266,435,18,107,53673
2022-10-15,44019,18,3524,635,25,148,48369
2022-10-16,43110,12,2795,539,21,93,46570
2022-10-17,30530,20,7182,347,28,68,38175
2022-10-18,25845,17,6930,368,13,112,33285
2022-10-19,27924,23,6996,406,16,61,35426
2022-10-20,31830,15,6846,436,15,73,39215
2022-10-21,43623,21,6617,441,14,70,50786
2022-10-22,39469,16,3096,581,17,150,43329
2022-10-23,38707,14,3074,537,11,107,42450
2022-10-24,28970,16,7447,333,20,77,36863
2022-10-25,29534,21,7458,339,22,89,37463
2022-10-26,37881,21,7691,409,34,103,46139
2022-10-27,36587,21,6919,421,13,105,44066
2022-10-28,67259,15,6479,422,26,60,74261
2022-10-29,62625,11,3656,617,40,121,67070
2022-10-30,47537,11,2117,422,32,76,50195
2022-10-31,45626,18,3912,289,17,45,49907
2022-11-01,50353,15,3955,312,10,23,54668
2022-11-02,38151,15,7306,354,13,18,45857
2022-11-03,29821,23,6693,376,20,44,36977
2022-11-04,35240,15,6279,328,16,23,41901
