,osobni automobili,vlakovi,teretna vozila,autobusi,plovila,zrakoplovi,UKUPNO
2013-01-01,22074,7,185,287,8,18,22579
2013-01-02,31509,7,957,560,16,26,33075
2013-01-03,24203,7,1161,534,10,23,25938
2013-01-04,35534,10,912,373,14,16,36859
2013-01-05,42419,8,913,503,14,13,43870
2013-01-06,35384,5,491,588,6,17,36491
2013-01-07,21680,8,1589,232,11,20,23540
2013-01-08,23841,8,1671,259,5,15,25799
2013-01-09,18959,6,1288,316,9,21,20599
2013-01-10,19630,11,1351,335,9,18,21354
2013-01-11,21842,11,1106,382,7,23,23371
2013-01-12,24282,9,569,328,8,15,25211
2013-01-13,21563,6,536,430,5,18,22558
2013-01-14,15556,6,938,237,6,16,16759
2013-01-15,15568,9,2095,308,5,17,18002
2013-01-16,16740,10,1587,282,5,18,18642
2013-01-17,15427,10,1419,314,5,12,17187
2013-01-18,17881,9,1010,583,12,18,19513
2013-01-19,19543,9,649,332,3,16,20552
2013-01-20,18928,5,649,404,2,18,20006
2013-01-21,18554,6,1684,231,7,12,20494
2013-01-22,16041,11,2106,281,5,15,18459
2013-01-23,16501,12,1736,282,9,16,18556
2013-01-24,17385,12,1568,277,7,17,19266
2013-01-25,17875,8,1016,275,13,22,19209
2013-01-26,18937,9,624,346,13,16,19945
2013-01-27,19865,7,665,368,6,19,20930
2013-01-28,16815,10,1858,220,11,19,18933
2013-01-29,16186,10,1719,246,8,15,18184
2013-01-30,17663,9,1861,297,11,18,19859
2013-01-31,19429,6,1690,303,13,18,21459
2013-02-01,21659,14,1364,315,10,19,23381
2013-02-02,19720,10,678,351,5,16,20780
2013-02-03,19105,6,746,290,5,20,20172
2013-02-04,18597,8,1985,211,6,21,20828
2013-02-05,17516,10,1700,267,7,15,19515
2013-02-06,16451,8,1616,315,12,16,18418
2013-02-07,18758,10,1688,260,13,13,20742
2013-02-08,22040,10,1113,283,13,17,23476
2013-02-09,21689,8,973,382,14,13,23079
2013-02-10,23719,9,541,420,7,19,24715
2013-02-11,18499,8,1985,260,8,21,20781
2013-02-12,15260,6,1778,254,2,15,17315
2013-02-13,16071,8,1727,298,10,14,18128
2013-02-14,17815,6,1618,274,9,17,19739
2013-02-15,18576,11,1711,259,19,22,20598
2013-02-16,21760,7,905,297,6,17,22992
2013-02-17,24264,8,700,400,5,18,25395
2013-02-18,18888,8,2229,265,9,17,21416
2013-02-19,17374,11,1877,236,16,14,19528
2013-02-20,16787,8,2003,288,13,20,19119
2013-02-21,17323,9,1785,305,13,15,19450
2013-02-22,18892,11,1412,351,11,18,20695
2013-02-23,16775,7,714,334,9,11,17850
2013-02-24,19669,7,664,387,3,21,20751
2013-02-25,17853,8,1979,273,4,17,20134
2013-02-26,17033,11,1802,282,13,17,19158
2013-02-27,18388,8,1839,303,6,15,20559
2013-02-28,20641,8,1824,317,8,20,22818
2013-03-01,25752,10,1404,363,13,18,27560
2013-03-02,22768,11,790,342,17,20,23948
2013-03-03,28694,5,682,392,10,19,29802
2013-03-04,20944,8,1971,292,8,21,23244
2013-03-05,19714,8,2011,288,11,19,22051
2013-03-06,19430,11,1905,307,7,17,21677
2013-03-07,18961,9,1813,322,8,17,21130
2013-03-08,23522,8,1484,384,10,19,25427
2013-03-09,22717,9,722,345,11,15,23819
2013-03-10,25795,5,561,572,5,21,26959
2013-03-11,19603,8,2042,331,14,20,22018
2013-03-12,18828,13,2317,279,18,12,21467
2013-03-13,19004,11,1967,305,10,23,21320
2013-03-14,16668,10,1280,387,13,21,18379
2013-03-15,22573,8,1239,406,11,17,24254
2013-03-16,23706,10,752,491,30,16,25005
2013-03-17,26322,6,757,505,15,23,27628
2013-03-18,19518,10,2141,265,3,20,21957
2013-03-19,21366,9,1937,323,10,7,23652
2013-03-20,19517,13,1916,381,20,20,21867
2013-03-21,21522,13,1795,373,21,3,23727
2013-03-22,27092,14,1297,451,28,27,28909
2013-03-23,29666,9,793,509,33,26,31036
2013-03-24,27078,6,688,497,6,30,28305
2013-03-25,18990,10,1976,305,10,19,21310
2013-03-26,18154,9,1835,325,16,25,20364
2013-03-27,22677,9,1955,407,19,26,25093
2013-03-28,29897,14,1686,450,28,25,32100
2013-03-29,39288,11,1120,441,24,26,40910
2013-03-30,28326,10,455,454,18,27,29290
2013-03-31,25205,4,235,345,7,31,25827
2013-04-01,44726,4,625,543,18,46,45962
2013-04-02,31701,9,2244,451,11,41,34457
2013-04-03,22484,7,1861,430,26,30,24838
2013-04-04,21666,8,1910,408,34,32,24058
2013-04-05,25825,4,1555,426,24,35,27869
2013-04-06,29665,7,901,510,25,41,31149
2013-04-07,32950,7,751,599,20,40,34367
2013-04-08,19695,8,2051,321,24,39,22138
2013-04-09,19048,10,2239,371,17,39,21724
2013-04-10,20733,8,2051,378,20,35,23225
2013-04-11,20802,11,1819,390,25,36,23083
2013-04-12,23880,12,1360,453,28,25,25758
2013-04-13,27302,9,781,569,32,51,28744
2013-04-14,36145,7,657,590,27,45,37471
2013-04-15,22301,7,2114,296,32,40,24790
2013-04-16,19245,10,1686,343,37,45,21366
2013-04-17,21905,10,2139,457,34,38,24583
2013-04-18,23121,7,1928,470,29,45,25600
2013-04-19,25464,11,1567,441,31,60,27574
2013-04-20,29967,10,825,549,22,70,31443
2013-04-21,35701,9,763,712,24,50,37259
2013-04-22,22428,7,2558,395,24,37,25449
2013-04-23,21200,11,2079,373,23,43,23729
2013-04-24,22198,11,2390,521,31,37,25188
2013-04-25,28857,9,1965,647,34,40,31552
2013-04-26,33172,10,2212,645,60,62,36161
2013-04-27,45816,9,685,774,53,96,47433
2013-04-28,43402,9,839,977,61,65,45353
2013-04-29,31251,9,2318,546,43,51,34218
2013-04-30,40060,11,2004,620,67,53,42815
2013-05-01,42570,11,630,819,78,60,44168
2013-05-02,41981,9,1348,633,65,47,44083
2013-05-03,37639,11,1865,687,88,57,40347
2013-05-04,60329,10,840,1167,144,126,62616
2013-05-05,63129,8,474,906,57,108,64682
2013-05-06,34345,8,2294,477,22,59,37205
2013-05-07,25513,11,2221,468,32,65,28310
2013-05-08,25091,11,2113,618,46,53,27932
2013-05-09,31844,9,1895,606,72,76,34502
2013-05-10,30084,11,1531,573,81,58,32338
2013-05-11,33081,9,758,603,57,120,34628
2013-05-12,51696,8,749,767,47,116,53383
2013-05-13,26890,6,2257,445,16,56,29670
2013-05-14,23214,11,2164,419,54,60,25922
2013-05-15,24076,11,2310,555,57,50,27059
2013-05-16,28197,9,2490,557,24,54,31331
2013-05-17,33374,11,1681,734,45,64,35909
2013-05-18,35203,13,720,671,60,149,36816
2013-05-19,37331,10,631,728,48,75,38823
2013-05-20,40323,8,2568,682,48,60,43689
2013-05-21,30213,9,2154,539,58,69,33042
2013-05-22,25583,10,2061,545,51,56,28306
2013-05-23,27259,9,2249,570,44,57,30188
2013-05-24,35854,10,2011,655,63,63,38656
2013-05-25,32786,8,761,892,35,155,34637
2013-05-26,37008,6,719,785,41,82,38641
2013-05-27,26601,9,2624,476,41,60,29811
2013-05-28,25965,9,2451,533,54,63,29075
2013-05-29,29726,10,1875,663,66,58,32398
2013-05-30,35911,8,1048,726,56,61,37810
2013-05-31,36442,8,1671,561,62,66,38810
2013-06-01,41518,10,1001,886,45,169,43629
2013-06-02,54785,7,653,935,63,96,56539
2013-06-03,28429,7,2334,655,47,70,31542
2013-06-04,26473,8,2540,573,42,74,29710
2013-06-05,25296,7,2305,547,41,63,28259
2013-06-06,26793,7,1825,573,58,61,29317
2013-06-07,30820,9,1572,736,90,91,33318
2013-06-08,37173,9,974,849,79,195,39279
2013-06-09,51104,7,703,951,95,114,52974
2013-06-10,29761,6,2220,590,45,77,32699
2013-06-11,25498,7,2372,491,53,72,28493
2013-06-12,25781,7,2244,566,37,79,28714
2013-06-13,30466,7,2169,540,58,93,33333
2013-06-14,36945,7,1865,715,76,81,39689
2013-06-15,41526,8,926,976,90,209,43735
2013-06-16,59062,7,740,989,211,137,61146
2013-06-17,32154,9,2444,545,64,78,35294
2013-06-18,29830,8,2217,522,75,86,32738
2013-06-19,30520,9,2349,571,85,95,33629
2013-06-20,35286,7,2325,587,78,95,38378
2013-06-21,46779,8,2131,738,133,93,49882
2013-06-22,57214,9,886,1225,109,215,59658
2013-06-23,59759,9,786,1043,219,162,61978
2013-06-24,43670,11,2436,562,60,83,46822
2013-06-25,46218,9,1314,592,74,92,48299
2013-06-26,38216,12,2161,666,61,95,41211
2013-06-27,38315,7,2084,656,67,112,41241
2013-06-28,49888,12,2240,676,140,88,53044
2013-06-29,64086,8,1101,1186,105,219,66705
2013-06-30,68296,10,663,1391,182,134,70676
2013-07-01,39496,10,1964,641,63,99,42273
2013-07-02,33894,12,1953,616,85,105,36665
2013-07-03,32462,10,2127,723,83,90,35495
2013-07-04,38014,7,1780,643,90,113,40647
2013-07-05,48608,11,1680,719,121,111,51250
2013-07-06,68750,7,863,1144,125,238,71127
2013-07-07,77787,7,771,996,193,148,79902
2013-07-08,48858,8,2512,558,77,110,52123
2013-07-09,39263,8,2043,598,62,110,42084
2013-07-10,42051,8,2191,632,75,114,45071
2013-07-11,47521,7,2245,728,80,111,50692
2013-07-12,55533,10,1547,722,146,92,58050
2013-07-13,76456,7,962,837,145,241,78648
2013-07-14,88788,8,685,1026,219,165,90891
2013-07-15,53835,10,2786,564,148,108,57451
2013-07-16,43521,10,2164,601,78,120,46494
2013-07-17,46488,9,2087,675,86,117,49462
2013-07-18,51385,11,2289,649,121,122,54577
2013-07-19,63850,11,2175,639,168,91,66934
2013-07-20,98357,10,1067,1129,209,247,101019
2013-07-21,94298,10,767,1027,194,153,96449
2013-07-22,60105,9,2504,658,117,113,63506
2013-07-23,42942,10,2160,567,111,117,45907
2013-07-24,56189,9,2232,683,112,128,59353
2013-07-25,63798,6,1935,659,127,127,66652
2013-07-26,81563,9,1548,696,210,122,84148
2013-07-27,115844,10,661,930,197,227,117869
2013-07-28,102527,9,612,1147,287,203,104785
2013-07-29,61586,8,2213,529,109,116,64561
2013-07-30,59678,7,2254,586,93,120,62738
2013-07-31,61645,11,2264,782,115,125,64942
2013-08-01,72459,9,1807,946,117,141,75479
2013-08-02,91483,11,1452,732,231,122,94031
2013-08-03,123209,10,668,1243,162,271,125563
2013-08-04,107673,9,673,1347,203,164,110069
2013-08-05,68307,7,1559,647,110,120,70750
2013-08-06,59773,9,2058,818,124,128,62910
2013-08-07,59885,12,2059,1645,152,111,63864
2013-08-08,63308,13,1814,628,202,122,66087
2013-08-09,86967,8,1478,744,121,108,89426
2013-08-10,121598,7,740,1039,97,236,123717
2013-08-11,105722,7,613,977,210,161,107690
2013-08-12,68138,7,1985,627,228,114,71099
2013-08-13,59982,9,1770,648,242,112,62763
2013-08-14,73660,7,1721,855,86,126,76455
2013-08-15,81094,5,621,835,162,156,82873
2013-08-16,94451,9,1392,812,327,105,97096
2013-08-17,138567,12,598,1011,512,219,140919
2013-08-18,132343,8,568,1207,614,173,134913
2013-08-19,76039,7,2017,714,408,118,79303
2013-08-20,64300,10,1572,683,67,105,66737
2013-08-21,58462,8,2045,705,138,113,61471
2013-08-22,65684,9,2154,760,564,118,69289
2013-08-23,88417,10,1616,1048,560,98,91749
2013-08-24,125583,11,625,1455,543,219,128436
2013-08-25,111001,5,716,1264,80,136,113202
2013-08-26,59704,8,2383,715,133,88,63031
2013-08-27,52001,10,1909,689,115,101,54825
2013-08-28,50743,12,2140,698,101,92,53786
2013-08-29,60591,8,1970,746,173,115,63603
2013-08-30,76196,11,1752,749,210,99,79017
2013-08-31,102087,8,858,1011,161,243,104368
2013-09-01,104697,9,660,1240,181,155,106942
2013-09-02,53051,10,2750,683,72,77,56643
2013-09-03,41032,9,1869,658,91,78,43737
2013-09-04,42440,8,1932,676,65,75,45196
2013-09-05,48578,7,2367,655,112,97,51816
2013-09-06,62254,8,1571,704,150,92,64779
2013-09-07,73034,9,916,1012,127,210,75308
2013-09-08,80910,7,746,1203,261,153,83280
2013-09-09,45226,7,2322,624,56,71,48306
2013-09-10,38749,8,2143,625,52,75,41652
2013-09-11,37858,7,2120,725,42,76,40828
2013-09-12,39939,8,2095,732,64,80,42918
2013-09-13,43283,8,1658,823,92,77,45941
2013-09-14,62574,8,649,1035,82,191,64539
2013-09-15,61558,8,734,1034,77,111,63522
2013-09-16,34668,8,2432,582,50,76,37816
2013-09-17,32233,11,2273,759,29,69,35374
2013-09-18,31696,10,1962,646,61,75,34450
2013-09-19,33714,7,1912,628,66,78,36405
2013-09-20,40731,8,1775,771,79,77,43441
2013-09-21,46371,9,1032,1162,64,195,48833
2013-09-22,51646,9,721,910,111,119,53516
2013-09-23,31856,8,2469,580,48,83,35044
2013-09-24,27895,12,2239,604,55,75,30880
2013-09-25,28819,9,2382,633,42,70,31955
2013-09-26,32583,9,2257,753,62,78,35742
2013-09-27,38278,9,1707,884,82,74,41034
2013-09-28,43009,69,756,955,76,170,45035
2013-09-29,44520,6,721,1197,31,91,46566
2013-09-30,28765,10,2393,542,20,63,31793
2013-10-01,25209,8,2259,541,34,63,28114
2013-10-02,26366,7,2382,688,37,21,29501
2013-10-03,32237,8,2274,673,47,80,35319
2013-10-04,35618,5,1610,832,49,56,38170
2013-10-05,39944,10,830,995,32,148,41959
2013-10-06,39520,8,825,966,23,82,41424
2013-10-07,26566,8,2823,587,13,50,30047
2013-10-08,25259,9,1520,478,16,51,27333
2013-10-09,22394,9,2213,798,50,41,25505
2013-10-10,25830,7,2290,598,31,49,28805
2013-10-11,32614,9,2044,638,38,44,35387
2013-10-12,34151,8,755,868,29,104,35915
2013-10-13,40046,7,700,804,29,68,41654
2013-10-14,24497,7,2503,486,20,57,27570
2013-10-15,21765,9,2456,481,26,56,24793
2013-10-16,25493,8,2124,599,21,39,28284
2013-10-17,24787,9,2051,609,36,52,27544
2013-10-18,28532,7,1949,613,31,49,31181
2013-10-19,33226,12,855,699,28,86,34906
2013-10-20,38448,11,835,916,31,67,40308
2013-10-21,24015,12,2314,452,23,50,26866
2013-10-22,21133,11,2451,474,20,55,24144
2013-10-23,22913,10,2244,505,22,37,25731
2013-10-24,24638,8,2480,540,29,49,27744
2013-10-25,28301,7,1844,585,24,45,30806
2013-10-26,33971,11,952,675,22,75,35706
2013-10-27,35762,13,663,717,25,40,37220
2013-10-28,25090,8,2512,416,23,23,28072
2013-10-29,24005,12,2532,392,27,24,26992
2013-10-30,33965,9,2294,449,15,27,36759
2013-10-31,39494,12,1639,499,18,32,41694
2013-11-01,36512,10,661,495,22,26,37726
2013-11-02,37887,10,704,420,17,30,39068
2013-11-03,60444,9,746,704,16,32,61951
2013-11-04,26235,10,2579,397,10,19,29250
2013-11-05,20128,8,2440,337,11,18,22942
2013-11-06,20206,10,2270,446,18,19,22969
2013-11-07,22018,11,2247,481,26,21,24804
2013-11-08,26541,10,2010,418,20,21,29020
2013-11-09,26122,10,819,545,8,17,27521
2013-11-10,28447,7,717,603,11,20,29805
2013-11-11,19894,11,2245,325,2,18,22495
2013-11-12,19401,8,2362,327,9,24,22131
2013-11-13,19871,7,1964,373,28,16,22259
2013-11-14,22184,8,2094,355,9,20,24670
2013-11-15,25828,13,1836,355,11,19,28062
2013-11-16,25792,6,983,550,10,13,27354
2013-11-17,30354,5,658,482,17,24,31540
2013-11-18,21265,9,2818,291,13,21,24417
2013-11-19,20327,9,2348,278,5,17,22984
2013-11-20,20605,8,2375,338,6,1,23333
2013-11-21,21807,8,2029,326,10,6,24186
2013-11-22,25360,11,1917,382,7,9,27686
2013-11-23,22328,9,834,437,6,14,23628
2013-11-24,27869,10,765,392,17,17,29070
2013-11-25,22748,10,2423,300,5,15,25501
2013-11-26,17484,12,2074,285,8,15,19878
2013-11-27,17668,7,2003,323,10,15,20026
2013-11-28,20312,9,2296,346,14,19,22996
2013-11-29,24831,7,1909,371,16,23,27157
2013-11-30,23586,11,965,518,11,17,25108
2013-12-01,26692,6,641,474,6,19,27838
2013-12-02,20771,11,2467,270,7,11,23537
2013-12-03,18191,10,2094,281,7,19,20602
2013-12-04,19609,10,2165,368,13,17,22182
2013-12-05,20669,9,2146,361,16,16,23217
2013-12-06,23251,12,2020,388,14,22,25707
2013-12-07,21626,10,649,481,11,18,22795
2013-12-08,25448,10,767,434,9,24,26692
2013-12-09,19304,9,2486,263,9,17,22088
2013-12-10,19557,7,2496,272,11,21,22364
2013-12-11,19934,8,2472,372,10,18,22814
2013-12-12,20697,5,1968,321,9,15,23015
2013-12-13,23936,9,1728,363,13,20,26069
2013-12-14,23628,8,896,438,7,17,24994
2013-12-15,26029,10,757,415,9,20,27240
2013-12-16,19668,11,2383,250,12,18,22342
2013-12-17,19363,11,2493,301,8,5,22181
2013-12-18,23148,11,2147,346,12,16,25680
2013-12-19,26041,6,1759,451,20,22,28299
2013-12-20,36867,16,1524,428,8,19,38862
2013-12-21,48825,10,742,610,7,16,50210
2013-12-22,34473,10,556,581,6,19,35645
2013-12-23,31802,8,1226,325,9,15,33385
2013-12-24,29045,11,543,299,6,13,29917
2013-12-25,21535,5,133,301,2,8,21984
2013-12-26,23717,5,367,360,2,12,24463
2013-12-27,29692,11,944,343,9,12,31011
2013-12-28,29691,10,467,405,7,16,30596
2013-12-29,28305,9,485,497,5,16,29317
2013-12-30,29207,9,935,436,7,13,30607
2013-12-31,19444,7,377,336,8,10,20182
2014-01-01,21122,6,213,287,6,10,21644
2014-01-02,31497,9,893,579,9,19,33006
2014-01-03,35302,9,1085,554,14,14,36978
2014-01-04,38973,10,438,516,7,13,39957
2014-01-05,42359,7,318,648,5,18,43355
2014-01-06,34155,10,841,514,4,16,35540
2014-01-07,22491,22,1647,350,7,20,24537
2014-01-08,23146,9,1837,335,6,17,25350
2014-01-09,21923,9,1737,340,12,14,24035
2014-01-10,24328,8,1469,351,6,17,26179
2014-01-11,26610,8,616,442,6,16,27698
2014-01-12,28561,7,614,528,5,20,29735
2014-01-13,20131,11,2189,267,14,15,22627
2014-01-14,18311,8,1843,273,8,19,20462
2014-01-15,17906,7,2014,367,10,15,20319
2014-01-16,19058,9,1533,357,14,14,20985
2014-01-17,23360,8,1626,316,10,19,25339
2014-01-18,25111,8,668,386,7,13,26193
2014-01-19,22916,9,587,469,6,19,24006
2014-01-20,19953,10,2239,285,6,19,22512
2014-01-21,17641,14,2043,249,6,16,19969
2014-01-22,19270,13,1964,328,9,17,21601
2014-01-23,19250,9,2008,336,9,17,21629
2014-01-24,18612,8,1311,310,8,16,20265
2014-01-25,19466,9,613,368,2,9,20467
2014-01-26,19784,9,547,371,8,20,20739
2014-01-27,18115,9,2047,251,11,19,20452
2014-01-28,14738,10,1503,284,16,15,16566
2014-01-29,16226,10,1756,302,10,14,18318
2014-01-30,15880,7,1609,295,7,15,17813
2014-01-31,20239,10,1348,319,9,18,21943
2014-02-01,18339,8,646,398,1,11,19403
2014-02-02,18304,5,573,427,7,21,19337
2014-02-03,16455,10,2018,252,7,14,18756
2014-02-04,15682,17,1738,272,6,15,17730
2014-02-05,16569,8,1824,346,9,18,18774
2014-02-06,17323,7,1993,286,8,16,19633
2014-02-07,21503,8,1421,305,14,19,23270
2014-02-08,19565,8,625,363,6,13,20580
2014-02-09,21958,7,571,441,6,19,23002
2014-02-10,19182,12,2138,252,6,16,21606
2014-02-11,17371,10,2042,271,6,14,19714
2014-02-12,17029,10,2071,309,10,18,19447
2014-02-13,19936,10,1844,337,10,19,22156
2014-02-14,23787,8,1625,340,8,20,25788
2014-02-15,24889,9,666,411,13,18,26006
2014-02-16,25688,6,625,482,5,24,26830
2014-02-17,20094,11,1936,246,6,17,22310
2014-02-18,18000,8,2255,288,6,17,20574
2014-02-19,18623,10,1960,330,13,16,20952
2014-02-20,20214,9,1961,358,16,23,22581
2014-02-21,24358,11,1425,315,15,15,26139
2014-02-22,21756,8,653,328,5,14,22764
2014-02-23,28082,9,1157,446,6,20,29720
2014-02-24,18738,9,2270,253,12,18,21300
2014-02-25,18147,10,1933,257,12,21,20380
2014-02-26,19318,10,2303,309,9,17,21966
2014-02-27,19233,10,1821,382,9,16,21471
2014-02-28,25677,9,1677,375,12,22,27772
2014-03-01,24431,10,799,480,6,12,25738
2014-03-02,26345,9,694,482,7,18,27555
2014-03-03,20617,9,2460,343,11,16,23456
2014-03-04,19566,10,2093,326,11,16,22022
2014-03-05,19507,12,1849,382,12,16,21778
2014-03-06,19942,9,2047,369,7,23,22397
2014-03-07,25535,10,1638,446,10,18,27657
2014-03-08,24684,11,608,499,12,16,25830
2014-03-09,35691,11,622,629,3,26,36982
2014-03-10,21633,11,2417,311,6,19,24397
2014-03-11,18814,12,2184,289,11,19,21329
2014-03-12,19542,11,2004,366,10,23,21956
2014-03-13,20630,11,2058,371,8,8,23086
2014-03-14,27899,10,1866,392,8,24,30199
2014-03-15,27809,9,725,467,10,20,29040
2014-03-16,34428,9,687,544,4,23,35695
2014-03-17,23093,11,2185,287,7,20,25603
2014-03-18,19187,10,2770,303,11,15,22296
2014-03-19,20876,11,2098,396,9,22,23412
2014-03-20,22133,10,2111,466,15,26,24761
2014-03-21,26120,11,1667,373,17,29,28217
2014-03-22,27023,9,917,440,12,22,28423
2014-03-23,29618,7,646,546,4,19,30840
2014-03-24,20978,9,2501,285,8,26,23807
2014-03-25,19536,9,2350,309,14,20,22238
2014-03-26,20112,10,2783,392,7,19,23323
2014-03-27,21879,10,2266,423,16,23,24617
2014-03-28,25852,9,1818,415,19,25,28138
2014-03-29,26538,10,709,500,25,25,27807
2014-03-30,34329,8,724,568,19,37,35685
2014-03-31,22267,11,2660,304,18,29,25289
2014-04-01,19934,10,2446,328,19,42,22779
2014-04-02,20946,10,1905,374,20,38,23293
2014-04-03,23639,10,2098,415,17,41,26220
2014-04-04,27036,13,1984,440,10,30,29513
2014-04-05,27823,9,848,524,11,50,29265
2014-04-06,34587,7,638,741,8,32,36013
2014-04-07,22992,12,2997,315,18,35,26369
2014-04-08,20077,9,2480,355,23,39,22983
2014-04-09,21020,13,2702,451,13,30,24229
2014-04-10,24346,11,2249,541,19,46,27212
2014-04-11,32317,12,2141,530,17,40,35057
2014-04-12,38208,10,1037,689,29,65,40038
2014-04-13,41343,9,887,689,33,83,43044
2014-04-14,25502,9,2520,336,15,91,28473
2014-04-15,27170,9,3062,396,63,42,30742
2014-04-16,30829,9,2160,481,27,21,33527
2014-04-17,37737,10,2199,673,30,47,40696
2014-04-18,49215,9,1064,644,33,48,51013
2014-04-19,37876,13,452,489,35,64,38929
2014-04-20,33387,10,188,388,18,45,34036
2014-04-21,61635,10,636,746,17,48,63092
2014-04-22,39613,12,2612,618,19,48,42922
2014-04-23,27129,11,2562,517,26,37,30282
2014-04-24,28621,11,2022,616,34,40,31344
2014-04-25,37513,9,1957,631,38,46,40194
2014-04-26,46657,12,877,856,68,84,48554
2014-04-27,52470,9,746,965,33,47,54270
2014-04-28,27814,12,2605,500,17,47,30995
2014-04-29,26701,9,2553,579,43,48,29933
2014-04-30,38168,10,1606,692,36,55,40567
2014-05-01,39178,10,320,926,35,50,40519
2014-05-02,40130,11,842,570,53,55,41661
2014-05-03,65372,14,641,1059,45,113,67244
2014-05-04,79078,10,660,1160,107,80,81095
2014-05-05,33347,10,2401,588,30,49,36425
2014-05-06,25799,9,2039,519,34,67,28467
2014-05-07,25324,10,2092,542,27,56,28051
2014-05-08,26371,12,1917,570,35,43,28948
2014-05-09,28370,12,1737,537,37,62,30755
2014-05-10,33131,10,840,672,39,143,34835
2014-05-11,41243,7,606,718,32,78,42684
2014-05-12,26950,11,2400,461,20,42,29884
2014-05-13,22178,9,2283,494,24,51,25039
2014-05-14,22797,9,2286,480,24,53,25649
2014-05-15,23880,8,2019,637,23,60,26627
2014-05-16,27461,6,1448,640,35,53,29643
2014-05-17,27533,7,597,697,38,121,28993
2014-05-18,33500,7,522,700,31,80,34840
2014-05-19,24352,7,2246,502,17,56,27180
2014-05-20,21288,8,2048,496,29,64,23933
2014-05-21,23149,10,2182,581,36,62,26020
2014-05-22,23125,9,2421,565,38,57,26215
2014-05-23,29614,6,1784,668,49,63,32184
2014-05-24,35500,6,761,816,49,150,37282
2014-05-25,45599,7,698,714,85,115,47218
2014-05-26,27771,7,2601,496,30,61,30966
2014-05-27,22144,6,2091,493,26,65,24825
2014-05-28,25872,6,1888,551,34,78,28429
2014-05-29,32740,6,1907,584,48,63,35348
2014-05-30,32137,6,1775,714,79,88,34799
2014-05-31,37681,7,828,915,53,167,39651
2014-06-01,62666,7,640,992,77,157,64539
2014-06-02,41096,5,2639,630,217,85,44672
2014-06-03,25811,7,2312,627,34,59,28850
2014-06-04,24785,8,2335,646,36,79,27889
2014-06-05,27990,9,2004,592,35,89,30719
2014-06-06,35565,7,2040,657,64,72,38405
2014-06-07,42504,7,686,819,105,195,44316
2014-06-08,55490,7,950,864,124,141,57576
2014-06-09,47683,8,2115,651,88,138,50683
2014-06-10,32259,7,2399,520,56,86,35327
2014-06-11,29056,8,1843,553,51,86,31597
2014-06-12,28504,6,1989,577,82,96,31254
2014-06-13,35609,8,1501,571,81,90,37860
2014-06-14,49802,7,813,914,56,191,51783
2014-06-15,56728,7,707,874,38,124,58478
2014-06-16,34133,7,2873,647,38,78,37776
2014-06-17,32883,9,2216,547,38,71,35764
2014-06-18,35275,8,1992,616,59,88,38038
2014-06-19,38570,8,1142,674,64,100,40558
2014-06-20,47737,10,1408,677,82,98,50012
2014-06-21,54366,8,705,977,85,216,56357
2014-06-22,76705,7,711,1119,178,190,78910
2014-06-23,36167,8,2173,636,82,102,39168
2014-06-24,33172,6,2378,591,64,94,36305
2014-06-25,40571,9,1147,624,35,93,42479
2014-06-26,36140,9,2453,705,83,108,39498
2014-06-27,44274,9,1650,819,101,84,46937
2014-06-28,60928,9,727,1020,114,226,63024
2014-06-29,77374,8,677,1192,143,140,79534
2014-06-30,44773,9,2730,569,72,99,48252
2014-07-01,32423,10,2506,631,67,117,35754
2014-07-02,35755,8,2355,704,60,95,38977
2014-07-03,37424,9,1918,755,80,131,40317
2014-07-04,48489,7,1776,712,101,109,51194
2014-07-05,72025,9,789,1308,118,219,74468
2014-07-06,80389,7,674,1193,219,169,82651
2014-07-07,47094,10,2420,653,99,119,50395
2014-07-08,41468,9,2493,739,46,118,44873
2014-07-09,40079,11,2076,652,61,125,43004
2014-07-10,49151,10,2032,848,44,127,52212
2014-07-11,57757,9,1696,698,164,120,60444
2014-07-12,77341,9,708,957,160,215,79390
2014-07-13,78308,8,640,969,103,137,80165
2014-07-14,49451,9,2719,633,65,113,52990
2014-07-15,43457,10,2376,572,66,138,46619
2014-07-16,43199,10,2383,721,90,143,46546
2014-07-17,50604,10,2067,727,109,140,53657
2014-07-18,72553,9,1850,744,181,115,75452
2014-07-19,95034,8,843,1130,162,240,97417
2014-07-20,102945,7,744,899,236,210,105041
2014-07-21,71970,9,2703,647,54,105,75488
2014-07-22,50484,10,2343,670,83,127,53717
2014-07-23,51205,9,2433,759,112,139,54657
2014-07-24,59719,11,2464,620,133,141,63088
2014-07-25,84718,12,1587,825,231,111,87484
2014-07-26,122976,9,713,890,226,217,125031
2014-07-27,98003,7,661,1115,324,168,100278
2014-07-28,55857,12,2632,496,146,117,59260
2014-07-29,58836,10,1952,582,80,130,61590
2014-07-30,63800,10,2180,746,55,118,66909
2014-07-31,63622,15,2125,836,102,137,66837
2014-08-01,91692,10,1524,726,168,126,94246
2014-08-02,117796,9,643,873,192,223,119736
2014-08-03,113941,9,797,964,138,159,116008
2014-08-04,66015,9,2566,580,116,122,69408
2014-08-05,60013,11,1592,566,59,124,62365
2014-08-06,59993,12,1862,768,77,129,62841
2014-08-07,67960,13,2038,817,121,143,71092
2014-08-08,96094,8,1571,764,198,138,98773
2014-08-09,129393,9,729,830,204,250,131415
2014-08-10,118482,8,701,1085,180,206,120662
2014-08-11,72612,9,2247,696,167,130,75861
2014-08-12,66042,9,2051,755,194,135,69186
2014-08-13,63403,10,2123,607,163,143,66449
2014-08-14,86864,9,1490,720,141,133,89357
2014-08-15,94064,8,3000569,797,368,123,3095929
2014-08-16,129561,10,783,813,289,229,131685
2014-08-17,132039,9,824,1200,382,201,134655
2014-08-18,82823,10,2354,693,326,105,86311
2014-08-19,66973,10,2005,709,232,107,70036
2014-08-20,66202,11,1672,773,181,132,68971
2014-08-21,69288,12,2200,707,226,125,72558
2014-08-22,85272,9,1689,716,478,115,88279
2014-08-23,125908,9,724,1004,267,223,128135
2014-08-24,104629,9,693,1301,232,171,107035
2014-08-25,64309,9,2851,706,160,113,68148
2014-08-26,58481,10,3059,622,117,115,62404
2014-08-27,61364,11,2058,714,138,118,64403
2014-08-28,66532,12,2284,791,137,128,69884
2014-08-29,84229,9,1902,747,225,115,87227
2014-08-30,109320,8,796,1164,186,232,111706
2014-08-31,101169,9,676,1269,226,151,103500
2014-09-01,68226,12,2443,711,18,79,71489
2014-09-02,48025,11,2591,569,43,99,51338
2014-09-03,45647,14,2312,670,80,102,48825
2014-09-04,51592,11,2296,680,73,89,54741
2014-09-05,57118,10,1722,725,100,91,59766
2014-09-06,64464,9,706,1113,85,181,66558
2014-09-07,75661,9,691,1171,117,131,77780
2014-09-08,44219,9,2653,701,84,75,47741
2014-09-09,38192,10,2204,681,97,86,41270
2014-09-10,46448,10,2310,631,70,99,49568
2014-09-11,45669,10,2255,670,40,89,48733
2014-09-12,53524,8,1782,748,87,83,56232
2014-09-13,57157,8,855,1141,58,183,59402
2014-09-14,55564,7,865,1089,60,126,57711
2014-09-15,33659,12,2824,582,45,74,37196
2014-09-16,31207,9,2312,583,33,78,34222
2014-09-17,32852,9,2171,739,54,94,35919
2014-09-18,35090,10,2383,688,92,88,38351
2014-09-19,43614,10,1893,767,75,79,46438
2014-09-20,50302,9,942,935,36,176,52400
2014-09-21,53876,8,737,1117,53,123,55914
2014-09-22,30478,9,2738,669,30,68,33992
2014-09-23,26550,9,2201,581,31,83,29455
2014-09-24,34294,9,2431,690,51,84,37559
2014-09-25,32482,10,2139,701,43,75,35450
2014-09-26,37766,9,1922,863,57,68,40685
2014-09-27,46494,8,1054,992,47,173,48768
2014-09-28,56853,8,731,989,116,125,58822
2014-09-29,31767,7,2647,579,43,89,35132
2014-09-30,29113,9,2692,574,60,71,32519
2014-10-01,29179,10,2419,654,30,68,32360
2014-10-02,33872,7,2177,671,41,63,36831
2014-10-03,42424,11,1739,812,40,58,45084
2014-10-04,37657,9,964,869,42,126,39667
2014-10-05,55234,6,736,940,56,105,57077
2014-10-06,30786,8,3041,516,25,63,34439
2014-10-07,27259,9,2197,538,27,53,30083
2014-10-08,27341,7,1580,631,29,56,29644
2014-10-09,25322,11,2155,567,47,55,28157
2014-10-10,32721,8,1786,665,52,51,35283
2014-10-11,36844,8,866,819,50,96,38683
2014-10-12,47992,7,803,794,29,88,49713
2014-10-13,26771,8,2576,444,26,58,29883
2014-10-14,25226,9,2109,509,26,50,27929
2014-10-15,25671,10,2721,590,13,51,29056
2014-10-16,26619,8,2481,506,25,55,29694
2014-10-17,30438,8,1882,535,27,45,32935
2014-10-18,34192,7,884,765,25,76,35949
2014-10-19,45994,7,621,842,32,84,47580
2014-10-20,27414,8,2368,442,15,55,30302
2014-10-21,22795,8,2513,431,19,44,25810
2014-10-22,22447,8,2294,516,11,45,25321
2014-10-23,23214,9,1757,546,20,53,25599
2014-10-24,30065,9,1597,486,22,52,32231
2014-10-25,33341,8,813,713,24,74,34973
2014-10-26,37403,8,682,808,26,46,38973
2014-10-27,26624,10,2678,432,19,27,29790
2014-10-28,24527,7,2326,433,17,27,27337
2014-10-29,26216,11,2262,423,19,31,28962
2014-10-30,34326,11,2313,525,24,31,37230
2014-10-31,36895,7,1160,458,20,31,38571
2014-11-01,34341,9,359,423,11,31,35174
2014-11-02,51609,9,797,563,23,41,53042
2014-11-03,28159,10,2709,374,27,27,31306
2014-11-04,22658,6,2382,386,10,24,25466
2014-11-05,22676,9,2604,400,5,20,25714
2014-11-06,22637,9,2094,424,8,22,25194
2014-11-07,26441,8,1900,441,9,20,28819
2014-11-08,27160,8,820,508,14,14,28524
2014-11-09,32926,7,648,588,13,20,34202
2014-11-10,22226,9,2634,307,9,22,25207
2014-11-11,23656,8,2475,361,8,23,26531
2014-11-12,20971,10,2283,356,6,18,23644
2014-11-13,21840,10,2207,389,12,17,24475
2014-11-14,28759,10,1905,429,14,20,31137
2014-11-15,31755,7,847,538,9,19,33175
2014-11-16,31247,6,680,530,8,23,32494
2014-11-17,22490,10,2746,275,14,22,25557
2014-11-18,20251,10,2522,330,10,21,23144
2014-11-19,21399,10,2284,337,9,17,24056
2014-11-20,22525,9,2188,400,17,19,25158
2014-11-21,28881,9,1770,372,17,20,31069
2014-11-22,26052,6,870,442,12,20,27402
2014-11-23,34163,6,831,479,18,26,35523
2014-11-24,22818,10,3004,278,10,19,26139
2014-11-25,21718,11,2548,315,7,20,24619
2014-11-26,20319,7,2304,366,9,23,23028
2014-11-27,20994,8,2424,375,11,20,23832
2014-11-28,25601,10,2033,431,17,21,28113
2014-11-29,24471,9,906,452,7,15,25860
2014-11-30,27568,8,707,458,6,17,28764
2014-12-01,21659,7,2616,269,3,18,24572
2014-12-02,19665,11,2434,286,9,17,22422
2014-12-03,20423,10,2253,286,10,19,23001
2014-12-04,21027,7,2182,349,7,19,23591
2014-12-05,25452,8,1629,364,12,20,27485
2014-12-06,24154,10,931,429,13,13,25550
2014-12-07,24318,7,557,372,8,21,25283
2014-12-08,26833,10,2485,297,19,23,29667
2014-12-09,20530,10,2457,320,5,6,23328
2014-12-10,20192,11,2432,319,13,5,22972
2014-12-11,21924,12,2539,389,21,18,24903
2014-12-12,25446,9,2117,427,11,25,28035
2014-12-13,26774,9,933,452,7,16,28191
2014-12-14,23932,13,730,476,8,25,25184
2014-12-15,20285,18,3027,263,8,21,23622
2014-12-16,22391,18,2519,366,8,21,25323
2014-12-17,23822,17,2719,400,16,21,26995
2014-12-18,26966,15,2349,469,17,22,29838
2014-12-19,36438,16,1869,427,8,20,38778
2014-12-20,50664,15,984,623,14,22,52322
2014-12-21,38976,13,688,636,5,23,40341
2014-12-22,30763,18,2123,292,9,23,33228
2014-12-23,37556,18,1710,365,12,19,39680
2014-12-24,41808,15,694,422,8,16,42963
2014-12-25,27246,10,164,406,2,10,27838
2014-12-26,26392,11,373,325,6,14,27121
2014-12-27,30309,13,546,423,3,19,31313
2014-12-28,24071,11,294,418,4,20,24818
2014-12-29,25687,18,1029,394,3,18,27149
2014-12-30,28694,16,835,573,7,21,30146
2014-12-31,20312,16,392,450,4,17,21191
2015-01-01,17113,10,144,283,5,13,17568
2015-01-02,29960,15,645,526,7,24,31177
2015-01-03,37557,12,383,624,12,19,38607
2015-01-04,40700,10,409,722,1,25,41867
2015-01-05,33051,15,1053,357,10,20,34506
2015-01-06,31301,17,1215,430,5,24,32992
2015-01-07,22654,17,2586,313,7,20,25597
2015-01-08,24533,13,3816,382,11,19,28774
2015-01-09,25741,17,3993,370,8,22,30151
2015-01-10,34444,9,2323,469,8,18,37271
2015-01-11,32199,13,1198,516,2,20,33948
2015-01-12,20737,14,4630,293,10,21,25705
2015-01-13,25814,17,3938,278,6,21,30074
2015-01-14,20307,18,4144,328,7,18,24822
2015-01-15,20510,18,4234,472,10,21,25265
2015-01-16,25143,20,4586,329,10,19,30107
2015-01-17,27155,13,2630,362,4,16,30180
2015-01-18,24425,12,1569,477,4,21,26508
2015-01-19,19637,18,4540,314,12,20,24541
2015-01-20,19544,20,4875,298,8,19,24764
2015-01-21,19790,17,4650,308,5,21,24791
2015-01-22,21134,17,4804,326,8,20,26309
2015-01-23,22880,17,4251,328,7,19,27502
2015-01-24,22543,14,2629,413,10,17,25626
2015-01-25,23947,13,1550,401,5,22,25938
2015-01-26,19519,17,4531,252,8,21,24348
2015-01-27,18192,15,4702,294,6,17,23226
2015-01-28,19813,20,4776,336,13,21,24979
2015-01-29,19421,16,5014,319,11,20,24801
2015-01-30,21492,17,4447,350,3,32,26341
2015-01-31,20980,11,2623,398,7,15,24034
2015-02-01,22159,14,1581,378,6,19,24157
2015-02-02,20560,15,4496,220,5,21,25317
2015-02-03,18959,15,4520,282,10,23,23809
2015-02-04,17137,16,4489,329,6,19,21996
2015-02-05,16825,19,3560,361,1,21,20787
2015-02-06,15219,16,1537,321,6,21,17120
2015-02-07,17728,11,2639,343,6,15,20742
2015-02-08,20583,11,2213,366,7,22,23202
2015-02-09,18049,16,4719,249,6,19,23058
2015-02-10,17958,16,10889,260,14,21,29158
2015-02-11,19083,18,5676,297,11,18,25103
2015-02-12,21219,19,4325,345,18,21,25947
2015-02-13,26978,15,4438,367,11,27,31836
2015-02-14,26985,13,3088,412,15,17,30530
2015-02-15,29870,12,1896,504,8,21,32311
2015-02-16,22676,18,4573,284,4,27,27582
2015-02-17,23055,17,4614,296,9,28,28019
2015-02-18,21429,19,4408,290,10,17,26173
2015-02-19,22995,18,5072,321,5,21,28432
2015-02-20,26938,18,4463,347,13,28,31807
2015-02-21,25894,13,2623,426,11,17,28984
2015-02-22,28869,11,1738,420,0,22,31060
2015-02-23,21918,16,4778,269,2,21,27004
2015-02-24,19565,15,5139,292,5,20,25036
2015-02-25,20232,16,4916,318,6,19,25507
2015-02-26,21559,17,5057,359,12,22,27026
2015-02-27,27347,18,4824,341,8,22,32560
2015-02-28,27307,11,3095,424,10,17,30864
2015-03-01,31068,11,1484,505,5,27,33100
2015-03-02,25002,16,5107,293,5,20,30443
2015-03-03,20517,17,5705,333,3,24,26599
2015-03-04,20863,13,5344,348,14,22,26604
2015-03-05,20174,19,4799,370,1,22,25385
2015-03-06,28854,18,4787,435,2,25,34121
2015-03-07,25429,12,2733,446,11,14,28645
2015-03-08,30591,12,1752,653,9,28,33045
2015-03-09,21967,17,4767,360,11,22,27144
2015-03-10,20524,20,5291,365,10,24,26234
2015-03-11,21419,16,5387,357,13,20,27212
2015-03-12,23292,18,5563,388,6,24,29291
2015-03-13,26091,24,5027,357,16,29,31544
2015-03-14,36536,12,2718,490,11,17,39784
2015-03-15,32802,10,1583,545,9,26,34975
2015-03-16,22573,19,5210,307,10,19,28138
2015-03-17,20856,16,5200,334,10,22,26438
2015-03-18,27993,17,5326,360,9,24,33729
2015-03-19,24655,16,5744,466,15,28,30924
2015-03-20,28199,17,4917,422,10,24,33589
2015-03-21,28896,12,2867,515,8,16,32314
2015-03-22,33153,11,1582,564,7,31,35348
2015-03-23,22858,17,5342,312,17,22,28568
2015-03-24,22611,15,6019,359,7,25,29036
2015-03-25,20682,15,5495,446,5,20,26663
2015-03-26,31895,20,5680,456,16,28,38095
2015-03-27,30328,17,4946,416,15,24,35746
2015-03-28,35948,11,3209,544,11,32,39755
2015-03-29,37628,11,1468,639,16,48,39810
2015-03-30,33904,17,4933,351,10,35,39250
2015-03-31,26261,17,5718,389,18,34,32437
2015-04-01,30751,18,5150,495,17,36,36467
2015-04-02,36257,17,5347,547,25,64,42257
2015-04-03,57164,18,4266,669,27,43,62187
2015-04-04,34461,12,2169,518,21,54,37235
2015-04-05,35006,11,818,422,7,43,36307
2015-04-06,64718,13,1104,601,15,42,66493
2015-04-07,54762,14,6308,492,19,46,61641
2015-04-08,28603,16,5510,474,27,39,34669
2015-04-09,27567,16,5661,449,29,45,33767
2015-04-10,36796,14,5160,551,24,45,42590
2015-04-11,43129,13,2797,621,19,66,46645
2015-04-12,43622,11,1097,669,17,64,45480
2015-04-13,32929,15,4949,446,17,42,38398
2015-04-14,24539,18,5164,439,18,49,30227
2015-04-15,24308,16,5297,466,26,50,30163
2015-04-16,26455,17,5399,523,29,46,32469
2015-04-17,35425,15,5304,541,22,34,41341
2015-04-18,33833,14,3188,619,15,88,37757
2015-04-19,57303,12,1754,688,21,60,59838
2015-04-20,25623,18,5797,444,20,42,31944
2015-04-21,23932,19,6154,431,19,67,30622
2015-04-22,24671,13,5997,540,35,52,31308
2015-04-23,25767,15,5570,539,22,51,31964
2015-04-24,33919,13,5873,581,20,40,40446
2015-04-25,39242,13,3608,696,35,86,43680
2015-04-26,40066,15,1839,698,30,63,42711
2015-04-27,36937,14,3959,505,17,40,41472
2015-04-28,28667,18,5978,490,21,51,35225
2015-04-29,33656,17,6112,602,23,53,40463
2015-04-30,48077,18,5062,757,34,68,54016
2015-05-01,46323,13,1807,880,32,57,49112
2015-05-02,54031,14,1618,795,53,109,56620
2015-05-03,88417,13,1383,991,83,100,90987
2015-05-04,38607,18,5994,607,79,63,45368
2015-05-05,27541,15,5453,499,24,58,33590
2015-05-06,27944,17,5538,526,29,64,34118
2015-05-07,29023,17,5616,621,36,60,35373
2015-05-08,34692,16,5375,652,44,68,40847
2015-05-09,39794,13,3007,781,37,115,43747
2015-05-10,47698,14,2044,839,39,98,50732
2015-05-11,29303,14,5689,515,32,67,35620
2015-05-12,27315,18,5594,519,25,68,33539
2015-05-13,39049,15,5529,471,40,72,45176
2015-05-14,35540,17,5017,707,53,90,41424
2015-05-15,35696,16,5457,577,28,56,41830
2015-05-16,39108,10,3259,751,47,113,43288
2015-05-17,62369,10,1851,698,43,108,65079
2015-05-18,30469,16,5125,529,41,64,36244
2015-05-19,26334,14,5882,507,25,53,32815
2015-05-20,28134,15,5733,540,38,71,34531
2015-05-21,29351,18,5052,565,34,82,35102
2015-05-22,38866,18,5779,790,19,59,45531
2015-05-23,38067,10,2970,805,22,144,42018
2015-05-24,40894,13,1476,816,30,92,43321
2015-05-25,59032,12,4378,666,42,72,64202
2015-05-26,31112,16,6145,553,38,78,37942
2015-05-27,27505,12,5868,576,33,76,34070
2015-05-28,30089,20,5404,586,47,88,36234
2015-05-29,37683,16,5156,615,50,76,43596
2015-05-30,42938,10,2832,889,51,157,46877
2015-05-31,55006,8,1682,857,62,129,57744
2015-06-01,36407,18,5436,504,138,92,42595
2015-06-02,43134,13,5425,580,336,92,49580
2015-06-03,38499,14,4862,640,58,89,44162
2015-06-04,39285,17,3371,662,68,104,43507
2015-06-05,45344,16,5158,619,89,80,51306
2015-06-06,55086,8,3392,741,116,224,59567
2015-06-07,85872,13,1619,930,113,164,88711
2015-06-08,40582,16,5905,526,54,90,47173
2015-06-09,30582,15,5574,497,51,93,36812
2015-06-10,33478,12,5531,647,52,94,39814
2015-06-11,30958,18,4965,1166,49,101,37257
2015-06-12,40639,14,5175,705,78,93,46704
2015-06-13,47386,13,3376,870,74,186,51905
2015-06-14,63620,8,2111,906,60,141,66846
2015-06-15,37567,14,5166,591,50,91,43479
2015-06-16,31723,12,5514,555,51,92,37947
2015-06-17,34508,13,5447,600,25,92,40685
2015-06-18,35267,15,5221,594,62,106,41265
2015-06-19,40829,9,5115,699,67,88,46807
2015-06-20,51412,7,3710,915,60,194,56298
2015-06-21,64219,12,2047,987,114,124,67503
2015-06-22,38798,15,4086,600,60,99,43658
2015-06-23,34810,18,5439,584,37,89,40977
2015-06-24,40928,17,5834,605,49,113,47546
2015-06-25,41922,16,3780,713,107,106,46644
2015-06-26,48437,17,5858,736,94,86,55228
2015-06-27,65363,11,3186,1182,96,215,70053
2015-06-28,84602,11,2344,1001,169,143,88270
2015-06-29,49852,17,5841,579,93,88,56470
2015-06-30,42334,17,5889,546,65,130,48981
2015-07-01,40029,16,5321,829,65,128,46388
2015-07-02,42535,20,5416,717,101,144,48933
2015-07-03,53590,15,5346,805,105,106,59967
2015-07-04,68217,13,2982,910,115,218,72455
2015-07-05,84297,13,1697,1134,248,170,87559
2015-07-06,51399,17,5665,647,110,122,57960
2015-07-07,42743,17,5936,675,88,131,49590
2015-07-08,44746,19,5797,648,83,121,51414
2015-07-09,48158,18,5395,666,71,135,54443
2015-07-10,62650,18,5257,734,100,129,68888
2015-07-11,89037,14,3165,946,145,240,93547
2015-07-12,99173,14,1761,984,244,217,102393
2015-07-13,57168,16,4728,614,101,132,62759
2015-07-14,49121,20,5646,726,97,132,55742
2015-07-15,56303,16,6066,696,94,147,63322
2015-07-16,65569,17,5617,737,120,145,72205
2015-07-17,71815,18,4889,793,145,87,77747
2015-07-18,100522,15,2420,945,209,230,104341
2015-07-19,110290,15,1669,1118,215,165,113472
2015-07-20,67173,17,5207,581,111,131,73220
2015-07-21,53674,19,5310,619,98,129,59849
2015-07-22,56013,19,5519,785,123,165,62624
2015-07-23,63225,18,5436,718,169,87,69653
2015-07-24,82336,12,4970,665,183,106,88272
2015-07-25,117257,11,2756,964,246,230,121464
2015-07-26,101262,15,1879,963,113,222,104454
2015-07-27,68792,19,5675,622,120,120,75348
2015-07-28,55431,17,5933,597,104,121,62203
2015-07-29,61184,16,5437,720,145,98,67600
2015-07-30,78218,18,5403,774,115,164,84692
2015-07-31,102931,18,4885,911,121,146,109012
2015-08-01,137751,13,2686,994,197,251,141892
2015-08-02,119869,16,1834,1127,177,164,123187
2015-08-03,74224,17,5394,645,93,132,80505
2015-08-04,63612,20,5387,700,113,138,69970
2015-08-05,72563,18,4424,707,95,144,77951
2015-08-06,77705,22,4902,845,129,147,83750
2015-08-07,100411,18,5064,882,199,127,106701
2015-08-08,135805,13,3389,989,207,262,140665
2015-08-09,118709,14,1499,1130,183,184,121719
2015-08-10,87029,17,4802,726,156,131,92861
2015-08-11,66244,18,5007,785,141,131,72326
2015-08-12,69343,20,5282,753,160,153,75711
2015-08-13,78352,21,4717,675,287,140,84192
2015-08-14,107339,20,4454,772,414,129,113128
2015-08-15,128962,16,1740,1098,439,245,132500
2015-08-16,128005,14,1371,2009,130,160,131689
2015-08-17,83985,18,5326,782,143,119,90373
2015-08-18,63429,17,5031,688,309,121,69595
2015-08-19,68107,18,5140,722,103,120,74210
2015-08-20,75125,18,4973,835,227,132,81310
2015-08-21,95923,18,4192,721,290,135,101279
2015-08-22,114846,16,2198,984,420,218,118682
2015-08-23,122099,13,1281,1297,509,197,125396
2015-08-24,79870,19,5497,827,93,120,86426
2015-08-25,59272,18,5491,669,116,124,65690
2015-08-26,59576,17,5141,763,181,122,65800
2015-08-27,66384,20,5283,801,165,137,72790
2015-08-28,89006,18,5072,883,225,111,95315
2015-08-29,113754,16,2407,1095,249,240,117761
2015-08-30,108827,15,1776,1130,258,189,112195
2015-08-31,69214,19,5385,702,140,112,75572
2015-09-01,50365,19,5702,753,106,109,57054
2015-09-02,49680,17,5992,595,136,113,56533
2015-09-03,51500,18,5081,728,115,111,57553
2015-09-04,66828,16,5438,756,93,96,73227
2015-09-05,78865,15,2922,1040,35,186,83063
2015-09-06,73042,16,1836,934,69,143,76040
2015-09-07,45109,18,5210,676,65,84,51162
2015-09-08,42458,18,5485,644,59,102,48766
2015-09-09,45422,19,5958,697,67,110,52273
2015-09-10,49576,18,5532,666,62,106,55960
2015-09-11,59182,16,5156,733,106,78,65271
2015-09-12,68644,14,3445,1081,87,205,73476
2015-09-13,82317,14,1489,1115,127,133,85195
2015-09-14,43503,18,5699,630,19,83,49952
2015-09-15,35632,18,6089,648,34,94,42515
2015-09-16,35191,18,6088,679,40,98,42114
2015-09-17,41092,18,6030,629,71,101,47941
2015-09-18,46647,2,4965,738,87,87,52526
2015-09-19,57125,3,2644,1048,85,187,61092
2015-09-20,63904,2,1639,974,55,117,66691
2015-09-21,37251,2,6054,613,37,75,44032
2015-09-22,32244,4,4032,583,48,95,37006
2015-09-23,36903,3,4702,631,31,86,42356
2015-09-24,34303,1,3742,688,38,91,38863
2015-09-25,37480,5,4253,712,86,77,42613
2015-09-26,43354,1,2888,919,56,167,47385
2015-09-27,57797,2,1427,934,48,109,60317
2015-09-28,32325,2,4641,624,36,123,37751
2015-09-29,27570,3,5563,652,15,87,33890
2015-09-30,29156,1,5934,673,33,75,35872
2015-10-01,30904,2,5656,604,41,76,37283
2015-10-02,34963,3,5194,615,47,66,40888
2015-10-03,42848,3,3406,799,41,144,47241
2015-10-04,43791,7,1267,909,33,91,46098
2015-10-05,31423,12,4514,582,26,61,36618
2015-10-06,25370,12,5512,548,24,60,31526
2015-10-07,28176,12,5787,592,22,59,34648
2015-10-08,31323,11,4400,644,50,59,36487
2015-10-09,33954,11,5610,722,43,54,40394
2015-10-10,35032,7,3153,805,33,104,39134
2015-10-11,39288,7,1680,816,16,67,41874
2015-10-12,28020,11,5536,524,39,63,34193
2015-10-13,25407,12,4521,472,20,59,30491
2015-10-14,24431,12,5747,484,19,55,30748
2015-10-15,26310,14,5666,578,30,62,32660
2015-10-16,32984,13,4818,596,17,46,38474
2015-10-17,34240,3,3394,765,40,102,38544
2015-10-18,39589,3,1417,818,34,68,41929
2015-10-19,26115,4,5640,487,18,54,32318
2015-10-20,23636,3,5611,434,24,48,29756
2015-10-21,23660,3,4935,559,24,54,29235
2015-10-22,27942,3,6216,606,22,63,34852
2015-10-23,36347,2,4760,559,27,50,41745
2015-10-24,37668,2,3598,682,30,102,42082
2015-10-25,42537,3,1738,653,18,44,44993
2015-10-26,38696,4,5137,526,18,39,44420
2015-10-27,27744,3,5858,388,19,34,34046
2015-10-28,26867,5,6059,453,16,30,33430
2015-10-29,29027,6,5446,434,22,34,34969
2015-10-30,35502,7,5676,492,13,35,41725
2015-10-31,39982,6,2866,528,16,46,43444
2015-11-01,44828,8,2026,489,3,43,47397
2015-11-02,31317,11,5087,341,11,33,36800
2015-11-03,26379,11,6179,500,16,33,33118
2015-11-04,25074,12,6293,395,13,29,31816
2015-11-05,25614,11,5963,496,22,25,32131
2015-11-06,30721,9,5586,463,12,22,36813
2015-11-07,31804,8,3802,544,13,28,36199
2015-11-08,43956,10,2267,534,14,38,46819
2015-11-09,26149,12,5595,322,13,31,32122
2015-11-10,23452,12,5564,397,14,29,29468
2015-11-11,24987,12,5545,2175,10,23,32752
2015-11-12,25237,10,5990,425,10,26,31698
2015-11-13,29119,7,4753,395,11,26,34311
2015-11-14,29916,10,3092,562,8,22,33610
2015-11-15,36628,9,1822,565,7,27,39058
2015-11-16,23947,11,5325,310,13,23,29629
2015-11-17,29574,14,5465,331,9,25,35418
2015-11-18,23060,12,6044,430,22,24,29592
2015-11-19,24834,11,5921,378,14,24,31182
2015-11-20,29463,10,5616,364,5,18,35476
2015-11-21,25449,7,3547,457,5,15,29480
2015-11-22,30388,7,1706,505,10,24,32640
2015-11-23,24356,11,5106,310,11,21,29815
2015-11-24,21051,12,6116,288,8,21,27496
2015-11-25,23486,11,5363,328,15,21,29224
2015-11-26,22093,10,5127,396,7,24,27657
2015-11-27,27098,12,5354,424,11,18,32917
2015-11-28,25572,7,3210,375,9,10,29183
2015-11-29,30235,8,1871,462,8,25,32609
2015-11-30,25226,12,5660,333,8,29,31268
2015-12-01,22138,12,6467,312,7,26,28962
2015-12-02,22453,12,6431,344,11,22,29273
2015-12-03,22766,12,5645,366,6,21,28816
2015-12-04,28862,10,6133,429,8,22,35464
2015-12-05,27059,7,3437,508,12,21,31044
2015-12-06,29868,8,1841,481,17,24,32239
2015-12-07,22284,10,5139,294,7,20,27754
2015-12-08,25735,12,5236,374,9,23,31389
2015-12-09,22665,12,5367,373,10,28,28455
2015-12-10,24162,11,5386,394,8,24,29985
2015-12-11,27015,11,5525,359,8,22,32940
2015-12-12,26852,6,3457,491,13,15,30834
2015-12-13,32479,7,2069,444,6,25,35030
2015-12-14,23234,15,5939,265,5,21,29479
2015-12-15,22481,14,5889,308,5,21,28718
2015-12-16,24109,14,5183,396,8,23,29733
2015-12-17,27488,13,5957,438,9,25,33930
2015-12-18,33352,15,5500,391,11,21,39290
2015-12-19,42474,11,3181,643,12,16,46337
2015-12-20,35770,7,1991,515,3,23,38309
2015-12-21,30756,14,6006,335,6,24,37141
2015-12-22,31604,17,6123,362,6,18,38130
2015-12-23,43662,14,5193,488,7,23,49387
2015-12-24,50130,12,8452,554,8,17,59173
2015-12-25,30155,9,1233,339,1,7,31744
2015-12-26,30187,7,490,375,4,23,31086
2015-12-27,38312,9,854,402,4,18,39599
2015-12-28,32300,11,3458,320,10,16,36115
2015-12-29,31504,15,3527,410,13,27,35496
2015-12-30,37865,12,3024,602,7,19,41529
2015-12-31,25053,13,1261,378,7,12,26724
2016-01-01,22921,7,382,261,1,8,23580
2016-01-02,46719,8,563,641,5,23,47959
2016-01-03,43887,9,675,700,5,26,45302
2016-01-04,28259,14,2772,341,9,20,31415
2016-01-05,30554,11,2955,365,8,24,33917
2016-01-06,28170,13,2228,441,4,23,30879
2016-01-07,24996,12,2834,408,7,16,28273
2016-01-08,30214,14,2666,421,3,21,33339
2016-01-09,37415,8,2249,466,11,15,40164
2016-01-10,38543,9,1724,655,2,22,40955
2016-01-11,25900,13,4227,371,2,24,30537
2016-01-12,23025,16,4790,312,10,19,28172
2016-01-13,22856,13,4653,345,6,23,27896
2016-01-14,21438,15,5005,372,4,22,26856
2016-01-15,25055,13,4823,358,8,20,30277
2016-01-16,26488,10,2949,410,9,13,29879
2016-01-17,24851,8,1792,422,1,22,27096
2016-01-18,21635,14,5164,262,10,21,27106
2016-01-19,21544,13,5275,300,14,17,27163
2016-01-20,21815,14,5008,336,10,20,27203
2016-01-21,21688,11,4577,351,2,20,26649
2016-01-22,25192,13,4913,334,10,23,30485
2016-01-23,25025,10,3267,425,7,10,28744
2016-01-24,26561,10,1941,459,3,24,28998
2016-01-25,21373,12,5063,272,7,24,26751
2016-01-26,19527,11,4989,300,7,22,24856
2016-01-27,20454,13,5629,323,7,21,26447
2016-01-28,21390,13,5225,360,9,19,27016
2016-01-29,26811,12,5492,378,9,25,32727
2016-01-30,25620,9,3223,447,4,13,29316
2016-01-31,28720,10,2228,382,2,14,31356
2016-02-01,21336,13,4447,281,9,18,26104
2016-02-02,20912,8,4980,360,10,26,26296
2016-02-03,19413,13,5190,347,7,24,24994
2016-02-04,22152,12,5031,353,6,19,27573
2016-02-05,27542,13,4922,293,10,25,32805
2016-02-06,27605,7,3180,461,13,19,31285
2016-02-07,27090,10,2164,506,2,26,29798
2016-02-08,27684,7,3851,291,3,21,31857
2016-02-09,22039,14,5258,331,5,20,27667
2016-02-10,21295,8,5063,393,9,21,26789
2016-02-11,23386,12,5251,369,10,22,29050
2016-02-12,28173,12,5322,402,6,23,33938
2016-02-13,27906,7,3158,430,6,17,31524
2016-02-14,29426,7,1672,456,4,24,31589
2016-02-15,24357,9,5203,260,4,21,29854
2016-02-16,23454,11,5399,301,10,19,29194
2016-02-17,21979,11,5277,367,6,25,27665
2016-02-18,22816,11,5011,364,6,22,28230
2016-02-19,27492,11,5006,317,10,24,32860
2016-02-20,29170,8,3154,430,8,21,32791
2016-02-21,32638,9,2157,439,6,25,35274
2016-02-22,23190,9,5313,243,6,26,28787
2016-02-23,22060,10,5420,316,5,22,27833
2016-02-24,22641,8,6138,336,4,29,29156
2016-02-25,23884,12,5684,342,10,28,29960
2016-02-26,27780,9,5386,397,10,25,33607
2016-02-27,27659,7,3070,457,10,22,31225
2016-02-28,31977,9,2280,506,1,23,34796
2016-02-29,24205,10,4658,270,7,24,29174
2016-03-01,25153,10,5707,312,6,21,31209
2016-03-02,23607,11,5681,363,17,25,29704
2016-03-03,23677,11,5411,421,8,24,29552
2016-03-04,27909,10,5411,416,8,25,33779
2016-03-05,27563,6,3343,477,7,25,31421
2016-03-06,31893,8,2010,610,6,26,34553
2016-03-07,23869,12,5603,310,9,24,29827
2016-03-08,21781,11,5476,344,9,21,27642
2016-03-09,23047,10,5611,387,13,27,29095
2016-03-10,24836,12,6428,383,10,25,31694
2016-03-11,28717,9,5303,420,4,22,34475
2016-03-12,28783,9,3361,500,7,20,32680
2016-03-13,34640,7,2309,641,3,24,37624
2016-03-14,25028,10,5156,349,3,30,30576
2016-03-15,22803,13,6220,360,12,25,29433
2016-03-16,23915,13,5835,376,3,24,30166
2016-03-17,25328,10,6061,433,13,29,31874
2016-03-18,33574,12,5760,418,14,31,39809
2016-03-19,39868,10,3439,535,12,26,43890
2016-03-20,40681,9,1886,592,13,36,43217
2016-03-21,28344,10,5969,339,10,25,34697
2016-03-22,26954,14,5048,338,14,22,32390
2016-03-23,29917,12,6228,392,8,30,36587
2016-03-24,38265,11,6035,571,27,31,44940
2016-03-25,49575,9,5302,589,10,35,55520
2016-03-26,34613,9,2400,461,27,28,37538
2016-03-27,37474,9,1464,360,14,42,39363
2016-03-28,67070,7,1583,532,16,40,69248
2016-03-29,40829,14,6776,463,14,39,48135
2016-03-30,28255,13,6490,440,22,39,35259
2016-03-31,28780,12,6512,459,28,39,35830
2016-04-01,34072,11,5252,438,15,45,39833
2016-04-02,39919,8,3358,642,12,50,43989
2016-04-03,47191,9,2092,651,13,52,50008
2016-04-04,28204,13,5863,387,19,41,34527
2016-04-05,23881,10,6256,447,24,39,30657
2016-04-06,23775,11,5760,524,21,43,30134
2016-04-07,26247,12,6522,495,23,44,33343
2016-04-08,33392,12,5474,465,20,36,39399
2016-04-09,32054,9,3225,606,11,55,35960
2016-04-10,38298,7,2329,662,17,47,41360
2016-04-11,27920,13,6248,388,17,53,34639
2016-04-12,25612,12,6508,392,14,43,32581
2016-04-13,25146,14,6039,442,20,45,31706
2016-04-14,26067,10,6110,536,23,40,32786
2016-04-15,33331,12,5905,581,24,41,39894
2016-04-16,36555,11,3547,603,17,63,40796
2016-04-17,45306,9,1968,682,18,72,48055
2016-04-18,28072,10,6310,461,13,47,34913
2016-04-19,2887,3,611,7,2,0,3510
2016-04-20,22679,13,5244,392,9,24,28361
2016-04-21,25971,12,5769,435,37,45,32269
2016-04-22,33962,9,5656,555,23,45,40250
2016-04-23,33509,10,3417,663,12,56,37667
2016-04-24,38683,12,2124,768,25,63,41675
2016-04-25,36048,15,6358,540,30,50,43041
2016-04-26,32635,13,6565,530,26,51,39820
2016-04-27,32812,12,4632,595,20,45,38116
2016-04-28,35596,13,7151,637,23,58,43478
2016-04-29,46553,12,5752,595,27,50,52989
2016-04-30,53773,9,3211,786,34,86,57899
2016-05-01,52516,13,1499,738,9,96,54871
2016-05-02,57431,12,3027,558,24,60,61112
2016-05-03,40895,10,5273,663,55,70,46966
2016-05-04,33767,9,5247,636,24,65,39748
2016-05-05,39346,12,5476,657,39,95,45625
2016-05-06,38942,12,5957,558,50,74,45593
2016-05-07,45892,10,3379,694,65,133,50173
2016-05-08,71926,7,1919,969,51,148,75020
2016-05-09,36766,11,6285,479,28,73,43642
2016-05-10,29004,12,6006,450,30,67,35569
2016-05-11,28891,13,6611,520,26,67,36128
2016-05-12,30490,13,5928,623,27,78,37159
2016-05-13,39376,12,5777,617,34,65,45881
2016-05-14,40941,8,3607,755,27,127,45465
2016-05-15,44717,9,1762,696,29,109,47322
2016-05-16,45391,12,5242,663,31,83,51422
2016-05-17,33332,13,6762,584,37,76,40804
2016-05-18,30243,12,6743,601,40,88,37727
2016-05-19,30826,11,6207,626,32,82,37784
2016-05-20,37463,14,6288,682,40,66,44553
2016-05-21,42714,9,3916,818,66,167,47690
2016-05-22,61430,11,1862,824,72,133,64332
2016-05-23,34314,13,6269,570,33,75,41274
2016-05-24,29225,15,6252,544,22,80,36138
2016-05-25,35976,12,5874,610,35,103,42610
2016-05-26,43110,13,4576,687,65,127,48578
2016-05-27,44867,14,5470,641,65,75,51132
2016-05-28,51483,9,3719,863,95,187,56356
2016-05-29,87587,10,1524,1043,60,178,90402
2016-05-30,40115,14,6174,550,27,87,46967
2016-05-31,31350,15,6418,526,42,92,38443
2016-06-01,33010,13,6477,604,43,100,40247
2016-06-02,35503,12,6145,653,47,105,42465
2016-06-03,40151,16,5368,686,67,84,46372
2016-06-04,43560,10,3014,771,85,168,47608
2016-06-05,62951,8,1977,876,116,128,66056
2016-06-06,36488,15,6250,518,46,80,43397
2016-06-07,29663,14,5900,472,34,83,36166
2016-06-08,31884,12,6493,507,52,110,39058
2016-06-09,33257,12,6253,551,43,101,40217
2016-06-10,41631,13,5772,624,67,55,48162
2016-06-11,46226,10,3532,878,39,170,50855
2016-06-12,53755,13,1812,795,40,142,56557
2016-06-13,34584,13,6050,516,29,68,41260
2016-06-14,30429,13,6010,519,46,103,37120
2016-06-15,33317,13,6450,564,54,99,40497
2016-06-16,36941,13,6320,570,29,111,43984
2016-06-17,44746,11,6668,1940,37,86,53488
2016-06-18,53864,9,4005,899,72,197,59046
2016-06-19,69389,10,1997,1081,86,146,72709
2016-06-20,40705,14,5799,546,40,96,47200
2016-06-21,37265,12,6057,607,43,109,44093
2016-06-22,36763,11,5334,656,42,120,42926
2016-06-23,39395,13,6679,664,75,135,46961
2016-06-24,49887,12,6020,672,111,93,56795
2016-06-25,59988,10,2973,1192,109,198,64470
2016-06-26,78007,11,1830,1154,141,164,81307
2016-06-27,47759,16,6581,607,56,121,55140
2016-06-28,40331,14,6230,633,73,108,47389
2016-06-29,41846,11,6612,711,65,139,49384
2016-06-30,49446,15,6719,4805,88,154,61227
2016-07-01,58989,13,6128,719,109,123,66081
2016-07-02,79952,9,3166,1048,157,173,84505
2016-07-03,86601,10,1868,1135,155,186,89955
2016-07-04,53786,13,6377,651,76,149,61052
2016-07-05,45926,14,5408,567,67,135,52117
2016-07-06,47567,16,6140,619,71,154,54567
2016-07-07,50094,11,6277,710,98,160,57350
2016-07-08,66776,16,5745,717,125,85,73464
2016-07-09,97848,10,3450,1089,146,242,102785
2016-07-10,109064,9,1820,1117,231,163,112404
2016-07-11,62134,12,5982,628,96,121,68973
2016-07-12,51834,18,5816,578,113,145,58504
2016-07-13,54309,14,6723,719,100,165,62030
2016-07-14,64541,15,6247,715,87,166,71771
2016-07-15,79466,15,6432,721,54,128,86816
2016-07-16,99370,9,3464,1231,111,239,104424
2016-07-17,96967,11,2172,1181,171,182,100684
2016-07-18,62842,13,6664,517,126,71,70233
2016-07-19,56160,12,6101,605,87,157,63122
2016-07-20,59010,15,6877,692,120,116,66830
2016-07-21,66469,15,6589,717,124,174,74088
2016-07-22,85351,12,6358,760,173,127,92781
2016-07-23,111726,10,3047,1135,328,233,116479
2016-07-24,109915,11,2048,1084,200,178,113436
2016-07-25,72440,15,6185,637,108,148,79533
2016-07-26,59736,13,6205,548,105,166,66773
2016-07-27,59946,15,5922,656,140,158,66837
2016-07-28,76066,15,6431,682,117,165,83476
2016-07-29,101308,15,5983,688,224,141,108359
2016-07-30,125372,9,2771,1203,239,202,129796
2016-07-31,124874,10,1916,1155,253,193,128401
2016-08-01,87440,16,4764,667,56,161,93104
2016-08-02,62147,15,6081,611,95,135,69084
2016-08-03,68895,16,6194,648,126,172,76051
2016-08-04,78630,14,6064,670,271,165,85814
2016-08-05,104994,15,4258,732,146,151,110296
2016-08-06,127714,8,3149,905,79,253,132108
2016-08-07,118168,11,2289,1057,100,207,121832
2016-08-08,79144,12,5737,684,169,151,85897
2016-08-09,67752,17,5421,683,271,156,74300
2016-08-10,77892,13,6397,771,87,172,85332
2016-08-11,95627,15,5625,643,105,173,102188
2016-08-12,97016,13,5400,667,220,141,103457
2016-08-13,128021,10,2883,921,239,252,132326
2016-08-14,117912,11,1611,1097,295,197,121123
2016-08-15,100082,13,1331,595,319,153,102493
2016-08-16,85256,13,5811,690,277,159,92206
2016-08-17,75298,15,5874,731,263,157,82338
2016-08-18,82712,16,5985,826,269,173,89981
2016-08-19,103559,17,5431,623,387,134,110151
2016-08-20,128001,9,2756,1727,612,257,133362
2016-08-21,127784,12,1580,1265,367,203,131211
2016-08-22,84608,15,6296,844,107,128,91998
2016-08-23,70128,17,5820,690,126,133,76914
2016-08-24,71798,15,6238,804,159,159,79173
2016-08-25,75105,16,6428,805,219,103,82676
2016-08-26,96496,16,6226,737,278,143,103896
2016-08-27,115103,8,3036,994,264,239,119644
2016-08-28,116633,8,1685,1378,312,219,120235
2016-08-29,77551,15,5887,706,131,118,84408
2016-08-30,68781,14,7105,722,79,142,76843
2016-08-31,62774,14,6478,662,109,159,70196
2016-09-01,59904,15,6473,699,118,139,67348
2016-09-02,71339,16,5789,674,143,99,78060
2016-09-03,89834,10,3330,1142,145,219,94680
2016-09-04,107442,14,1696,1168,250,176,110746
2016-09-05,61234,12,6650,740,48,103,68787
2016-09-06,46827,13,6839,611,50,107,54447
2016-09-07,51413,16,6313,582,42,128,58494
2016-09-08,52146,16,6068,682,91,133,59136
2016-09-09,65877,12,6105,719,104,84,72901
2016-09-10,81199,13,3558,1043,88,210,86111
2016-09-11,85647,11,2217,1029,167,200,89271
2016-09-12,54301,14,5764,515,71,120,60785
2016-09-13,45891,12,6176,583,75,104,52841
2016-09-14,45766,14,6506,624,76,90,53076
2016-09-15,48786,14,6769,704,82,118,56473
2016-09-16,58877,13,5782,751,77,95,65595
2016-09-17,65049,10,3676,1171,49,196,70151
2016-09-18,72086,11,1881,1034,52,162,75226
2016-09-19,44034,15,6307,590,44,99,51089
2016-09-20,36514,17,6020,544,44,96,43235
2016-09-21,39333,13,5900,664,41,87,46038
2016-09-22,41227,15,6850,674,66,148,48980
2016-09-23,47962,12,5437,706,70,84,54271
2016-09-24,61567,11,4148,1094,72,178,67070
2016-09-25,72780,9,1955,1205,118,117,76184
2016-09-26,40367,13,6348,593,63,94,47478
2016-09-27,34911,13,6489,628,57,89,42187
2016-09-28,37989,14,6747,662,56,109,45577
2016-09-29,38320,12,6943,743,58,116,46192
2016-09-30,47085,15,6750,754,67,86,54757
2016-10-01,52602,10,3708,832,48,113,57313
2016-10-02,57541,11,1873,890,41,123,60479
2016-10-03,41829,12,6676,623,28,88,49256
2016-10-04,29916,14,7148,770,36,74,37958
2016-10-05,32242,13,6739,641,45,81,39761
2016-10-06,32195,13,6294,645,46,80,39273
2016-10-07,38658,12,6666,696,58,70,46160
2016-10-08,42307,8,4082,853,40,133,47423
2016-10-09,48580,10,1924,834,27,107,51482
2016-10-10,30699,11,6827,481,23,77,38118
2016-10-11,28096,15,6159,548,21,64,34903
2016-10-12,28481,13,7035,544,28,65,36166
2016-10-13,32054,13,7042,621,36,80,39846
2016-10-14,35390,15,6273,656,27,51,42412
2016-10-15,37683,10,3969,847,16,102,42627
2016-10-16,45631,10,2728,847,20,82,49318
2016-10-17,30327,12,6685,487,36,78,37625
2016-10-18,25472,14,6424,448,31,62,32451
2016-10-19,28778,12,6622,534,32,59,36037
2016-10-20,29644,13,6475,592,22,78,36824
2016-10-21,34930,11,6197,569,26,43,41776
2016-10-22,37453,10,3388,890,35,96,41872
2016-10-23,42029,9,2184,837,21,70,45150
2016-10-24,28084,12,6694,488,21,64,35363
2016-10-25,24633,13,5780,457,22,42,30947
2016-10-26,28100,11,5659,561,17,44,34392
2016-10-27,29060,11,6274,495,18,37,35895
2016-10-28,41888,8,6264,540,17,52,48769
2016-10-29,51916,7,3947,683,31,68,56652
2016-10-30,46768,9,1813,563,27,8,49188
2016-10-31,42814,11,3163,365,30,39,46422
2016-11-01,59310,12,2587,470,41,28,62448
2016-11-02,38802,12,7321,452,21,13,46621
2016-11-03,29619,15,6386,503,15,7,36545
2016-11-04,34473,11,5642,404,26,26,40582
2016-11-05,35990,10,4187,492,11,10,40700
2016-11-06,37346,8,2157,628,5,20,40164
2016-11-07,25199,13,5706,300,12,9,31239
2016-11-08,22653,12,6530,349,14,8,29566
2016-11-09,24907,12,6776,454,16,4,32169
2016-11-10,27314,12,6042,497,11,5,33881
2016-11-11,31783,13,5464,489,13,3,37765
2016-11-12,28495,10,3460,600,10,20,32595
2016-11-13,36118,10,1824,633,8,24,38617
2016-11-14,24400,439,6322,316,8,14,31499
2016-11-15,23341,14,6025,301,11,25,29717
2016-11-16,24343,12,6331,416,23,22,31147
2016-11-17,25259,14,6251,407,11,23,31965
2016-11-18,30596,11,6118,416,6,3,37150
2016-11-19,27897,10,3152,447,9,13,31528
2016-11-20,34198,11,2109,453,15,22,36808
2016-11-21,26967,14,6180,351,6,20,33538
2016-11-22,20568,15,5988,322,10,25,26928
2016-11-23,24877,14,7156,422,9,22,32500
2016-11-24,24687,14,6391,354,12,21,31479
2016-11-25,32780,12,6217,474,4,25,39512
2016-11-26,27744,8,4088,452,7,16,32315
2016-11-27,36219,12,1952,546,10,26,38765
2016-11-28,25761,17,5859,356,10,23,32026
2016-11-29,22141,15,6194,372,10,22,28754
2016-11-30,22634,12,5890,381,17,20,28954
2016-12-01,23964,13,6235,402,9,21,30644
2016-12-02,28453,10,6074,411,9,28,34985
2016-12-03,26901,10,3501,561,8,15,30996
2016-12-04,31353,11,1884,524,10,31,33813
2016-12-05,23973,12,5827,271,8,21,30112
2016-12-06,25519,13,5886,303,12,26,31759
2016-12-07,23329,12,6418,383,9,23,30174
2016-12-08,26250,17,5929,417,18,21,32652
2016-12-09,29436,12,5382,364,13,19,35226
2016-12-10,33376,6,3525,606,15,15,37543
2016-12-11,36918,8,1878,568,11,27,39410
2016-12-12,24512,10,6627,313,6,22,31490
2016-12-13,21873,10,5886,320,7,24,28120
2016-12-14,23344,10,6324,358,18,21,30075
2016-12-15,24710,10,6450,419,12,26,31627
2016-12-16,30080,11,6107,446,9,24,36677
2016-12-17,32691,7,3792,636,6,33,37165
2016-12-18,33843,6,2286,592,8,24,36759
2016-12-19,26900,9,5928,288,8,24,33157
2016-12-20,26925,10,6367,336,5,23,33666
2016-12-21,29053,14,6172,394,11,25,35669
2016-12-22,36690,10,5352,502,14,28,42596
2016-12-23,49394,12,4907,473,4,24,54814
2016-12-24,48295,9,2831,595,10,14,51754
2016-12-25,30110,7,969,468,4,17,31575
2016-12-26,35740,7,1749,364,5,17,37882
2016-12-27,33350,13,4144,355,7,4,37873
2016-12-28,34045,13,3823,393,4,16,38294
2016-12-29,35833,14,3805,548,11,25,40236
2016-12-30,42306,13,2545,623,6,23,45516
2016-12-31,24621,8,981,498,6,13,26127
2017-01-01,33167,10,407,440,3,20,34047
2017-01-02,46390,9,1670,675,14,28,48786
2017-01-03,33417,12,2956,493,9,23,36910
2017-01-04,31387,12,3136,372,12,22,34941
2017-01-05,34913,12,3605,447,5,18,39000
2017-01-06,35512,12,1694,457,6,14,37695
2017-01-07,41720,8,1076,529,8,10,43351
2017-01-08,47635,9,1151,652,5,20,49472
2017-01-09,33912,16,3757,437,6,22,38150
2017-01-10,23983,13,3936,347,8,20,28307
2017-01-11,22342,11,4453,389,10,25,27230
2017-01-12,23273,14,4669,384,6,20,28366
2017-01-13,21531,12,3809,315,0,18,25685
2017-01-14,22618,9,2610,445,4,11,25697
2017-01-15,24971,7,1675,506,8,22,27189
2017-01-16,20762,14,5342,273,3,18,26412
2017-01-17,17504,10,4021,297,4,19,21855
2017-01-18,17711,12,4755,333,5,20,22836
2017-01-19,21065,9,4834,364,5,19,26296
2017-01-20,26063,11,5376,323,11,24,31808
2017-01-21,24213,8,2735,404,10,12,27382
2017-01-22,28032,7,1580,483,8,23,30133
2017-01-23,21440,9,5196,278,11,25,26959
2017-01-24,19197,11,5575,276,5,21,25085
2017-01-25,20561,11,5718,354,9,19,26672
2017-01-26,21445,11,5279,366,4,17,27122
2017-01-27,26532,10,5370,322,13,22,32269
2017-01-28,25366,5,2912,410,5,13,28711
2017-01-29,27198,5,1896,472,5,22,29598
2017-01-30,21047,10,5638,266,2,17,26980
2017-01-31,20993,10,5916,333,15,23,27290
2017-02-01,19091,11,5703,386,7,20,25218
2017-02-02,21883,10,5576,353,9,23,27854
2017-02-03,26698,10,5179,322,9,17,32235
2017-02-04,26099,5,3181,401,5,11,29702
2017-02-05,27820,7,1831,467,4,21,30150
2017-02-06,23087,12,5662,271,7,15,29054
2017-02-07,20921,10,5927,289,15,20,27182
2017-02-08,24064,9,4488,320,7,19,28907
2017-02-09,23620,10,5992,370,7,17,30016
2017-02-10,27898,10,5115,394,11,18,33446
2017-02-11,28134,8,3220,441,11,12,31826
2017-02-12,33547,5,1494,474,11,24,35555
2017-02-13,25374,12,5838,284,10,27,31545
2017-02-14,23106,10,5621,317,12,21,29087
2017-02-15,25225,8,5673,374,6,21,31307
2017-02-16,25400,10,5472,401,11,18,31312
2017-02-17,31514,11,5126,354,9,20,37034
2017-02-18,30401,7,3319,428,8,19,34182
2017-02-19,37702,7,2162,523,6,24,40424
2017-02-20,25072,9,6010,312,7,20,31430
2017-02-21,23357,11,5941,329,12,21,29671
2017-02-22,24310,9,6028,385,5,22,30759
2017-02-23,25104,11,6016,374,7,23,31535
2017-02-24,30884,8,5298,396,5,20,36611
2017-02-25,30780,6,3407,457,6,17,34673
2017-02-26,36828,6,2955,547,5,27,40368
2017-02-27,26297,7,6469,299,25,24,33121
2017-02-28,23387,8,6056,328,9,19,29807
2017-03-01,26016,9,6517,381,12,18,32953
2017-03-02,25332,9,5660,387,13,26,31427
2017-03-03,31030,9,5749,370,10,23,37191
2017-03-04,31323,5,3465,476,11,17,35297
2017-03-05,36280,5,2272,554,3,24,39138
2017-03-06,25075,9,5591,325,6,29,31035
2017-03-07,22217,9,6055,344,8,21,28654
2017-03-08,23582,8,6090,410,10,22,30122
2017-03-09,24459,7,6102,427,14,22,31031
2017-03-10,30631,8,5442,447,9,23,36560
2017-03-11,30814,7,3232,498,12,17,34580
2017-03-12,41265,4,1923,698,10,29,43929
2017-03-13,25736,10,6126,362,13,22,32269
2017-03-14,23603,10,6208,396,7,27,30251
2017-03-15,24611,10,5680,400,8,19,30728
2017-03-16,25487,10,6503,475,18,24,32517
2017-03-17,33050,11,5963,449,10,24,39507
2017-03-18,32031,9,3403,547,8,17,36015
2017-03-19,41926,7,1995,615,15,30,44588
2017-03-20,25885,12,6343,321,11,23,32595
2017-03-21,23464,10,6407,381,9,23,30294
2017-03-22,24229,10,6410,435,16,20,31120
2017-03-23,25634,10,6382,459,15,32,32532
2017-03-24,30797,10,5942,444,11,27,37231
2017-03-25,34309,7,3808,553,11,22,38710
2017-03-26,39906,7,2056,643,9,17,42638
2017-03-27,28016,10,6837,347,8,57,35275
2017-03-28,23423,10,6466,379,4,42,30324
2017-03-29,24943,10,7278,449,20,24,32724
2017-03-30,26887,10,6668,487,12,22,34086
2017-03-31,32423,12,6151,465,15,22,39088
2017-04-01,36224,7,3555,583,15,59,40443
2017-04-02,42958,8,2900,650,11,21,46548
2017-04-03,27037,11,6934,387,16,13,34398
2017-04-04,24666,11,6343,393,15,26,31454
2017-04-05,25297,9,6368,464,16,42,32196
2017-04-06,28195,12,6582,536,24,52,35401
2017-04-07,33608,10,6010,606,20,45,40299
2017-04-08,44291,8,4173,784,19,64,49339
2017-04-09,47274,8,2322,740,19,67,50430
2017-04-10,31302,10,7031,451,22,57,38873
2017-04-11,29495,10,7014,501,23,46,37089
2017-04-12,34207,15,6942,579,29,54,41826
2017-04-13,43519,11,6781,641,30,65,51047
2017-04-14,53840,11,4249,812,23,52,58987
2017-04-15,37205,8,2425,600,17,75,40330
2017-04-16,36992,8,652,537,15,49,38253
2017-04-17,75232,6,1671,803,49,52,77813
2017-04-18,48005,11,6720,624,25,65,55450
2017-04-19,32854,12,7117,584,24,60,40651
2017-04-20,31605,10,6557,558,19,33,38782
2017-04-21,38382,11,6384,602,22,24,45425
2017-04-22,47320,10,4114,927,23,98,52492
2017-04-23,47186,9,2404,949,24,58,50630
2017-04-24,33708,9,6192,595,52,54,40610
2017-04-25,35387,13,6225,694,62,60,42441
2017-04-26,33856,13,6954,672,22,69,41586
2017-04-27,34717,10,5351,655,13,64,40810
2017-04-28,40130,12,6156,699,18,42,47057
2017-04-29,45398,7,3935,1061,21,110,50532
2017-04-30,46925,9,1647,1032,35,106,49754
2017-05-01,67482,10,1744,937,100,70,70343
2017-05-02,66487,11,3614,806,74,65,71057
2017-05-03,39223,12,7275,805,32,82,47429
2017-05-04,31737,12,6329,699,36,50,38863
2017-05-05,36870,11,6297,664,36,35,43913
2017-05-06,43099,9,3848,787,44,125,47912
2017-05-07,44725,7,1985,917,23,87,47744
2017-05-08,33157,12,6246,583,39,41,40078
2017-05-09,28402,11,7078,506,24,46,36067
2017-05-10,28467,11,7132,568,43,72,36293
2017-05-11,28919,10,6394,632,30,73,36058
2017-05-12,31239,9,5941,1032,17,27,38265
2017-05-13,34107,8,3308,760,28,97,38308
2017-05-14,48206,12,2123,826,39,114,51320
2017-05-15,31129,13,5917,633,24,52,37768
2017-05-16,27674,13,7173,607,30,55,35552
2017-05-17,28690,11,7084,617,35,53,36490
2017-05-18,30422,12,6011,642,21,101,37209
2017-05-19,37598,12,6514,741,32,76,44973
2017-05-20,40040,12,4211,856,23,156,45298
2017-05-21,50105,9,2075,906,37,70,53202
2017-05-22,32571,13,6508,555,37,69,39753
2017-05-23,29760,11,6410,682,30,96,36989
2017-05-24,33972,11,6325,704,37,57,41106
2017-05-25,42471,10,6350,749,40,60,49680
2017-05-26,39019,13,5444,674,32,74,45256
2017-05-27,44837,7,3503,943,54,203,49547
2017-05-28,80297,8,2383,1173,73,214,84148
2017-05-29,39917,12,6607,658,46,50,47290
2017-05-30,30639,12,6810,577,40,72,38150
2017-05-31,33578,9,6729,692,38,108,41154
2017-06-01,35141,10,6327,702,49,70,42299
2017-06-02,44609,12,5723,788,72,73,51277
2017-06-03,46567,9,3081,935,123,101,50816
2017-06-04,68954,8,1721,952,406,144,72185
2017-06-05,58683,11,5075,746,75,90,64680
2017-06-06,39453,11,6887,591,28,108,47078
2017-06-07,33849,10,7121,652,42,96,41770
2017-06-08,34408,12,6529,645,53,73,41720
2017-06-09,43829,11,6586,696,79,50,51251
2017-06-10,53694,6,3966,1059,81,205,59011
2017-06-11,67528,10,2583,1049,98,119,71387
2017-06-12,42179,10,6494,597,63,87,49430
2017-06-13,35053,12,6583,589,51,78,42366
2017-06-14,43453,11,7104,644,46,115,51373
2017-06-15,50627,11,4974,839,70,109,56630
2017-06-16,53524,12,5374,748,121,67,59846
2017-06-17,56114,11,3354,945,63,131,60618
2017-06-18,91892,6,2395,1193,86,193,95765
2017-06-19,47213,12,6876,650,54,109,54914
2017-06-20,38233,11,7062,669,52,126,46153
2017-06-21,39333,9,6944,747,59,124,47216
2017-06-22,42865,6,5396,749,59,132,49207
2017-06-23,53689,12,6162,816,98,92,60869
2017-06-24,64240,5,3438,1144,134,228,69189
2017-06-25,73830,9,2217,1158,93,167,77474
2017-06-26,54493,11,6135,688,68,117,61512
2017-06-27,44687,16,6571,751,95,141,52261
2017-06-28,46549,13,6610,972,29,105,54278
2017-06-29,49817,11,7079,801,28,147,57883
2017-06-30,65428,10,6108,772,101,137,72556
2017-07-01,78903,9,3754,1347,78,197,84288
2017-07-02,80261,13,2057,1330,71,138,83870
2017-07-03,56074,13,6795,719,66,111,63778
2017-07-04,45325,12,6393,621,71,156,52578
2017-07-05,50078,14,6495,787,80,92,57546
2017-07-06,54237,10,6760,803,83,107,62000
2017-07-07,68383,12,5932,847,123,132,75429
2017-07-08,92224,9,3741,1141,132,262,97509
2017-07-09,110133,11,2115,1121,202,181,113763
2017-07-10,67353,13,6488,663,111,136,74764
2017-07-11,53665,12,6570,657,89,159,61152
2017-07-12,55723,13,6460,728,122,160,63206
2017-07-13,62749,11,6328,832,91,118,70129
2017-07-14,85563,9,6256,993,97,134,93052
2017-07-15,104503,8,3101,1114,108,172,109006
2017-07-16,111048,10,1964,1173,91,204,114490
2017-07-17,70455,15,6134,660,96,132,77492
2017-07-18,57586,11,6757,762,85,166,65367
2017-07-19,62623,14,7080,775,105,176,70773
2017-07-20,72706,15,6185,1035,125,161,80227
2017-07-21,90864,17,6011,734,147,123,97896
2017-07-22,120392,6,3309,1054,214,186,125161
2017-07-23,115842,11,1752,1342,224,226,119397
2017-07-24,80439,14,6372,607,73,181,87686
2017-07-25,63051,16,5966,587,96,130,69846
2017-07-26,70492,15,6403,758,93,165,77926
2017-07-27,78105,15,6681,757,120,176,85854
2017-07-28,98894,13,5695,813,178,142,105735
2017-07-29,138366,12,3381,1050,233,205,143247
2017-07-30,126763,13,2230,1202,163,225,130596
2017-07-31,88005,15,6152,750,123,174,95219
2017-08-01,70902,14,6346,734,93,184,78273
2017-08-02,71392,11,6251,659,90,182,78585
2017-08-03,80332,11,6065,732,108,130,87378
2017-08-04,104654,14,5602,916,183,158,111527
2017-08-05,124931,10,2913,977,270,215,129316
2017-08-06,119571,11,1737,1296,135,142,122892
2017-08-07,84010,13,5978,860,76,161,91098
2017-08-08,69354,12,5599,662,121,194,75942
2017-08-09,84199,12,5975,715,156,119,91176
2017-08-10,86355,12,5963,821,141,118,93410
2017-08-11,104613,12,4687,694,120,136,110262
2017-08-12,130518,10,2793,1141,118,256,134836
2017-08-13,107496,10,1542,1220,200,201,110669
2017-08-14,98302,15,4792,869,134,102,104214
2017-08-15,97496,9,2276,862,278,203,101124
2017-08-16,82912,14,5556,799,207,185,89673
2017-08-17,80196,15,5516,755,342,172,86996
2017-08-18,105945,14,4848,750,616,109,112282
2017-08-19,121515,7,2585,1144,363,251,125865
2017-08-20,123072,11,1314,1283,79,205,125964
2017-08-21,82016,14,5950,767,161,126,89034
2017-08-22,67660,10,6349,721,176,139,75055
2017-08-23,63974,11,5992,819,307,164,71267
2017-08-24,76971,13,6516,784,224,168,84676
2017-08-25,94832,15,5464,851,245,130,101537
2017-08-26,121517,9,2912,1068,229,233,125968
2017-08-27,112651,10,1894,1226,292,204,116277
2017-08-28,80224,13,6396,807,74,129,87643
2017-08-29,63371,13,6661,654,92,159,70950
2017-08-30,67630,14,6434,758,159,168,75163
2017-08-31,78285,12,6240,839,224,155,85755
2017-09-01,83285,17,5074,806,87,109,89378
2017-09-02,90529,12,3355,942,54,221,95113
2017-09-03,95132,12,1726,1153,44,181,98248
2017-09-04,57995,18,6552,778,68,97,65508
2017-09-05,47209,15,6157,643,77,85,54186
2017-09-06,51849,13,6267,611,93,125,58958
2017-09-07,65524,13,6315,692,53,136,72733
2017-09-08,74769,15,5399,812,122,88,81205
2017-09-09,74437,11,3771,1061,42,158,79480
2017-09-10,78171,11,1941,1132,17,149,81421
2017-09-11,51536,12,6610,613,18,73,58862
2017-09-12,42658,12,6221,704,39,110,49744
2017-09-13,35197,13,6097,655,76,81,42119
2017-09-14,45274,12,6538,703,57,120,52704
2017-09-15,59175,13,5936,881,56,69,66130
2017-09-16,66862,7,4135,1025,50,191,72270
2017-09-17,63577,11,2446,1154,54,93,67335
2017-09-18,44466,12,6312,622,67,88,51567
2017-09-19,39649,7,6060,641,28,109,46494
2017-09-20,38028,10,6138,667,32,101,44976
2017-09-21,40048,12,6591,909,52,117,47729
2017-09-22,48836,12,5753,839,80,83,55603
2017-09-23,56820,9,3776,1032,95,146,61878
2017-09-24,63564,9,2541,1134,51,122,67421
2017-09-25,38777,11,6784,630,44,71,46317
2017-09-26,33053,10,6364,595,32,67,40121
2017-09-27,35618,12,6795,709,36,96,43266
2017-09-28,38517,11,6270,770,46,112,45726
2017-09-29,47179,12,6050,863,47,74,54225
2017-09-30,52799,8,4009,1093,46,140,58095
2017-10-01,63924,9,2164,1042,56,144,67339
2017-10-02,39795,10,6371,620,52,74,46922
2017-10-03,36112,11,6602,777,33,100,43635
2017-10-04,30696,10,6447,692,41,52,37938
2017-10-05,34075,10,6157,751,45,52,41090
2017-10-06,41744,11,6304,764,25,41,48889
2017-10-07,43364,7,3540,988,28,147,48074
2017-10-08,51172,8,2082,999,32,78,54371
2017-10-09,33002,8,6940,565,21,35,40571
2017-10-10,29879,9,7034,672,36,68,37698
2017-10-11,29150,11,7259,666,41,61,37188
2017-10-12,30840,12,7123,685,25,54,38739
2017-10-13,37123,14,6723,717,34,43,44654
2017-10-14,42520,7,3801,986,30,113,47457
2017-10-15,55429,7,2201,930,36,107,58710
2017-10-16,32472,12,6830,537,37,46,39934
2017-10-17,27337,10,6974,499,20,66,34906
2017-10-18,28390,11,7226,598,31,51,36307
2017-10-19,31920,11,6842,638,38,76,39525
2017-10-20,38762,13,6269,671,44,37,45796
2017-10-21,40130,7,4072,761,38,111,45119
2017-10-22,45725,8,1804,842,9,82,48470
2017-10-23,32220,12,6085,623,12,41,38993
2017-10-24,25974,12,6959,487,13,45,33490
2017-10-25,29603,11,7146,615,23,46,37444
2017-10-26,36134,11,7108,606,19,70,43948
2017-10-27,40836,11,6281,597,18,30,47773
2017-10-28,48685,7,3886,830,26,72,53506
2017-10-29,52585,8,2362,768,18,50,55791
2017-10-30,39420,13,6267,474,17,21,46212
2017-10-31,41863,10,4164,516,16,23,46592
2017-11-01,47027,8,3228,486,17,19,50785
2017-11-02,35913,9,7361,502,13,21,43819
2017-11-03,38940,12,6282,472,28,19,45753
2017-11-04,45209,8,4462,620,22,24,50345
2017-11-05,50248,9,1980,732,11,27,53007
2017-11-06,25240,11,6669,382,13,11,32326
2017-11-07,25021,9,6645,436,5,32,32148
2017-11-08,25212,13,7017,465,19,9,32735
2017-11-09,26285,9,6259,547,17,8,33125
2017-11-10,32410,11,5915,523,18,9,38886
2017-11-11,34186,8,4104,631,10,11,38950
2017-11-12,36768,6,1975,725,12,9,39495
2017-11-13,25204,11,6371,399,8,10,32003
2017-11-14,24377,11,6332,378,6,11,31115
2017-11-15,25030,11,6706,472,17,7,32243
2017-11-16,25705,10,6640,430,7,18,32810
2017-11-17,34505,10,5961,410,8,7,40901
2017-11-18,31650,6,4010,514,20,7,36207
2017-11-19,36607,5,1937,574,24,11,39158
2017-11-20,27836,11,6499,360,12,9,34727
2017-11-21,26052,10,6330,355,13,11,32771
2017-11-22,24788,8,6387,429,14,12,31638
2017-11-23,26579,9,6372,480,13,11,33464
2017-11-24,33379,9,5996,508,16,12,39920
2017-11-25,31453,6,3352,579,9,8,35407
2017-11-26,36039,4,1904,602,8,7,38564
2017-11-27,26277,9,6399,365,9,2,33061
2017-11-28,23864,9,5974,359,13,11,30230
2017-11-29,23484,10,6101,434,4,8,30041
2017-11-30,24428,6,6013,417,12,8,30884
2017-12-01,29772,7,6246,426,5,6,36462
2017-12-02,27323,4,3648,572,9,6,31562
2017-12-03,30749,8,1951,638,4,10,33360
2017-12-04,25273,12,6538,341,8,5,32177
2017-12-05,22333,7,6329,380,10,8,29067
2017-12-06,24824,10,6853,392,12,15,32106
2017-12-07,27167,8,6414,482,10,15,34096
2017-12-08,31685,11,6289,474,7,6,38472
2017-12-09,25575,5,3745,778,6,7,30116
2017-12-10,37237,6,1834,675,10,9,39771
2017-12-11,25358,11,6166,333,4,8,31880
2017-12-12,23601,10,6273,382,11,7,30284
2017-12-13,23507,11,6706,428,15,7,30674
2017-12-14,26265,12,6445,490,4,11,33227
2017-12-15,30267,13,6260,427,5,11,36983
2017-12-16,32023,7,4041,716,13,6,36806
2017-12-17,33894,5,2449,630,4,6,36988
2017-12-18,28590,13,6469,378,7,10,35467
2017-12-19,28162,11,6429,357,15,12,34986
2017-12-20,31486,13,6607,465,10,15,38596
2017-12-21,38649,10,6720,604,9,6,45998
2017-12-22,53231,11,5494,606,11,8,59361
2017-12-23,65152,11,3206,765,11,10,69155
2017-12-24,36549,9,1547,863,4,4,38976
2017-12-25,26857,5,1031,270,1,3,28167
2017-12-26,38677,5,1339,469,1,11,40502
2017-12-27,35893,12,4184,480,6,7,40582
2017-12-28,35414,13,3739,445,4,9,39624
2017-12-29,42691,10,3583,534,9,10,46837
2017-12-30,42516,9,1557,722,9,13,44826
2017-12-31,21614,7,407,422,5,5,22460
2018-01-01,36249,9,372,347,3,7,36987
2018-01-02,51748,5,1762,763,7,8,54293
2018-01-03,38179,11,3653,632,6,11,42492
2018-01-04,37976,10,3814,496,9,8,42313
2018-01-05,46570,11,3622,478,9,5,50695
2018-01-06,47982,6,1757,615,3,9,50372
2018-01-07,45886,7,1031,645,3,9,47581
2018-01-08,37636,11,4678,427,5,9,42766
2018-01-09,29777,11,5319,374,6,7,35494
2018-01-10,28373,11,5682,386,11,4,34467
2018-01-11,26363,10,5006,442,5,5,31831
2018-01-12,29586,14,4718,344,11,7,34680
2018-01-13,33769,9,3166,510,9,6,37469
2018-01-14,34498,7,1803,590,4,8,36910
2018-01-15,18849,10,4236,335,5,9,23444
2018-01-16,18033,10,4026,298,2,7,22376
2018-01-17,20858,10,5211,372,4,10,26465
2018-01-18,24180,8,5503,388,10,9,30098
2018-01-19,28104,9,4453,320,4,12,32902
2018-01-20,27287,5,3053,452,3,5,30805
2018-01-21,30036,9,1599,488,7,5,32144
2018-01-22,21857,10,4434,346,9,7,26663
2018-01-23,17791,10,4813,313,4,7,22938
2018-01-24,20081,11,5668,379,6,11,26156
2018-01-25,20872,9,5650,395,8,11,26945
2018-01-26,24488,8,5007,376,7,9,29895
2018-01-27,23373,4,3009,468,9,6,26869
2018-01-28,29669,5,1786,497,4,17,31978
2018-01-29,20179,11,5466,274,4,11,25945
2018-01-30,20217,9,5576,296,7,8,26113
2018-01-31,21238,10,5165,403,7,9,26832
2018-02-01,22540,9,5787,397,4,8,28745
2018-02-02,22865,8,4705,360,8,8,27954
2018-02-03,19102,4,2990,465,3,5,22569
2018-02-04,23012,6,2054,507,9,9,25597
2018-02-05,20431,10,4567,282,4,8,25302
2018-02-06,19135,10,4791,312,7,7,24262
2018-02-07,18112,9,4335,329,5,7,22797
2018-02-08,20325,8,4048,393,7,9,24790
2018-02-09,25323,9,5229,328,3,8,30900
2018-02-10,27519,5,3144,479,8,7,31162
2018-02-11,29864,6,2259,563,6,12,32710
2018-02-12,19995,13,4720,329,10,14,25081
2018-02-13,17247,11,4559,327,0,17,22161
2018-02-14,22725,10,6043,401,8,8,29195
2018-02-15,22253,8,5024,431,15,10,27741
2018-02-16,29105,8,5377,404,12,13,34919
2018-02-17,27820,6,3164,522,13,11,31536
2018-02-18,29633,6,1763,533,3,9,31947
2018-02-19,21772,9,5262,364,11,15,27433
2018-02-20,20423,10,6718,345,13,8,27517
2018-02-21,19313,10,4643,415,5,8,24394
2018-02-22,19703,9,5346,433,3,22,25516
2018-02-23,24260,9,4765,431,4,8,29477
2018-02-24,23250,5,3140,508,7,7,26917
2018-02-25,24424,6,1930,531,6,9,26906
2018-02-26,18441,8,5243,297,2,3,23994
2018-02-27,14767,7,3038,329,12,11,18164
2018-02-28,17768,10,6050,379,10,13,24230
2018-03-01,17677,8,4779,381,6,10,22861
2018-03-02,22178,10,5070,370,9,5,27642
2018-03-03,20911,2,3425,555,8,9,24910
2018-03-04,24906,6,1737,548,8,12,27217
2018-03-05,20888,7,5593,330,15,12,26845
2018-03-06,19015,9,6143,370,5,8,25550
2018-03-07,20735,8,5609,485,9,11,26857
2018-03-08,21636,7,5429,500,13,16,27601
2018-03-09,27674,12,5791,694,12,10,34193
2018-03-10,26918,4,3251,581,7,12,30773
2018-03-11,29005,5,1887,740,4,9,31650
2018-03-12,22321,9,5932,436,9,11,28718
2018-03-13,20438,10,5612,451,9,17,26537
2018-03-14,21273,11,6900,454,12,11,28661
2018-03-15,24707,9,5545,489,3,6,30759
2018-03-16,32354,9,5878,424,4,13,38682
2018-03-17,29857,6,3602,567,7,12,34051
2018-03-18,27553,5,1851,583,9,8,30009
2018-03-19,25044,9,5620,449,7,5,31134
2018-03-20,22921,8,6199,436,11,13,29588
2018-03-21,22981,10,6308,517,5,16,29837
2018-03-22,24497,9,6015,447,12,15,30995
2018-03-23,31955,10,5256,551,14,10,37796
2018-03-24,38159,5,3691,752,17,26,42650
2018-03-25,39492,6,1853,760,11,31,42153
2018-03-26,28750,11,6868,440,14,33,36116
2018-03-27,29044,9,6437,504,28,32,36054
2018-03-28,31491,9,6659,585,32,36,38812
2018-03-29,41145,11,5911,698,21,43,47829
2018-03-30,52661,9,4897,586,11,30,58194
2018-03-31,36005,7,2959,731,12,49,39763
2018-04-01,37322,7,1252,650,10,40,39281
2018-04-02,67882,7,1452,980,21,46,70388
2018-04-03,47229,12,6817,694,17,40,54809
2018-04-04,33333,9,6304,569,16,42,40273
2018-04-05,33069,11,6306,551,10,37,39984
2018-04-06,41176,10,5323,678,24,35,47246
2018-04-07,47987,7,3236,931,19,62,52242
2018-04-08,53887,7,1476,818,15,45,56248
2018-04-09,38505,10,5671,618,14,43,44861
2018-04-10,28561,11,5604,500,15,41,34732
2018-04-11,26855,11,6510,573,21,39,34009
2018-04-12,29325,8,6363,652,19,24,36391
2018-04-13,33858,10,5746,589,13,33,40249
2018-04-14,38112,8,3967,773,9,73,42942
2018-04-15,47220,8,1947,818,13,54,50060
2018-04-16,33105,9,5988,561,17,24,39704
2018-04-17,25822,13,6881,459,26,45,33246
2018-04-18,27508,9,7000,651,17,47,35232
2018-04-19,29110,11,6859,563,27,58,36628
2018-04-20,35969,12,6345,667,15,29,43037
2018-04-21,39297,7,3708,753,31,85,43881
2018-04-22,50802,9,1672,895,16,92,53486
2018-04-23,32591,11,6644,579,19,43,39887
2018-04-24,29249,12,7520,520,44,51,37396
2018-04-25,34320,10,7352,608,27,56,42373
2018-04-26,39087,11,6833,643,28,55,46657
2018-04-27,51678,11,5124,744,36,48,57641
2018-04-28,48601,7,3615,1033,32,76,53364
2018-04-29,55604,8,1930,971,42,89,58644
2018-04-30,54717,10,4829,760,88,68,60472
2018-05-01,78586,7,1756,836,171,85,81441
2018-05-02,64754,6,3267,940,24,37,69028
2018-05-03,42237,7,6610,789,25,64,49732
2018-05-04,42692,10,6087,709,29,64,49591
2018-05-05,51467,7,3777,907,27,87,56272
2018-05-06,46843,6,1477,972,26,102,49426
2018-05-07,37355,9,6604,593,24,66,44651
2018-05-08,31817,10,6621,645,27,78,39198
2018-05-09,34417,9,6423,577,23,51,41500
2018-05-10,41529,9,6414,765,32,82,48831
2018-05-11,38392,8,5927,637,53,68,45085
2018-05-12,43049,7,3480,948,55,184,47723
2018-05-13,66000,6,1968,960,40,101,69075
2018-05-14,37645,8,6531,567,27,68,44846
2018-05-15,31314,8,7024,588,21,80,39035
2018-05-16,29605,9,6633,668,32,84,37031
2018-05-17,32828,9,6756,654,24,53,40324
2018-05-18,39008,12,5566,769,48,46,45449
2018-05-19,46690,5,3787,935,42,177,51636
2018-05-20,52820,7,1792,917,52,127,55715
2018-05-21,54340,9,4999,820,37,89,60294
2018-05-22,41476,12,7596,678,37,66,49865
2018-05-23,30987,9,7104,777,33,80,38990
2018-05-24,31859,13,6771,830,44,97,39614
2018-05-25,42682,11,6298,842,52,85,49970
2018-05-26,44932,6,3506,1020,47,197,49708
2018-05-27,64643,8,2050,1173,70,139,68083
2018-05-28,41494,11,5838,797,35,97,48272
2018-05-29,33251,12,6797,781,47,99,40987
2018-05-30,41036,8,7225,713,55,106,49143
2018-05-31,50678,10,4802,899,64,112,56565
2018-06-01,50714,10,5681,892,87,95,57479
2018-06-02,56186,5,3542,937,118,157,60945
2018-06-03,72200,8,1457,1343,181,148,75337
2018-06-04,57161,11,5475,820,54,97,63618
2018-06-05,32684,10,6653,640,39,109,40135
2018-06-06,38905,8,5953,685,55,118,45724
2018-06-07,35743,8,6833,723,58,73,43438
2018-06-08,42232,11,6212,831,48,93,49427
2018-06-09,43748,6,4297,986,61,197,49295
2018-06-10,64032,6,2249,1064,71,174,67596
2018-06-11,39014,9,5786,703,56,96,45664
2018-06-12,35814,12,7158,663,46,111,43804
2018-06-13,39608,11,7120,740,51,80,47610
2018-06-14,44886,13,6641,739,59,120,52458
2018-06-15,48919,12,5841,792,58,97,55719
2018-06-16,54692,6,3452,1089,54,222,59515
2018-06-17,75440,7,1871,1119,84,182,78703
2018-06-18,45740,11,6930,665,62,93,53501
2018-06-19,36602,9,7031,645,50,144,44481
2018-06-20,41100,10,7009,753,66,134,49072
2018-06-21,45953,9,6980,874,105,150,54071
2018-06-22,61287,8,5354,842,38,91,67620
2018-06-23,64497,8,3790,1059,62,131,69547
2018-06-24,66771,12,2048,1253,77,200,70361
2018-06-25,64798,13,2605,888,64,134,68502
2018-06-26,48513,15,7580,767,42,151,57068
2018-06-27,49325,17,7606,775,47,126,57896
2018-06-28,50028,15,7630,990,85,107,58855
2018-06-29,64290,17,6480,956,105,137,71985
2018-06-30,81998,13,4152,1039,102,292,87596
2018-07-01,85345,10,2161,1634,160,248,89558
2018-07-02,54238,16,6902,1044,73,126,62399
2018-07-03,43878,17,6393,878,93,168,51427
2018-07-04,48055,15,6940,812,90,135,56047
2018-07-05,52995,12,7295,760,98,191,61351
2018-07-06,68640,18,5875,1163,104,146,75946
2018-07-07,89218,13,3307,1120,100,251,94009
2018-07-08,99326,12,1941,1339,164,256,103038
2018-07-09,66053,15,6909,624,108,164,73873
2018-07-10,53988,13,7008,641,109,147,61906
2018-07-11,54482,15,6560,816,55,216,62144
2018-07-12,65515,14,6855,858,105,191,73538
2018-07-13,77296,13,5895,757,133,159,84253
2018-07-14,105132,9,3088,1932,190,229,110580
2018-07-15,105614,12,1688,1165,190,239,108908
2018-07-16,77108,14,6650,561,86,152,84571
2018-07-17,62299,16,6853,746,79,177,70170
2018-07-18,63331,15,6987,730,98,139,71300
2018-07-19,67670,15,6443,840,140,200,75308
2018-07-20,93533,14,6228,694,166,154,100789
2018-07-21,120114,11,3550,1104,183,258,125220
2018-07-22,119880,13,1785,1167,146,169,123160
2018-07-23,78975,15,5639,689,66,153,85537
2018-07-24,63724,18,6948,671,81,183,71625
2018-07-25,67618,13,5974,793,126,184,74708
2018-07-26,80974,16,6303,783,128,148,88352
2018-07-27,104926,15,6011,704,159,199,112014
2018-07-28,132225,11,3601,946,170,268,137221
2018-07-29,127047,9,2097,1108,213,174,130648
2018-07-30,85053,18,6106,628,91,72,91968
2018-07-31,73683,17,6295,704,130,146,80975
2018-08-01,74129,16,6775,769,123,196,82008
2018-08-02,82082,14,5544,749,110,141,88640
2018-08-03,75516,12,4091,605,134,182,80540
2018-08-04,126155,17,2925,1017,193,286,130593
2018-08-05,118119,13,1896,1088,162,228,121506
2018-08-06,86673,13,5264,811,129,167,93057
2018-08-07,73794,16,5979,994,111,143,81037
2018-08-08,72663,18,5854,779,140,197,79651
2018-08-09,83392,14,6096,727,181,210,90620
2018-08-10,110733,13,5538,810,224,165,117483
2018-08-11,117711,13,2591,1313,223,217,122068
2018-08-12,105339,15,1302,1335,224,233,108448
2018-08-13,87201,16,5204,674,333,151,93579
2018-08-14,79937,13,5437,666,118,172,86343
2018-08-15,84814,9,2759,852,87,127,88648
2018-08-16,84278,14,5197,746,200,146,90581
2018-08-17,108867,16,5194,718,303,150,115248
2018-08-18,129744,15,2344,949,463,264,133779
2018-08-19,133347,13,1205,1275,382,172,136394
2018-08-20,90901,15,5225,801,205,112,97259
2018-08-21,67868,14,5345,662,202,183,74274
2018-08-22,69455,17,5431,744,303,161,76111
2018-08-23,84696,13,6020,776,451,135,92091
2018-08-24,105337,17,5361,776,557,112,112160
2018-08-25,122041,14,2708,991,103,257,126114
2018-08-26,102389,12,1367,1235,29,192,105224
2018-08-27,67720,18,6179,725,87,149,74878
2018-08-28,59903,17,6053,681,110,169,66933
2018-08-29,65051,14,6607,753,151,175,72751
2018-08-30,71678,14,6205,787,204,109,78997
2018-08-31,94501,13,5591,886,131,140,101262
2018-09-01,101276,12,2887,1036,72,189,105472
2018-09-02,92403,17,1753,1222,83,183,95661
2018-09-03,58450,15,6447,807,61,70,65850
2018-09-04,48462,16,6578,648,67,81,55852
2018-09-05,48963,16,6934,828,77,101,56919
2018-09-06,57131,15,6905,733,109,147,65040
2018-09-07,73532,16,6141,828,104,108,80729
2018-09-08,75724,18,3645,1067,74,173,80701
2018-09-09,85958,11,1786,1253,100,133,89241
2018-09-10,51903,14,6605,668,64,110,59364
2018-09-11,44573,16,6752,740,52,127,52260
2018-09-12,44406,16,6940,692,67,148,52269
2018-09-13,46034,14,6878,638,70,91,53725
2018-09-14,55741,14,5830,846,100,96,62627
2018-09-15,69045,15,3705,965,56,224,74010
2018-09-16,85621,12,1898,1184,130,200,89045
2018-09-17,49734,13,6483,633,62,76,57001
2018-09-18,40780,16,7247,638,48,126,48855
2018-09-19,46456,18,7067,751,60,125,54477
2018-09-20,51360,18,7392,855,75,85,59785
2018-09-21,58742,22,8795,969,122,90,68740
2018-09-22,67266,13,4684,1093,45,208,73309
2018-09-23,59503,11,2059,971,96,157,62797
2018-09-24,55551,36,8232,918,29,445,65211
2018-09-25,36968,16,6757,629,36,97,44503
2018-09-26,37918,14,6949,664,42,150,45737
2018-09-27,42194,12,6701,767,52,116,49842
2018-09-28,48640,13,6401,878,67,99,56098
2018-09-29,54009,11,3908,1075,35,140,59178
2018-09-30,62433,10,1939,1000,46,166,65594
2018-10-01,41663,12,6701,716,42,73,49207
2018-10-02,29229,15,5820,682,20,96,35862
2018-10-03,34463,13,6346,695,40,95,41652
2018-10-04,35445,16,6583,731,39,115,42929
2018-10-05,47269,13,6303,778,50,73,54486
2018-10-06,47688,10,3896,903,31,108,52636
2018-10-07,51446,12,1774,1060,29,135,54456
2018-10-08,34532,10,5320,500,25,65,40452
2018-10-09,31385,11,7190,616,22,80,39304
2018-10-10,31660,11,7157,900,29,63,39820
2018-10-11,31857,12,7191,733,53,86,39932
2018-10-12,40151,11,7091,686,51,57,48047
2018-10-13,44098,6,3948,989,37,145,49223
2018-10-14,59135,10,1914,1021,31,135,62246
2018-10-15,34136,9,6569,565,21,77,41377
2018-10-16,23494,17,6214,566,35,68,30394
2018-10-17,29446,6,7215,599,23,59,37348
2018-10-18,31098,8,7077,644,23,83,38933
2018-10-19,38458,10,6433,775,35,49,45760
2018-10-20,41528,8,3952,839,19,124,46470
2018-10-21,46750,7,1840,965,14,66,49642
2018-10-22,33960,12,5961,542,10,51,40536
2018-10-23,29968,13,6477,673,20,61,37212
2018-10-24,28038,13,7544,580,25,53,36253
2018-10-25,33391,11,6988,690,35,77,41192
2018-10-26,41926,10,6575,698,20,37,49266
2018-10-27,42355,9,3743,817,8,109,47041
2018-10-28,48335,12,2056,930,4,36,51373
2018-10-29,31780,12,7043,549,3,15,39402
2018-10-30,35176,15,6961,568,11,19,42750
2018-10-31,46505,8,4991,512,25,20,52061
2018-11-01,38385,11,2785,603,9,10,41803
2018-11-02,36001,11,5572,436,15,9,42044
2018-11-03,46452,9,3094,600,19,34,50208
2018-11-04,71076,8,1620,731,16,29,73480
2018-11-05,36808,13,7245,434,11,11,44522
2018-11-06,25761,14,7554,400,7,10,33746
2018-11-07,25820,10,7399,473,13,18,33733
2018-11-08,27112,14,7057,486,12,14,34695
2018-11-09,34345,13,6336,537,9,18,41258
2018-11-10,31594,10,4216,608,16,13,36457
2018-11-11,37462,10,2142,713,10,11,40348
2018-11-12,29279,12,7221,409,12,13,36946
2018-11-13,24462,14,7174,456,15,10,32131
2018-11-14,26228,13,6717,469,17,9,33453
2018-11-15,27470,16,7028,510,14,14,35052
2018-11-16,35686,15,6488,516,11,15,42731
2018-11-17,33690,9,3734,587,25,13,38058
2018-11-18,39907,8,2233,550,7,10,42715
2018-11-19,27769,14,6355,362,10,19,34529
2018-11-20,21555,12,6577,359,5,10,28518
2018-11-21,24260,10,5406,404,10,11,30101
2018-11-22,27133,10,6940,431,13,8,34535
2018-11-23,33786,9,6533,462,14,10,40814
2018-11-24,30524,8,3647,533,13,7,34732
2018-11-25,35572,9,2127,562,9,9,38288
2018-11-26,29816,8,6347,364,13,9,36557
2018-11-27,22702,12,6425,430,10,6,29585
2018-11-28,22994,13,6553,412,6,8,29986
2018-11-29,24774,15,7001,458,4,9,32261
2018-11-30,31827,11,6634,453,8,11,38944
2018-12-01,28934,6,3946,657,8,11,33562
2018-12-02,33943,7,1958,663,8,7,36586
2018-12-03,27185,13,6808,310,5,9,34330
2018-12-04,24493,14,6964,369,10,11,31861
2018-12-05,24073,15,7155,414,11,13,31681
2018-12-06,25112,15,7040,430,8,9,32614
2018-12-07,31397,11,6536,439,17,10,38410
2018-12-08,31992,7,3958,782,5,7,36751
2018-12-09,36580,16,1986,665,16,16,39279
2018-12-10,26814,17,6462,324,7,12,33636
2018-12-11,23562,20,6900,331,12,10,30835
2018-12-12,26747,14,7336,419,22,10,34548
2018-12-13,26427,23,7131,464,4,12,34061
2018-12-14,26027,17,5938,425,5,8,32420
2018-12-15,27975,21,3315,665,10,10,31996
2018-12-16,33936,13,2327,758,5,8,37047
2018-12-17,25342,19,6170,377,9,8,31925
2018-12-18,26020,18,6622,354,4,10,33028
2018-12-19,29458,19,6619,434,11,8,36549
2018-12-20,35927,17,6412,602,9,9,42976
2018-12-21,51790,16,5694,712,8,13,58233
2018-12-22,66464,13,2968,874,6,8,70333
2018-12-23,53296,19,1651,836,5,8,55815
2018-12-24,30381,18,2709,378,8,6,33500
2018-12-25,25278,11,942,335,2,5,26573
2018-12-26,37112,11,981,442,5,9,38560
2018-12-27,37167,16,3390,439,1,10,41023
2018-12-28,41428,18,3432,397,8,10,45293
2018-12-29,42417,19,1791,596,10,14,44847
2018-12-30,39830,18,638,725,12,10,41233
2018-12-31,24203,16,1160,371,11,5,25766
2019-01-01,26113,6,330,288,5,4,26746
2019-01-02,50623,14,1795,882,10,8,53332
2019-01-03,42476,18,3236,723,5,9,46467
2019-01-04,48612,18,3263,503,4,7,52407
2019-01-05,72415,15,1698,617,9,9,74763
2019-01-06,43637,10,1039,779,6,10,45481
2019-01-07,31928,22,4194,436,7,9,36596
2019-01-08,31249,16,4992,445,4,8,36714
2019-01-09,26057,16,5368,438,7,9,31895
2019-01-10,24742,19,5078,468,6,11,30324
2019-01-11,29267,17,4813,392,3,10,34502
2019-01-12,31326,13,3014,485,6,11,34855
2019-01-13,30546,15,1590,509,3,14,32677
2019-01-14,24807,19,6008,384,2,12,31232
2019-01-15,23244,19,5944,338,6,11,29562
2019-01-16,23216,16,6565,385,5,9,30196
2019-01-17,24558,16,6156,428,7,13,31178
2019-01-18,30105,18,5445,386,2,11,35967
2019-01-19,27899,11,3316,495,6,10,31737
2019-01-20,30047,12,1802,484,5,13,32363
2019-01-21,25494,20,5882,333,6,8,31743
2019-01-22,30180,14,6911,364,23,73,37565
2019-01-23,19170,16,5792,410,8,11,25407
2019-01-24,21241,12,6001,373,5,11,27643
2019-01-25,26580,16,5386,380,5,7,32374
2019-01-26,24460,13,3216,457,9,7,28162
2019-01-27,27330,14,1852,524,6,14,29740
2019-01-28,23625,10,6359,305,10,9,30318
2019-01-29,21357,18,6127,335,7,5,27849
2019-01-30,21393,16,6428,393,15,14,28259
2019-01-31,22946,15,6044,406,4,10,29425
2019-02-01,29782,15,5774,367,6,12,35956
2019-02-02,26677,15,3711,483,5,5,30896
2019-02-03,29289,12,1913,559,5,10,31788
2019-02-04,24358,19,5845,334,8,14,30578
2019-02-05,21672,16,6271,339,9,13,28320
2019-02-06,24641,21,7133,377,12,9,32193
2019-02-07,28699,16,6601,405,9,19,35749
2019-02-08,33646,15,4736,406,12,9,38824
2019-02-09,38092,11,3707,464,13,12,42299
2019-02-10,39525,9,2023,541,6,11,42115
2019-02-11,25721,16,6504,361,7,8,32617
2019-02-12,23899,17,6614,352,4,14,30900
2019-02-13,23657,19,6152,390,7,9,30234
2019-02-14,27185,16,6503,443,7,15,34169
2019-02-15,33589,19,6087,397,8,13,40113
2019-02-16,34715,11,3459,527,13,16,38741
2019-02-17,41230,14,1913,540,1,11,43709
2019-02-18,28736,17,6381,377,6,11,35528
2019-02-19,24539,18,6512,339,8,13,31429
2019-02-20,26663,17,6935,370,7,14,34006
2019-02-21,27723,16,6662,396,9,12,34818
2019-02-22,29949,17,5397,345,9,12,35729
2019-02-23,31423,13,4064,514,5,11,36030
2019-02-24,35743,13,2487,584,3,16,38846
2019-02-25,27537,14,6554,384,10,11,34510
2019-02-26,24124,18,7027,373,8,13,31563
2019-02-27,25357,19,7482,422,11,13,33304
2019-02-28,29563,22,6880,496,4,11,36976
2019-03-01,38662,19,6666,437,9,18,45811
2019-03-02,35357,12,3710,541,7,7,39634
2019-03-03,44519,12,2099,630,6,19,47285
2019-03-04,30361,20,7027,389,10,10,37817
2019-03-05,25225,17,7144,412,6,14,32818
2019-03-06,26174,22,6691,431,12,17,33347
2019-03-07,27120,17,7562,500,3,17,35219
2019-03-08,35295,16,6617,507,5,19,42459
2019-03-09,33214,14,3925,560,12,10,37735
2019-03-10,40643,14,1904,700,28,17,43306
2019-03-11,27533,18,6286,465,8,15,34325
2019-03-12,24691,16,7396,375,12,13,32503
2019-03-13,24187,16,7187,458,6,10,31864
2019-03-14,27511,19,6894,450,9,20,34903
2019-03-15,35585,23,5973,505,18,17,42121
2019-03-16,35086,12,3908,561,9,14,39590
2019-03-17,44848,13,1606,701,7,11,47186
2019-03-18,28737,18,6656,398,3,13,35825
2019-03-19,25763,18,7039,421,13,18,33272
2019-03-20,25221,17,7221,470,11,20,32960
2019-03-21,27449,18,7331,474,12,10,35294
2019-03-22,34415,14,6886,533,8,24,41880
2019-03-23,34582,11,4507,619,9,21,39749
2019-03-24,47565,13,2094,703,14,35,50424
2019-03-25,29912,17,7312,419,14,9,37683
2019-03-26,25418,17,7189,393,11,12,33040
2019-03-27,25365,22,7504,488,16,23,33418
2019-03-28,27964,19,7552,499,19,27,36080
2019-03-29,35565,21,6842,499,16,15,42958
2019-03-30,34708,12,4048,592,20,15,39395
2019-03-31,48348,9,1943,753,13,43,51109
2019-04-01,30859,18,6786,473,13,39,38188
2019-04-02,26104,18,6998,438,12,48,33618
2019-04-03,27237,18,7035,493,19,41,34843
2019-04-04,27950,16,7141,606,9,52,35774
2019-04-05,35145,15,6215,595,14,25,42009
2019-04-06,34775,13,4250,700,18,78,39834
2019-04-07,44942,13,2241,778,8,58,48040
2019-04-08,29657,15,7167,503,15,40,37397
2019-04-09,25118,23,6981,472,22,29,32645
2019-04-10,27495,17,7352,566,11,46,35487
2019-04-11,28952,19,7250,684,15,48,36968
2019-04-12,38596,18,6717,703,18,61,46113
2019-04-13,47793,10,3914,902,21,52,52692
2019-04-14,47078,17,2186,826,16,66,50189
2019-04-15,33416,16,7193,474,19,45,41163
2019-04-16,33420,21,7752,593,23,56,41865
2019-04-17,37417,18,7559,694,18,58,45764
2019-04-18,48332,18,6651,774,34,47,55856
2019-04-19,61577,20,5508,712,29,36,67882
2019-04-20,50086,14,3156,744,22,60,54082
2019-04-21,48723,17,1573,697,49,98,51157
2019-04-22,78648,11,1864,777,33,75,81408
2019-04-23,54235,19,7624,669,11,65,62623
2019-04-24,39253,15,7483,672,22,62,47507
2019-04-25,44274,21,7327,693,39,74,52428
2019-04-26,55412,10,6311,758,29,52,62572
2019-04-27,63798,25,3456,1040,52,118,68489
2019-04-28,59487,15,1739,1166,24,108,62539
2019-04-29,46197,16,7129,766,33,68,54209
2019-04-30,48427,15,6031,843,36,74,55426
2019-05-01,49073,14,2101,867,40,93,52188
2019-05-02,55591,14,3413,863,55,105,60041
2019-05-03,63491,17,6000,806,43,67,70424
2019-05-04,79764,15,3885,1054,62,154,84934
2019-05-05,70317,10,1909,1091,10,111,73448
2019-05-06,40636,21,6227,655,18,64,47621
2019-05-07,33551,21,7323,555,29,97,41576
2019-05-08,31299,20,7836,590,35,64,39844
2019-05-09,33204,17,6797,633,15,119,40785
2019-05-10,38047,17,7058,713,32,69,45936
2019-05-11,42517,14,4061,802,32,165,47591
2019-05-12,46587,15,2109,863,17,83,49674
2019-05-13,32731,21,6694,596,17,64,40123
2019-05-14,26463,19,7191,656,19,92,34440
2019-05-15,29175,18,7103,667,33,57,37053
2019-05-16,29582,18,7021,699,44,55,37419
2019-05-17,41220,20,6861,755,44,60,48960
2019-05-18,41236,14,4169,950,23,175,46567
2019-05-19,49163,14,2219,951,34,134,52515
2019-05-20,32754,15,7129,692,21,72,40683
2019-05-21,29229,17,7215,641,22,93,37217
2019-05-22,30391,15,8150,765,41,103,39465
2019-05-23,31486,21,7484,727,42,82,39842
2019-05-24,39845,17,6551,788,34,53,47288
2019-05-25,43278,14,3980,926,37,201,48436
2019-05-26,51482,12,1830,1112,38,172,54646
2019-05-27,35770,23,7224,732,18,50,43817
2019-05-28,31077,16,7619,617,27,76,39432
2019-05-29,33780,22,7366,669,24,91,41952
2019-05-30,42990,17,7594,811,40,111,51563
2019-05-31,43811,17,7047,778,53,97,51803
2019-06-01,51892,15,3520,886,78,166,56557
2019-06-02,80825,13,2378,1049,90,198,84553
2019-06-03,43016,16,6378,687,36,99,50232
2019-06-04,33947,17,6450,745,44,120,41323
2019-06-05,37573,20,6799,648,37,121,45198
2019-06-06,39667,20,6859,728,45,139,47458
2019-06-07,48041,20,6353,898,65,115,55492
2019-06-08,54414,11,3726,951,115,252,59469
2019-06-09,67442,13,1878,936,98,201,70568
2019-06-10,67090,24,4739,900,77,172,73002
2019-06-11,41734,18,7351,663,47,117,49930
2019-06-12,39209,21,7340,671,55,122,47418
2019-06-13,41694,18,7221,662,50,152,49797
2019-06-14,51878,18,6729,736,73,120,59554
2019-06-15,63708,14,4031,1006,79,243,69081
2019-06-16,78974,13,1986,1191,138,195,82497
2019-06-17,50246,19,7084,654,68,116,58187
2019-06-18,41567,16,6941,609,44,133,49310
2019-06-19,49028,17,7358,724,59,148,57334
2019-06-20,60373,17,5573,799,77,160,66999
2019-06-21,68389,20,6104,746,118,96,75473
2019-06-22,79631,13,3585,1017,55,252,84553
2019-06-23,96150,16,2076,1161,125,219,99747
2019-06-24,56874,20,7140,705,72,170,64981
2019-06-25,60993,15,3485,661,66,164,65384
2019-06-26,50300,23,7852,719,78,121,59093
2019-06-27,49804,24,7766,879,103,188,58764
2019-06-28,65884,18,6548,841,80,172,73543
2019-06-29,79223,10,3876,961,122,272,84464
2019-06-30,94221,16,2347,1327,196,229,98336
2019-07-01,61117,22,6701,799,77,142,68858
2019-07-02,46949,20,7264,699,67,186,55185
2019-07-03,50157,19,7085,758,71,187,58277
2019-07-04,56225,21,7190,885,70,177,64568
2019-07-05,70793,20,6721,801,139,173,78647
2019-07-06,88983,17,3698,1149,181,308,94336
2019-07-07,95075,13,1655,1286,118,222,98369
2019-07-08,67372,22,6937,642,108,180,75261
2019-07-09,56535,19,6966,710,63,131,64424
2019-07-10,57508,18,7567,791,30,177,66091
2019-07-11,57100,21,5922,766,118,198,64125
2019-07-12,81319,19,6560,768,141,170,88977
2019-07-13,104370,12,3911,983,98,195,109569
2019-07-14,102552,16,1842,1080,151,233,105874
2019-07-15,73698,19,7120,628,71,165,81701
2019-07-16,58439,21,7277,704,58,191,66690
2019-07-17,62587,20,7305,798,94,120,70924
2019-07-18,69584,20,7195,727,108,199,77833
2019-07-19,88507,19,6370,725,148,163,95932
2019-07-20,112740,14,3554,999,150,302,117759
2019-07-21,115446,14,2007,1258,200,265,119190
2019-07-22,82286,18,6826,608,146,171,90055
2019-07-23,66933,23,6814,662,98,192,74722
2019-07-24,68804,21,7014,733,129,205,76906
2019-07-25,82219,19,6857,918,188,208,90409
2019-07-26,103568,20,6308,954,265,178,111293
2019-07-27,123462,16,2924,965,132,295,127794
2019-07-28,123190,16,2032,1148,30,223,126639
2019-07-29,82705,21,6444,748,90,184,90192
2019-07-30,70359,19,6850,724,132,192,78276
2019-07-31,72947,23,6972,918,136,198,81194
2019-08-01,89036,20,6603,858,168,203,96888
2019-08-02,114165,19,5765,721,108,157,120935
2019-08-03,127358,14,3458,917,159,320,132226
2019-08-04,115216,16,1955,1148,201,251,118787
2019-08-05,92318,16,4336,614,156,181,97621
2019-08-06,64143,25,5233,698,90,201,70390
2019-08-07,78901,21,6249,856,106,197,86330
2019-08-08,88422,22,6104,880,95,206,95729
2019-08-09,111852,19,5396,753,215,180,118415
2019-08-10,136446,17,2987,981,186,292,140909
2019-08-11,119588,13,1067,1068,215,186,122137
2019-08-12,92225,22,4938,670,285,169,98309
2019-08-13,77635,19,5306,716,178,175,84029
2019-08-14,92108,17,5077,768,76,180,98226
2019-08-15,96991,15,2814,889,219,143,101071
2019-08-16,111297,19,4697,694,287,114,117108
2019-08-17,131724,14,2723,970,493,221,136145
2019-08-18,157119,17,1194,1202,375,244,160151
2019-08-19,93060,19,5543,767,224,170,99783
2019-08-20,71386,24,5025,766,391,68,77660
2019-08-21,78585,21,5925,828,263,181,85803
2019-08-22,87671,22,5815,789,156,199,94652
2019-08-23,104794,24,5353,721,222,136,111250
2019-08-24,112026,16,2652,939,385,185,116203
2019-08-25,121044,11,1366,1306,272,207,124206
2019-08-26,79710,23,6505,806,107,154,87305
2019-08-27,67369,17,6278,715,140,174,74693
2019-08-28,68062,19,6696,717,159,117,75770
2019-08-29,78908,21,6489,765,190,167,86540
2019-08-30,94530,20,5771,776,142,110,101349
2019-08-31,104871,17,3373,1000,188,211,109660
2019-09-01,107014,20,1703,1165,214,235,110351
2019-09-02,68565,25,6353,652,70,118,75783
2019-09-03,56907,18,6796,713,47,134,64615
2019-09-04,52385,23,6867,661,63,91,60090
2019-09-05,60697,23,6845,726,113,150,68554
2019-09-06,80038,18,6024,749,64,114,87007
2019-09-07,79841,16,3682,975,72,239,84825
2019-09-08,81045,17,1840,1114,46,131,84193
2019-09-09,51180,24,6455,685,66,99,58509
2019-09-10,44088,18,6542,679,66,134,51527
2019-09-11,43756,20,8031,669,50,127,52653
2019-09-12,46049,19,6808,718,53,141,53788
2019-09-13,57515,22,6021,789,70,123,64540
2019-09-14,72387,16,3514,958,84,243,77202
2019-09-15,89910,16,1934,1043,138,216,93257
2019-09-16,55305,19,6703,740,69,86,62922
2019-09-17,46508,21,7387,671,84,129,54800
2019-09-18,44804,20,7619,690,49,119,53301
2019-09-19,46944,21,7225,816,44,134,55184
2019-09-20,58690,18,5883,867,57,85,65600
2019-09-21,65403,9,4285,1035,69,197,70998
2019-09-22,85142,12,2112,1134,97,199,88696
2019-09-23,39935,21,5157,696,24,99,45932
2019-09-24,35081,16,7256,625,49,119,43146
2019-09-25,38695,17,6967,672,41,79,46471
2019-09-26,41088,16,7512,843,60,124,49643
2019-09-27,45016,19,6452,724,41,98,52350
2019-09-28,55194,15,4082,985,61,155,60492
2019-09-29,67727,13,2042,1104,51,175,71112
2019-09-30,41801,18,6952,705,42,82,49600
2019-10-01,34397,16,6891,713,44,111,42172
2019-10-02,33235,20,5646,656,17,63,39637
2019-10-03,39219,14,6997,748,29,113,47120
2019-10-04,47038,19,6371,735,53,80,54296
2019-10-05,49932,11,3890,1033,49,132,55047
2019-10-06,61179,15,2041,1074,35,159,64503
2019-10-07,37581,16,6955,605,32,69,45258
2019-10-08,33662,14,5295,670,44,75,39760
2019-10-09,30640,20,6802,689,41,52,38244
2019-10-10,34994,19,7377,701,31,55,43177
2019-10-11,43785,19,6673,748,67,70,51362
2019-10-12,45784,15,3889,1004,37,162,50891
2019-10-13,59623,11,1938,1123,39,158,62892
2019-10-14,36798,20,6713,634,42,48,44255
2019-10-15,30259,17,6805,613,17,80,37791
2019-10-16,31948,18,7005,663,29,66,39729
2019-10-17,34092,17,7037,756,33,63,41998
2019-10-18,42444,20,6357,689,24,59,49593
2019-10-19,43000,14,4019,873,24,115,48045
2019-10-20,54475,12,1919,907,30,111,57454
2019-10-21,34941,18,6884,565,32,60,42500
2019-10-22,29591,18,7172,601,26,62,37470
2019-10-23,30533,20,6612,583,20,60,37828
2019-10-24,34263,17,7297,654,26,86,42343
2019-10-25,44971,18,7069,657,24,54,52793
2019-10-26,46716,13,3930,842,27,82,51610
2019-10-27,54027,12,1616,888,26,39,56608
2019-10-28,38863,21,6643,1623,21,32,47203
2019-10-29,35177,20,7442,483,23,23,43168
2019-10-30,42825,21,6741,536,20,14,50157
2019-10-31,51135,14,5195,608,20,90,57062
2019-11-01,43578,9,2798,586,12,10,46993
2019-11-02,47895,14,2736,531,11,42,51229
2019-11-03,66340,13,1517,730,4,15,68619
2019-11-04,40403,19,7049,480,16,14,47981
2019-11-05,29473,19,7277,418,17,13,37217
2019-11-06,27203,23,7698,451,21,11,35407
2019-11-07,28317,19,7001,505,25,17,35884
2019-11-08,34295,16,6554,480,18,14,41377
2019-11-09,34088,11,3312,630,13,13,38067
2019-11-10,39995,9,1913,760,10,13,42700
2019-11-11,30842,19,6595,359,14,7,37836
2019-11-12,24205,21,6879,429,5,21,31560
2019-11-13,25134,21,6740,704,9,7,32615
2019-11-14,28288,18,7055,476,10,13,35860
2019-11-15,35234,18,5656,475,8,12,41403
2019-11-16,30429,12,3548,613,5,14,34621
2019-11-17,38279,10,2033,619,3,14,40958
2019-11-18,30328,19,7370,373,14,14,38118
2019-11-19,24197,20,7066,357,8,13,31661
2019-11-20,26271,19,7086,391,13,14,33794
2019-11-21,29616,17,7042,465,6,22,37168
2019-11-22,35903,17,6300,1541,8,17,43786
2019-11-23,33186,17,3969,582,14,12,37780
2019-11-24,38851,15,2064,547,9,13,41499
2019-11-25,34051,21,6523,408,12,13,41028
2019-11-26,25967,21,6650,374,13,17,33042
2019-11-27,25834,23,7505,383,12,10,33767
2019-11-28,26709,24,7138,434,10,15,34330
2019-11-29,36634,18,6285,436,14,15,43402
2019-11-30,30891,14,4028,614,13,10,35570
2019-12-01,38996,14,2140,619,5,13,41787
2019-12-02,27107,19,6780,343,7,10,34266
2019-12-03,24783,15,7029,348,12,8,32195
2019-12-04,24953,16,6578,415,5,13,31980
2019-12-05,27299,16,6684,423,12,18,34452
2019-12-06,31938,19,6444,450,11,17,38879
2019-12-07,29735,11,4127,682,13,13,34581
2019-12-08,37417,13,2144,699,13,19,40305
2019-12-09,27573,14,6795,401,9,12,34804
2019-12-10,23087,18,7092,361,9,14,30581
2019-12-11,27240,17,7244,408,9,18,34936
2019-12-12,26647,19,7672,454,11,11,34814
2019-12-13,31485,17,6422,444,3,5,38376
2019-12-14,34501,14,4318,755,10,12,39610
2019-12-15,37851,16,2736,745,6,14,41368
2019-12-16,29097,22,7541,377,15,6,37058
2019-12-17,27956,21,7394,366,11,10,35758
2019-12-18,30918,20,7270,420,10,9,38647
2019-12-19,37729,19,7842,449,7,7,46053
2019-12-20,54400,22,6228,535,4,7,61196
2019-12-21,68602,12,3637,1043,5,6,73305
2019-12-22,54862,16,3614,922,4,13,59431
2019-12-23,42793,20,4520,455,13,6,47807
2019-12-24,37440,19,3375,376,12,5,41227
2019-12-25,29189,11,1264,395,2,7,30868
2019-12-26,38001,13,886,492,4,9,39405
2019-12-27,42299,22,2853,410,3,7,45594
2019-12-28,46367,14,1847,518,10,11,48767
2019-12-29,43385,17,808,664,9,11,44894
2019-12-30,42426,21,2507,535,7,10,45506
2019-12-31,26907,17,1299,421,13,7,28664
2020-01-01,31498,11,490,363,4,16,32382
2020-01-02,50518,14,1347,798,8,10,52695
2020-01-03,53389,19,2550,643,9,17,56627
2020-01-04,55395,17,1397,716,7,13,57545
2020-01-05,62839,11,750,726,7,8,64341
2020-01-06,42927,17,2112,598,3,11,45668
2020-01-07,31452,19,4419,414,4,10,36318
2020-01-08,33464,18,4608,465,9,7,38571
2020-01-09,29850,19,5094,459,2,11,35435
2020-01-10,32531,19,4938,416,11,9,37924
2020-01-11,36247,11,3342,552,5,8,40165
2020-01-12,39756,15,1803,596,3,7,42180
2020-01-13,26502,19,6364,390,6,14,33295
2020-01-14,23519,19,6266,340,13,11,30168
2020-01-15,23140,18,6320,375,5,13,29871
2020-01-16,24934,21,6121,401,7,7,31491
2020-01-17,32253,17,5560,348,13,4,38195
2020-01-18,31127,14,3592,462,8,9,35212
2020-01-19,31250,11,1894,500,4,12,33671
2020-01-20,26373,24,6151,358,10,6,32922
2020-01-21,24685,17,6317,323,8,11,31361
2020-01-22,24430,18,6610,361,12,10,31441
2020-01-23,24892,21,6470,379,3,5,31770
2020-01-24,30264,18,5747,369,9,13,36420
2020-01-25,27964,12,3881,456,6,9,32328
2020-01-26,30473,13,1857,480,1,10,32834
2020-01-27,24131,19,6443,308,2,11,30914
2020-01-28,21975,21,6040,327,23,11,28397
2020-01-29,22688,18,6649,372,9,10,29746
2020-01-30,24701,17,6667,412,6,5,31808
2020-01-31,32231,21,6430,372,10,4,39068
2020-02-01,29965,13,3637,479,5,7,34106
2020-02-02,32017,13,2035,494,11,12,34582
2020-02-03,25859,22,6286,310,14,4,32495
2020-02-04,21479,23,6663,323,7,12,28507
2020-02-05,23441,18,6746,395,9,7,30616
2020-02-06,24010,18,7085,382,8,13,31516
2020-02-07,30940,15,6026,367,10,8,37366
2020-02-08,31490,16,3158,446,10,7,35127
2020-02-09,39625,14,1964,532,8,11,42154
2020-02-10,26300,17,6716,314,8,11,33366
2020-02-11,23873,20,6857,326,11,14,31101
2020-02-12,24909,24,6903,362,15,7,32220
2020-02-13,26378,21,7704,411,6,10,34530
2020-02-14,35929,20,6334,376,6,12,42677
2020-02-15,33951,19,3647,568,13,13,38211
2020-02-16,41384,11,1751,537,7,16,43706
2020-02-17,31751,23,6567,346,3,19,38709
2020-02-18,25975,22,6717,384,11,16,33125
2020-02-19,26320,21,7100,394,9,7,33851
2020-02-20,27996,22,6121,404,13,12,34568
2020-02-21,37058,18,6168,709,10,10,43973
2020-02-22,36047,15,3448,512,9,18,40049
2020-02-23,41109,15,1996,991,8,19,44138
2020-02-24,30185,24,6568,352,11,12,37152
2020-02-25,25132,24,6987,354,12,15,32524
2020-02-26,22452,21,6383,350,8,10,29224
2020-02-27,25331,18,6868,404,11,19,32651
2020-02-28,33067,21,6502,338,5,13,39946
2020-02-29,30028,16,3630,459,11,13,34157
2020-03-01,34282,18,1847,465,3,13,36628
2020-03-02,27571,22,6573,310,9,17,34502
2020-03-03,21109,16,5777,310,4,12,27228
2020-03-04,22369,21,6644,313,12,15,29374
2020-03-05,24075,17,6437,372,6,32,30939
2020-03-06,31072,24,6372,383,5,16,37872
2020-03-07,26765,12,3709,380,10,8,30884
2020-03-08,34454,32,1888,571,9,15,36969
2020-03-09,25806,18,6229,294,14,11,32372
2020-03-10,21244,20,6559,287,5,22,28137
2020-03-11,21832,22,6143,320,8,10,28335
2020-03-12,21609,22,5723,310,12,15,27691
2020-03-13,21192,16,4495,261,6,13,25983
2020-03-14,13774,15,2536,248,5,13,16591
2020-03-15,11671,14,1402,202,5,12,13306
2020-03-16,6213,9,2899,70,11,10,9212
2020-03-17,4469,8,3854,57,6,11,8405
2020-03-18,3626,9,4979,35,6,10,8665
2020-03-19,2614,6,3617,19,7,7,6270
2020-03-20,2410,6,3197,12,10,3,5638
2020-03-21,1395,6,2099,3,8,3,3514
2020-03-22,1087,8,1463,42,4,2,2606
2020-03-23,1587,7,3802,6,4,1,5407
2020-03-24,1796,8,2798,2,2,3,4609
2020-03-25,1165,8,3566,2,6,2,4749
2020-03-26,1286,7,4032,1,6,3,5335
2020-03-27,1178,2,4240,3,7,2,5432
2020-03-28,996,6,2108,0,6,3,3119
2020-03-29,545,5,1080,2,5,2,1639
2020-03-30,1446,6,3700,1,4,3,5160
2020-03-31,1313,6,4179,0,6,1,5505
2020-04-01,1147,8,4263,1,5,1,5425
2020-04-02,939,10,4315,4,13,2,5283
2020-04-03,1430,8,3772,9,4,2,5225
2020-04-04,984,5,1993,3,7,1,2993
2020-04-05,656,2,1080,0,7,1,1746
2020-04-06,1247,9,3840,6,1,5,5108
2020-04-07,1026,5,4187,0,11,2,5231
2020-04-08,1183,7,4566,0,8,3,5767
2020-04-09,1320,4,4217,4,7,3,5555
2020-04-10,1047,4,3268,0,12,1,4332
2020-04-11,444,8,1651,2,3,1,2109
2020-04-12,238,1,869,0,0,1,1109
2020-04-13,949,7,1536,0,8,2,2502
2020-04-14,1478,6,3672,2,4,1,5163
2020-04-15,1228,8,4449,0,6,1,5692
2020-04-16,1293,2,4255,1,9,1,5561
2020-04-17,1106,5,4059,10,5,2,5187
2020-04-18,774,6,1975,4,7,1,2767
2020-04-19,568,6,1453,2,4,1,2034
2020-04-20,1549,5,3373,7,4,1,4939
2020-04-21,1783,4,4087,2,8,4,5888
2020-04-22,1506,7,4314,2,5,2,5836
2020-04-23,1623,5,4589,0,4,2,6223
2020-04-24,1940,9,4214,3,8,2,6176
2020-04-25,1030,3,2541,10,8,2,3594
2020-04-26,902,6,1406,0,7,1,2322
2020-04-27,1672,5,3647,2,3,3,5332
2020-04-28,1828,6,4531,4,7,1,6377
2020-04-29,1872,6,5353,4,13,2,7250
2020-04-30,1875,5,4187,5,7,1,6080
2020-05-01,800,1,1836,4,4,2,2647
2020-05-02,992,2,1591,4,6,3,2598
2020-05-03,2365,5,1505,0,6,2,3883
2020-05-04,2949,9,3993,1,4,4,6960
2020-05-05,2030,4,4783,0,5,1,6823
2020-05-06,2267,4,4932,4,10,4,7221
2020-05-07,2195,4,4722,4,10,3,6938
2020-05-08,2446,5,4442,4,8,3,6908
2020-05-09,1480,5,2819,2,6,3,4315
2020-05-10,1616,7,2057,0,8,2,3690
2020-05-11,2937,6,4636,0,9,3,7591
2020-05-12,2878,5,5301,0,3,2,8189
2020-05-13,3410,7,5239,0,7,4,8667
2020-05-14,3199,6,5343,0,10,3,8561
2020-05-15,5124,7,4786,8,8,4,9937
2020-05-16,4154,6,2753,3,4,2,6922
2020-05-17,6206,7,2096,6,5,6,8326
2020-05-18,6073,6,5565,1,6,4,11655
2020-05-19,5275,4,5647,1,4,2,10933
2020-05-20,6301,7,5566,15,8,8,11905
2020-05-21,11095,4,5673,10,8,5,16795
2020-05-22,13699,3,5733,8,9,7,19459
2020-05-23,10931,8,2647,23,12,12,13633
2020-05-24,17619,6,1812,6,3,19,19465
2020-05-25,14956,7,4949,16,12,8,19948
2020-05-26,10954,6,6036,17,10,3,17026
2020-05-27,11114,8,6209,24,11,15,17381
2020-05-28,12354,3,5586,70,9,5,18027
2020-05-29,17135,4,5234,20,10,8,22411
2020-05-30,16553,7,2677,33,8,10,19288
2020-05-31,23031,6,1695,9,3,13,24757
2020-06-01,23900,6,4322,33,6,26,28293
2020-06-02,15989,4,5802,20,12,8,21835
2020-06-03,17593,5,5886,34,10,19,23547
2020-06-04,18515,3,5342,58,5,19,23942
2020-06-05,22520,5,5574,30,6,16,28151
2020-06-06,23587,6,3417,46,8,14,27078
2020-06-07,32314,5,1540,37,11,24,33931
2020-06-08,20097,5,5435,38,18,13,25606
2020-06-09,18976,6,5141,25,12,11,24171
2020-06-10,23666,6,6185,116,13,16,30002
2020-06-11,23041,4,3746,82,15,23,26911
2020-06-12,26561,6,5676,47,18,21,32329
2020-06-13,31170,7,2929,41,14,33,34194
2020-06-14,47955,6,1490,90,15,37,49593
2020-06-15,26691,4,4815,81,14,20,31625
2020-06-16,20940,10,5527,78,19,33,26607
2020-06-17,23702,8,5941,117,21,32,29821
2020-06-18,27152,8,6169,190,20,23,33562
2020-06-19,26876,7,6074,165,32,40,33194
2020-06-20,31131,4,3793,197,25,54,35204
2020-06-21,30441,7,1653,251,17,67,32436
2020-06-22,25037,16,4188,114,18,27,29400
2020-06-23,21920,18,6047,109,28,34,28156
2020-06-24,22851,16,6187,154,24,40,29272
2020-06-25,22993,12,5193,151,33,37,28419
2020-06-26,28327,18,6023,145,44,48,34605
2020-06-27,32143,9,3685,184,57,69,36147
2020-06-28,50508,11,1989,270,107,80,52965
2020-06-29,34374,14,5174,136,52,43,39793
2020-06-30,26109,10,6519,123,41,55,32857
2020-07-01,23547,15,5451,147,43,67,29270
2020-07-02,27471,20,6121,194,93,50,33949
2020-07-03,36917,16,5777,170,29,60,42969
2020-07-04,33120,14,3546,231,51,102,37064
2020-07-05,43754,18,2200,339,63,275,46649
2020-07-06,30388,13,5560,123,55,77,36216
2020-07-07,25906,15,6219,161,26,58,32385
2020-07-08,27124,23,6692,183,41,76,34139
2020-07-09,26926,19,6375,264,48,53,33685
2020-07-10,34383,18,6325,162,118,82,41088
2020-07-11,38312,16,3603,222,62,97,42312
2020-07-12,49642,15,1845,305,48,129,51984
2020-07-13,32416,20,5701,138,49,80,38404
2020-07-14,25893,17,6028,148,56,65,32207
2020-07-15,28108,20,6616,163,63,68,35038
2020-07-16,29168,16,6853,186,70,73,36366
2020-07-17,37706,13,5683,189,45,91,43727
2020-07-18,42348,16,3156,234,70,143,45967
2020-07-19,48715,12,2197,289,127,123,51463
2020-07-20,37316,18,6208,124,67,77,43810
2020-07-21,27763,17,5712,188,58,81,33819
2020-07-22,28436,18,5963,175,63,90,34745
2020-07-23,37569,18,6369,209,82,85,44332
2020-07-24,44792,19,6295,155,55,81,51397
2020-07-25,49066,14,3050,317,84,116,52647
2020-07-26,50996,19,1822,308,118,145,53408
2020-07-27,40676,15,5822,160,69,85,46827
2020-07-28,33379,12,6447,134,67,98,40137
2020-07-29,34860,18,6544,189,80,97,41788
2020-07-30,47671,17,6316,261,84,80,54429
2020-07-31,51822,16,5340,229,122,65,57594
2020-08-01,58447,15,2757,237,153,196,61805
2020-08-02,60282,14,1529,329,186,152,62492
2020-08-03,42536,20,5634,143,40,101,48474
2020-08-04,37477,14,6063,171,35,83,43843
2020-08-05,33664,14,4479,192,31,100,38480
2020-08-06,41582,24,6218,193,66,99,48182
2020-08-07,43798,18,5369,197,109,121,49612
2020-08-08,64328,17,3072,298,127,193,68035
2020-08-09,68632,11,1576,336,114,190,70859
2020-08-10,49846,14,5147,134,106,105,55352
2020-08-11,37762,12,5560,149,88,102,43673
2020-08-12,41660,13,5577,195,122,105,47672
2020-08-13,46407,26,5725,209,202,105,52674
2020-08-14,59007,13,5061,248,176,120,64625
2020-08-15,69768,16,1741,281,248,194,72248
2020-08-16,66516,18,1013,351,304,187,68389
2020-08-17,43997,18,5214,262,172,107,49770
2020-08-18,36453,15,4912,157,73,76,41686
2020-08-19,39937,12,6340,202,166,109,46766
2020-08-20,44885,15,4981,198,316,108,50503
2020-08-21,48004,17,5258,209,238,116,53842
2020-08-22,51875,15,2659,309,281,156,55295
2020-08-23,46122,11,1553,316,85,158,48245
2020-08-24,36885,14,5299,255,46,97,42596
2020-08-25,29388,15,6014,134,58,92,35701
2020-08-26,27943,12,5999,169,95,86,34304
2020-08-27,33200,11,5881,227,102,93,39514
2020-08-28,48255,21,6071,183,107,92,54729
2020-08-29,43343,15,3146,254,29,165,46952
2020-08-30,40525,11,1569,331,17,129,42582
2020-08-31,32095,17,4611,131,31,72,36957
2020-09-01,21590,18,6296,136,21,58,28119
2020-09-02,21233,17,6337,178,45,57,27867
2020-09-03,23015,17,6060,181,41,68,29382
2020-09-04,27705,17,5386,162,28,59,33357
2020-09-05,28432,11,3457,219,37,94,32250
2020-09-06,33327,13,1689,274,42,104,35449
2020-09-07,21280,13,5937,131,26,67,27454
2020-09-08,18744,13,5765,137,33,61,24753
2020-09-09,19352,15,6103,172,29,37,25708
2020-09-10,22067,16,6631,193,35,45,28987
2020-09-11,25329,12,5742,143,40,46,31312
2020-09-12,28832,13,3447,208,32,111,32643
2020-09-13,31215,11,1904,306,43,85,33564
2020-09-14,20383,16,6154,148,17,40,26758
2020-09-15,18823,18,6309,150,30,40,25370
2020-09-16,19997,20,6193,170,27,42,26449
2020-09-17,20998,17,6495,169,33,38,27750
2020-09-18,24371,18,6614,163,18,47,31231
2020-09-19,22362,12,3973,227,30,97,26701
2020-09-20,30776,16,1987,247,36,74,33136
2020-09-21,21123,21,6264,112,30,30,27580
2020-09-22,18365,19,6534,129,20,31,25098
2020-09-23,17358,18,6751,161,14,33,24335
2020-09-24,19345,15,6542,173,26,33,26134
2020-09-25,23144,18,5680,153,8,25,29028
2020-09-26,21715,10,3700,211,18,75,25729
2020-09-27,22274,13,1929,273,10,43,24542
2020-09-28,16046,20,5943,126,13,15,22163
2020-09-29,17422,17,6758,128,35,25,24385
2020-09-30,19297,15,7102,185,36,26,26661
2020-10-01,20609,16,6611,169,30,22,27457
2020-10-02,26346,15,6695,168,18,19,33261
2020-10-03,26546,12,3772,202,4,46,30582
2020-10-04,26345,9,2103,252,7,38,28754
2020-10-05,19275,17,6558,127,18,22,26017
2020-10-06,16930,15,7236,141,21,13,24356
2020-10-07,17348,15,7026,160,14,12,24575
2020-10-08,19562,15,6861,193,32,18,26681
2020-10-09,25355,16,6439,165,23,15,32013
2020-10-10,29117,16,3511,220,29,42,32935
2020-10-11,28934,15,1942,251,5,25,31172
2020-10-12,19565,16,6855,134,11,14,26595
2020-10-13,17170,16,6718,147,19,11,24081
2020-10-14,17713,16,7152,167,27,14,25089
2020-10-15,19563,15,6612,176,5,19,26390
2020-10-16,24769,16,6191,173,14,22,31185
2020-10-17,22378,9,3791,227,14,33,26452
2020-10-18,26701,10,1876,277,19,25,28908
2020-10-19,20882,19,6351,148,27,20,27447
2020-10-20,15515,17,6617,144,15,18,22326
2020-10-21,15411,14,6863,170,17,21,22496
2020-10-22,17907,15,6828,187,21,15,24973
2020-10-23,23396,14,5724,165,16,26,29341
2020-10-24,19835,9,4441,221,11,41,24558
2020-10-25,19603,9,2118,283,9,11,22033
2020-10-26,19178,20,6379,125,12,9,25723
2020-10-27,13059,20,7067,131,12,12,20301
2020-10-28,13672,16,7345,168,19,13,21233
2020-10-29,14635,14,7008,197,14,7,21875
2020-10-30,19777,18,5571,162,16,18,25562
2020-10-31,19883,17,3323,202,20,19,23464
2020-11-01,20391,14,2204,257,8,24,22898
2020-11-02,17224,19,6526,125,14,10,23918
2020-11-03,13026,15,5933,125,21,5,19125
2020-11-04,13741,16,6937,147,12,8,20861
2020-11-05,13943,15,6860,161,12,7,20998
2020-11-06,17391,16,6279,145,12,7,23850
2020-11-07,14619,9,4344,156,12,15,19155
2020-11-08,19727,5,2206,203,4,25,22170
2020-11-09,14518,15,6802,113,16,6,21470
2020-11-10,12471,16,6888,118,13,10,19516
2020-11-11,12978,14,7019,126,9,6,20152
2020-11-12,14429,15,6985,158,9,7,21603
2020-11-13,19482,15,6373,143,11,8,26032
2020-11-14,15027,9,3752,179,10,14,18991
2020-11-15,18796,6,1989,196,3,8,20998
2020-11-16,12423,14,6220,92,11,7,18767
2020-11-17,10840,10,7670,92,10,14,18636
2020-11-18,9672,10,5229,126,7,9,15053
2020-11-19,12202,7,6576,136,13,5,18939
2020-11-20,13957,12,6116,121,4,6,20216
2020-11-21,10627,6,4140,142,10,8,14933
2020-11-22,12077,6,2069,176,13,9,14350
2020-11-23,11600,11,6113,80,11,5,17820
2020-11-24,11708,9,6695,98,15,6,18531
2020-11-25,12828,8,6710,114,14,11,19685
2020-11-26,11530,11,6551,133,13,5,18243
2020-11-27,15762,12,5970,135,6,5,21890
2020-11-28,11186,10,3856,146,11,8,15217
2020-11-29,11769,5,2032,171,5,6,13988
2020-11-30,12452,15,6846,104,17,7,19441
2020-12-01,9735,15,6835,91,8,8,16692
2020-12-02,8770,9,6143,118,8,6,15054
2020-12-03,8981,9,6181,133,6,6,15316
2020-12-04,11484,9,5928,105,5,25,17556
2020-12-05,8798,8,3797,150,7,2,12762
2020-12-06,8150,8,1947,170,2,12,10289
2020-12-07,8509,12,6383,104,8,6,15022
2020-12-08,8244,10,5614,93,9,4,13974
2020-12-09,8978,9,6434,137,9,3,15570
2020-12-10,9516,7,6653,146,19,9,16350
2020-12-11,12216,11,6325,124,15,11,18702
2020-12-12,9974,10,4187,173,11,7,14362
2020-12-13,8959,10,2489,220,7,6,11691
2020-12-14,9244,8,5935,100,8,6,15301
2020-12-15,9770,10,6316,105,19,5,16225
2020-12-16,12156,17,7082,165,11,7,19438
2020-12-17,14061,14,7039,220,11,4,21349
2020-12-18,21686,19,6779,192,14,12,28702
2020-12-19,26989,9,3946,371,12,4,31331
2020-12-20,20530,11,2747,321,5,5,23619
2020-12-21,11856,17,6201,123,12,5,18214
2020-12-22,16106,14,4168,150,11,5,20454
2020-12-23,20720,14,5320,176,15,8,26253
2020-12-24,21871,3,3872,216,11,4,25977
2020-12-25,10525,5,1906,122,3,1,12562
2020-12-26,6616,3,800,129,3,4,7555
2020-12-27,7271,5,1202,179,3,8,8668
2020-12-28,8247,9,3548,76,3,4,11887
2020-12-29,9972,9,3600,106,5,2,13694
2020-12-30,11962,14,3099,121,9,3,15208
2020-12-31,9960,7,1416,106,9,1,11499
2021-01-01,7906,7,462,23,1,2,8401
2021-01-02,11882,7,635,108,0,4,12636
2021-01-03,14678,10,1121,211,8,3,16031
2021-01-04,16724,11,3488,112,4,2,20341
2021-01-05,12300,14,3243,127,12,12,15708
2021-01-06,11549,13,1907,168,8,4,13649
2021-01-07,11478,10,2924,188,6,2,14608
2021-01-08,14688,15,3463,126,11,8,18311
2021-01-09,14653,13,2581,195,8,6,17456
2021-01-10,14068,9,1800,288,2,6,16173
2021-01-11,12609,16,4588,145,7,6,17371
2021-01-12,9286,9,5339,113,9,5,14761
2021-01-13,9137,15,5299,141,12,2,14606
2021-01-14,9231,18,5551,180,5,3,14988
2021-01-15,11765,14,4731,119,8,8,16645
2021-01-16,9412,13,3169,167,14,3,12778
2021-01-17,9307,10,1886,230,8,4,11445
2021-01-18,9436,13,5509,95,13,3,15069
2021-01-19,9581,11,5818,100,4,6,15520
2021-01-20,9050,16,5849,131,11,7,15064
2021-01-21,10606,14,5916,174,11,4,16725
2021-01-22,13345,13,5845,124,8,2,19337
2021-01-23,10555,13,3551,155,5,4,14283
2021-01-24,10397,12,2537,214,7,2,13169
2021-01-25,10251,13,5755,96,7,4,16126
2021-01-26,9338,19,6034,95,10,2,15498
2021-01-27,9724,18,6007,128,12,3,15892
2021-01-28,10728,13,5808,158,12,12,16731
2021-01-29,13938,17,5806,124,10,9,19904
2021-01-30,11319,9,3733,167,6,3,15237
2021-01-31,9825,10,1903,210,11,3,11962
2021-02-01,9746,16,5517,98,10,4,15391
2021-02-02,10814,15,6288,100,8,2,17227
2021-02-03,9831,15,6660,135,5,11,16657
2021-02-04,11269,16,6382,181,9,5,17862
2021-02-05,15533,13,5918,131,10,4,21609
2021-02-06,12372,7,3785,162,11,10,16347
2021-02-07,10323,10,2063,223,2,5,12626
2021-02-08,11451,12,4444,94,6,5,16012
2021-02-09,11030,17,6429,94,7,2,17579
2021-02-10,10790,16,6737,137,3,1,17684
2021-02-11,11469,15,6441,186,7,12,18130
2021-02-12,16130,15,6127,121,3,12,22408
2021-02-13,12550,11,3587,160,5,5,16318
2021-02-14,11659,9,2057,191,0,2,13918
2021-02-15,11867,15,6337,89,7,7,18322
2021-02-16,10914,12,5935,111,15,7,16994
2021-02-17,10998,17,6454,129,7,13,17618
2021-02-18,11890,12,6356,158,12,14,18442
2021-02-19,16740,14,6132,126,15,5,23032
2021-02-20,13644,9,4111,169,7,8,17948
2021-02-21,14066,9,2280,216,1,5,16577
2021-02-22,12707,17,6424,105,12,10,19275
2021-02-23,11397,15,6870,104,13,5,18404
2021-02-24,11841,13,6795,126,7,6,18788
2021-02-25,13049,16,7048,170,8,10,20301
2021-02-26,17915,14,6377,137,11,10,24464
2021-02-27,14523,9,3964,167,12,5,18680
2021-02-28,15156,10,2307,207,4,11,17695
2021-03-01,13188,16,5520,95,9,8,18836
2021-03-02,11701,15,6605,111,4,12,18448
2021-03-03,12186,14,7052,140,10,8,19410
2021-03-04,14202,14,7044,173,12,7,21452
2021-03-05,15621,12,5763,124,4,5,21529
2021-03-06,13662,8,3786,160,8,8,17632
2021-03-07,14981,6,2014,213,8,9,17231
2021-03-08,11744,19,6315,105,13,8,18204
2021-03-09,11213,11,6875,102,6,6,18213
2021-03-10,13004,15,6407,151,9,13,19599
2021-03-11,11115,13,6202,151,16,15,17512
2021-03-12,14382,17,5180,105,7,11,19702
2021-03-13,10828,7,2879,119,16,11,13860
2021-03-14,10031,9,1348,158,2,10,11558
2021-03-15,10611,17,5683,114,11,5,16441
2021-03-16,10908,14,6963,113,13,8,18019
2021-03-17,11211,16,7449,141,11,13,18841
2021-03-18,12687,16,7015,163,13,4,19898
2021-03-19,17146,16,6775,122,14,9,24082
2021-03-20,12284,7,4072,182,6,10,16561
2021-03-21,13178,9,2426,227,4,9,15853
2021-03-22,12109,18,5823,109,5,12,18076
2021-03-23,10587,15,6823,105,11,12,17553
2021-03-24,12114,18,7535,141,9,14,19831
2021-03-25,12662,15,7064,171,14,15,19941
2021-03-26,18291,14,6475,132,16,11,24939
2021-03-27,18866,9,4181,198,7,12,23273
2021-03-28,14680,7,2381,229,4,14,17315
2021-03-29,12037,19,6715,106,14,8,18899
2021-03-30,12939,15,6936,102,15,19,20026
2021-03-31,15967,15,6279,156,13,16,22446
2021-04-01,18622,16,6779,178,19,23,25637
2021-04-02,22611,16,5575,179,8,16,28405
2021-04-03,12908,12,3350,163,6,22,16461
2021-04-04,13463,8,1426,174,2,9,15082
2021-04-05,19416,9,1780,118,10,34,21367
2021-04-06,15220,14,5917,103,7,7,21268
2021-04-07,13290,13,7047,138,12,15,20515
2021-04-08,11967,18,6738,168,10,34,18935
2021-04-09,17203,16,6697,140,20,24,24100
2021-04-10,18950,7,4274,176,10,16,23433
2021-04-11,18208,8,2463,232,9,17,20937
2021-04-12,12638,14,6342,114,7,7,19122
2021-04-13,11349,21,6537,102,12,6,18027
2021-04-14,12367,17,7385,135,19,18,19941
2021-04-15,13456,12,6932,165,18,13,20596
2021-04-16,18595,15,6274,134,12,10,25040
2021-04-17,15915,10,3796,174,16,16,19927
2021-04-18,19383,11,2092,203,9,19,21717
2021-04-19,13843,13,6614,120,11,6,20607
2021-04-20,12251,15,6717,96,8,16,19103
2021-04-21,13500,17,7426,134,10,14,21101
2021-04-22,14022,16,6835,163,8,15,21059
2021-04-23,20240,17,6434,176,14,16,26897
2021-04-24,19083,11,4244,157,12,29,23536
2021-04-25,20591,10,2982,224,16,34,23857
2021-04-26,16381,15,6519,101,17,15,23048
2021-04-27,16711,13,5526,97,9,5,22361
2021-04-28,15872,15,7516,155,8,13,23579
2021-04-29,19447,17,6909,179,15,18,26585
2021-04-30,26344,13,5630,131,13,16,32147
2021-05-01,22700,10,2381,189,11,23,25314
2021-05-02,22918,12,1240,221,13,23,24427
2021-05-03,21350,16,5859,87,21,24,27357
2021-05-04,17128,14,5923,104,23,12,23204
2021-05-05,16410,13,6549,154,14,16,23156
2021-05-06,16571,14,5977,189,16,24,22791
2021-05-07,22030,18,5818,154,16,18,28054
2021-05-08,25364,12,4059,204,17,36,29692
2021-05-09,27293,10,2062,270,19,34,29688
2021-05-10,18738,18,6289,127,16,26,25214
2021-05-11,19252,14,6945,468,19,15,26713
2021-05-12,24539,15,6983,162,11,20,31730
2021-05-13,27305,12,5951,175,9,19,33471
2021-05-14,22403,13,5166,134,17,16,27749
2021-05-15,23836,13,3587,136,20,28,27620
2021-05-16,35673,11,1721,287,20,35,37747
2021-05-17,23781,14,6006,130,17,14,29962
2021-05-18,17333,14,6509,137,17,19,24029
2021-05-19,17893,15,6458,157,18,17,24558
2021-05-20,18978,13,6551,205,16,24,25787
2021-05-21,26538,16,6201,152,12,23,32942
2021-05-22,31332,11,3819,212,22,50,35446
2021-05-23,28422,11,3576,265,15,27,32316
2021-05-24,29782,12,5338,154,11,33,35330
2021-05-25,19608,13,6475,121,24,20,26261
2021-05-26,18146,15,6962,171,29,45,25368
2021-05-27,19656,18,6664,200,17,36,26591
2021-05-28,26587,17,7418,170,22,49,34263
2021-05-29,28958,11,4235,204,27,39,33474
2021-05-30,35553,12,2161,295,23,44,38088
2021-05-31,22511,15,6464,147,18,39,29194
2021-06-01,20779,15,6771,158,24,36,27783
2021-06-02,24714,13,6888,181,56,41,31893
2021-06-03,29389,14,4816,253,31,54,34557
2021-06-04,28650,22,5979,155,42,43,34891
2021-06-05,36874,14,4176,262,45,85,41456
2021-06-06,51092,13,2103,335,40,81,53664
2021-06-07,27823,16,6730,157,21,36,34783
2021-06-08,20238,17,6937,172,31,46,27441
2021-06-09,20151,16,7024,211,17,46,27465
2021-06-10,23861,18,7097,227,23,51,31277
2021-06-11,31685,16,6487,216,35,57,38496
2021-06-12,30730,14,4330,246,33,78,35431
2021-06-13,42376,15,2377,377,43,114,45302
2021-06-14,28206,15,6747,170,26,50,35214
2021-06-15,24832,16,7282,164,29,44,32367
2021-06-16,24933,13,8119,231,36,51,33383
2021-06-17,27366,20,7744,238,23,67,35458
2021-06-18,36155,15,6639,237,54,60,43160
2021-06-19,40017,9,4191,330,31,114,44692
2021-06-20,51881,11,2811,441,48,111,55303
2021-06-21,33325,14,6109,251,51,61,39811
2021-06-22,26089,20,5666,241,28,57,32101
2021-06-23,31896,16,7138,343,47,63,39503
2021-06-24,38321,19,7405,314,37,71,46167
2021-06-25,44113,12,5519,289,77,87,50097
2021-06-26,48406,12,4376,514,67,139,53514
2021-06-27,68485,9,2754,703,105,154,72210
2021-06-28,39741,15,6012,259,66,88,46181
2021-06-29,34806,13,7326,249,48,89,42531
2021-06-30,38555,13,11986,307,34,73,50968
2021-07-01,38208,18,7180,335,48,121,45910
2021-07-02,47588,20,6616,441,76,105,54846
2021-07-03,54773,19,4625,436,93,193,60139
2021-07-04,69828,16,2174,566,59,141,72784
2021-07-05,44292,18,6398,243,38,108,51097
2021-07-06,30364,12,6603,272,50,110,37411
2021-07-07,33127,21,6949,317,65,136,40615
2021-07-08,41853,15,6641,397,62,86,49054
2021-07-09,52473,14,6507,335,88,136,59553
2021-07-10,72167,16,3988,525,84,181,76961
2021-07-11,67381,14,2808,571,139,191,71104
2021-07-12,49492,17,6455,237,110,106,56417
2021-07-13,41835,13,6815,269,43,105,49080
2021-07-14,46220,19,7044,296,50,123,53752
2021-07-15,51425,12,6797,374,120,133,58861
2021-07-16,69692,19,6559,359,133,119,76881
2021-07-17,80132,11,3969,637,59,204,85012
2021-07-18,78725,18,2296,575,77,175,81866
2021-07-19,60988,17,6374,267,60,126,67832
2021-07-20,48511,17,5538,254,93,122,54535
2021-07-21,49738,19,6646,329,90,134,56956
2021-07-22,52270,13,6379,377,82,134,59255
2021-07-23,78175,15,6447,389,122,162,85310
2021-07-24,94874,14,3754,506,224,230,99602
2021-07-25,95561,9,2182,603,107,227,98689
2021-07-26,61759,16,6283,241,62,118,68479
2021-07-27,53925,13,6704,287,97,156,61182
2021-07-28,55813,18,6425,372,95,126,62849
2021-07-29,68273,17,6229,427,130,174,75250
2021-07-30,92303,15,6165,464,198,174,99319
2021-07-31,120018,9,3748,781,225,260,125041
2021-08-01,108555,7,2310,922,50,179,112023
2021-08-02,76835,20,5952,320,97,181,83405
2021-08-03,58284,19,6273,278,114,115,65083
2021-08-04,63041,13,6386,335,115,151,70041
2021-08-05,71753,17,4915,365,39,129,77218
2021-08-06,89740,16,6150,425,195,168,96694
2021-08-07,112410,13,3541,517,149,203,116833
2021-08-08,110449,11,1611,604,76,224,112975
2021-08-09,78491,18,6376,286,116,117,85404
2021-08-10,65988,15,6388,305,147,165,73008
2021-08-11,65328,19,6564,306,117,141,72475
2021-08-12,78305,19,6177,451,1860,191,87003
2021-08-13,97923,21,5624,317,253,153,104291
2021-08-14,117659,12,3155,516,281,293,121916
2021-08-15,102851,13,1361,624,416,232,105497
2021-08-16,81823,15,5312,323,220,142,87835
2021-08-17,59743,14,5752,360,57,99,66025
2021-08-18,63285,17,6061,392,129,139,70023
2021-08-19,73055,15,5812,373,227,184,79666
2021-08-20,95070,15,5392,398,400,188,101463
2021-08-21,104715,7,2988,562,464,222,108958
2021-08-22,112923,12,1467,683,561,265,115911
2021-08-23,78381,16,6037,316,64,107,84921
2021-08-24,58087,18,7115,325,115,152,65812
2021-08-25,65397,15,6429,342,120,148,72451
2021-08-26,74913,15,6730,403,319,169,82549
2021-08-27,91193,16,6178,388,145,125,98045
2021-08-28,95301,8,3326,599,95,195,99524
2021-08-29,82656,8,1831,480,117,187,85279
2021-08-30,68376,16,6193,356,131,125,75197
2021-08-31,55141,17,6159,303,76,150,61846
2021-09-01,48284,18,6828,340,85,143,55698
2021-09-02,54701,15,6749,339,78,131,62013
2021-09-03,66021,17,6254,321,120,137,72870
2021-09-04,67333,13,3961,472,96,181,72056
2021-09-05,80038,9,2081,551,114,230,83023
2021-09-06,51575,18,7393,267,57,83,59393
2021-09-07,43870,14,7246,308,69,123,51630
2021-09-08,44908,17,7346,312,71,90,52744
2021-09-09,50481,12,6614,345,82,145,57679
2021-09-10,60258,15,6492,331,100,101,67297
2021-09-11,69462,10,3690,468,76,231,73937
2021-09-12,70980,12,2146,524,121,169,73952
2021-09-13,43831,19,6643,310,57,120,50980
2021-09-14,39135,13,6778,256,70,88,46340
2021-09-15,44481,17,7158,338,64,113,52171
2021-09-16,46824,17,6843,339,74,94,54191
2021-09-17,53229,17,7079,385,60,106,60876
2021-09-18,50055,10,4606,447,43,181,55342
2021-09-19,56560,11,2374,514,40,148,59647
2021-09-20,35789,20,6370,247,37,89,42552
2021-09-21,31208,17,7011,291,52,92,38671
2021-09-22,34184,16,7144,314,40,100,41798
2021-09-23,36219,17,7477,337,46,109,44205
2021-09-24,42980,16,6213,293,56,109,49667
2021-09-25,48020,11,4137,432,56,190,52846
2021-09-26,56970,14,2458,467,60,150,60119
2021-09-27,33876,13,6022,238,44,100,40293
2021-09-28,28166,16,7497,251,45,98,36073
2021-09-29,28757,13,7150,319,35,88,36362
2021-09-30,31968,16,7759,343,36,73,40195
2021-10-01,37509,15,6514,320,41,104,44503
2021-10-02,34713,8,4522,372,54,131,39800
2021-10-03,47791,8,2269,442,22,123,50655
2021-10-04,27676,15,6377,250,30,44,34392
2021-10-05,24403,12,7182,240,21,76,31934
2021-10-06,25090,17,7472,275,24,59,32937
2021-10-07,24920,14,6585,335,13,57,31924
2021-10-08,32515,16,7016,308,18,52,39925
2021-10-09,33240,11,4669,342,28,137,38427
2021-10-10,41539,8,2076,436,7,71,44137
2021-10-11,24870,12,6508,217,22,59,31688
2021-10-12,22800,13,7407,235,39,58,30552
2021-10-13,803537,10,409201,11494,11,46,1224299
2021-10-14,875582,15,444407,12537,15,50,1332606
2021-10-15,33451,12,6488,313,36,71,40371
2021-10-16,32939,9,4058,388,36,91,37521
2021-10-17,39386,10,2271,424,29,95,42215
2021-10-18,26908,15,7248,233,44,59,34507
2021-10-19,22337,11,7485,235,34,63,30165
2021-10-20,22870,14,6986,283,20,53,30226
2021-10-21,25402,15,7494,287,12,53,33263
2021-10-22,35269,13,6488,297,33,45,42145
2021-10-23,37681,10,5052,420,22,102,43287
2021-10-24,36267,11,2489,447,17,72,39303
2021-10-25,28565,16,6395,220,31,52,35279
2021-10-26,30431,14,6989,250,24,62,37770
2021-10-27,26804,14,6386,250,19,49,33522
2021-10-28,29385,14,6801,300,16,51,36567
2021-10-29,40354,16,7349,287,25,44,48075
2021-10-30,43957,7,4361,348,23,54,48750
2021-10-31,41887,9,2169,467,21,45,44598
2021-11-01,39729,15,2605,209,6,8,42572
2021-11-02,31187,14,6907,211,14,22,38355
2021-11-03,21244,18,6594,233,11,27,28127
2021-11-04,21297,14,6999,240,8,7,28565
2021-11-05,25435,13,6848,244,19,13,32572
2021-11-06,26221,8,4690,307,15,19,31260
2021-11-07,29167,8,2457,393,11,14,32050
2021-11-08,20269,17,7058,169,9,9,27531
2021-11-09,16589,16,7001,175,9,7,23797
2021-11-10,19716,13,7149,218,12,14,27122
2021-11-11,21132,18,6840,244,16,15,28265
2021-11-12,26956,14,6210,223,12,6,33421
2021-11-13,23057,9,4532,281,8,7,27894
2021-11-14,28770,7,2373,336,6,15,31507
2021-11-15,19749,17,6468,172,18,17,26441
2021-11-16,17355,14,6514,192,13,14,24102
2021-11-17,20170,16,7181,229,14,14,27624
2021-11-18,19862,15,5556,226,9,8,25676
2021-11-19,26029,16,6262,219,19,10,32555
2021-11-20,21812,10,4017,264,14,11,26128
2021-11-21,29173,8,2164,295,4,4,31648
2021-11-22,22737,15,5427,166,7,9,28361
2021-11-23,18898,15,6830,179,11,5,25938
2021-11-24,20502,10,7230,204,11,5,27962
2021-11-25,20731,14,6873,228,9,5,27860
2021-11-26,25870,16,6701,226,9,9,32831
2021-11-27,19529,11,4319,261,6,6,24132
2021-11-28,24639,6,2548,307,3,4,27507
2021-11-29,18044,13,6541,148,9,4,24759
2021-11-30,17650,16,7328,161,11,12,25178
2021-12-01,18393,17,7417,223,11,8,26069
2021-12-02,17926,14,7813,225,3,9,25990
2021-12-03,25059,17,6705,207,14,10,32012
2021-12-04,20777,6,4493,281,15,9,25581
2021-12-05,21741,9,2920,293,7,9,24979
2021-12-06,18202,12,6443,160,2,6,24825
2021-12-07,17418,14,6827,156,9,8,24432
2021-12-08,19314,21,7508,225,10,14,27092
2021-12-09,16735,14,6353,226,2,12,23342
2021-12-10,23272,13,6967,210,10,8,30480
2021-12-11,21524,9,4162,278,9,11,25993
2021-12-12,22991,6,2839,298,8,9,26151
2021-12-13,17562,16,6234,179,7,6,24004
2021-12-14,17648,15,6761,172,11,9,24616
2021-12-15,20063,15,7376,235,7,5,27701
2021-12-16,22527,13,7216,262,11,8,30037
2021-12-17,30211,18,7147,223,10,11,37620
2021-12-18,36865,10,4094,365,8,10,41352
2021-12-19,30402,11,2920,393,5,10,33741
2021-12-20,22889,15,7203,220,10,10,30347
2021-12-21,23777,18,6955,257,10,8,31025
2021-12-22,33255,14,6909,357,16,13,40564
2021-12-23,46845,14,5666,401,12,9,52947
2021-12-24,56302,16,4633,401,7,9,61368
2021-12-25,30994,7,1732,339,1,4,33077
2021-12-26,27947,9,1562,342,4,12,29876
2021-12-27,27050,15,4580,195,14,4,31858
2021-12-28,27523,12,4668,207,9,13,32432
2021-12-29,28867,17,4417,251,11,12,33575
2021-12-30,36893,15,4183,315,16,15,41437
2021-12-31,24355,13,1475,188,5,4,26040
2022-01-01,27130,6,394,102,1,10,27643
2022-01-02,39624,9,1239,362,7,16,41257
2022-01-03,28805,18,3947,205,10,13,32998
2022-01-04,26486,15,3649,197,8,7,30362
2022-01-05,28413,14,3971,239,9,7,32653
2022-01-06,26944,15,2253,295,2,9,29518
2022-01-07,33015,14,2812,239,7,9,36096
2022-01-08,42520,8,1872,324,6,16,44746
2022-01-09,55735,5,1665,455,7,8,57875
2022-01-10,27789,15,5489,333,4,8,33638
2022-01-11,18301,13,5632,263,8,4,24221
2022-01-12,17821,14,6093,255,4,6,24193
2022-01-13,18906,14,6423,272,5,9,25629
2022-01-14,22758,10,5897,212,5,9,28891
2022-01-15,21624,7,3114,276,11,6,25038
2022-01-16,25373,6,2757,341,7,7,28491
2022-01-17,20236,15,6344,178,10,6,26789
2022-01-18,16880,16,6199,182,10,11,23298
2022-01-19,17829,12,5988,225,12,3,24069
2022-01-20,17284,11,6551,239,9,5,24099
2022-01-21,23089,14,6003,212,10,8,29336
2022-01-22,20718,7,3523,253,6,7,24514
2022-01-23,23678,9,2688,310,4,11,26700
2022-01-24,18204,13,6434,167,6,3,24827
2022-01-25,15607,16,6504,165,8,6,22306
2022-01-26,16040,12,6697,238,13,18,23018
2022-01-27,17530,18,6935,235,5,6,24729
2022-01-28,23086,17,6650,221,9,4,29987
2022-01-29,20593,9,4028,258,10,8,24906
2022-01-30,21747,8,2088,308,7,12,24170
2022-01-31,17380,21,7068,164,4,8,24645
2022-02-01,16398,15,6955,168,7,5,23548
2022-02-02,16949,14,6879,211,7,9,24069
2022-02-03,19753,16,6986,245,10,10,27020
2022-02-04,25813,15,6186,190,10,11,32225
2022-02-05,23080,8,4604,265,10,8,27975
2022-02-06,24610,7,2730,277,11,10,27645
2022-02-07,18702,20,6695,168,4,12,25601
2022-02-08,24685,16,4136,163,11,14,29025
2022-02-09,19160,12,7911,213,17,6,27319
2022-02-10,20797,14,7425,250,8,13,28507
2022-02-11,25580,13,6620,201,7,11,32432
2022-02-12,25260,8,3903,278,9,8,29466
2022-02-13,29752,9,2632,302,3,19,32717
2022-02-14,20622,11,7016,158,7,5,27819
2022-02-15,18801,15,6817,162,4,8,25807
2022-02-16,19265,12,6760,194,9,10,26250
2022-02-17,21513,14,7060,217,10,6,28820
2022-02-18,30465,14,6383,199,14,9,37084
2022-02-19,29033,11,4093,264,11,14,33426
2022-02-20,31559,7,3496,287,5,8,35362
2022-02-21,23376,17,7338,164,11,7,30913
2022-02-22,20484,14,6767,318,10,9,27602
2022-02-23,22867,15,8386,244,11,14,31537
2022-02-24,24663,16,7067,242,10,14,32012
2022-02-25,31395,15,6933,209,9,6,38567
2022-02-26,30553,8,4878,282,4,11,35736
2022-02-27,33665,10,2719,321,4,17,36736
2022-02-28,24947,16,6646,165,5,6,31785
2022-03-01,22767,14,7503,184,10,7,30485
2022-03-02,20443,13,6186,234,10,10,26896
2022-03-03,22604,13,7215,249,13,19,30113
2022-03-04,32245,18,6711,238,9,8,39229
2022-03-05,28082,8,4620,301,6,7,33024
2022-03-06,34182,9,3104,407,6,10,37718
2022-03-07,22872,16,6943,186,4,9,30030
2022-03-08,18487,17,7158,177,12,7,25858
2022-03-09,19117,11,8021,235,9,12,27405
2022-03-10,21870,15,7521,218,11,7,29642
2022-03-11,28429,16,6803,223,12,14,35497
2022-03-12,26914,14,4174,308,11,13,31434
2022-03-13,34176,12,2962,398,7,20,37575
2022-03-14,22959,15,6612,195,9,14,29804
2022-03-15,21919,14,6127,197,10,11,28278
2022-03-16,20397,16,7598,233,10,13,28267
2022-03-17,23777,12,7949,266,14,9,32027
2022-03-18,30352,14,7038,246,11,16,37677
2022-03-19,28054,12,3809,312,9,13,32209
2022-03-20,36311,11,2545,397,13,19,39296
2022-03-21,23147,15,6492,170,16,9,29849
2022-03-22,20055,18,7524,190,11,11,27809
2022-03-23,22845,13,7201,246,10,21,30336
2022-03-24,22843,13,7537,228,13,29,30663
2022-03-25,30801,12,6582,270,16,12,37693
2022-03-26,29825,9,4413,311,13,18,34589
2022-03-27,42537,14,2524,429,8,65,45577
2022-03-28,23581,15,6320,178,11,24,30129
2022-03-29,19576,18,7662,195,13,28,27492
2022-03-30,21000,13,6916,226,11,32,28198
2022-03-31,23136,18,7683,259,13,34,31143
2022-04-01,28345,17,6882,242,15,33,35534
2022-04-02,25590,10,4571,313,16,30,30530
2022-04-03,32730,11,2721,345,13,45,35865
2022-04-04,22036,15,6800,212,17,36,29116
2022-04-05,19439,17,7748,226,16,34,27480
2022-04-06,21207,18,8083,260,18,22,29608
2022-04-07,24556,15,7468,288,18,47,32392
2022-04-08,33194,13,7465,315,13,42,41042
2022-04-09,38229,10,4394,438,10,77,43158
2022-04-10,41095,10,2799,419,7,61,44391
2022-04-11,28028,14,6208,229,16,43,34538
2022-04-12,26521,17,7469,218,25,37,34287
2022-04-13,30583,17,7273,305,28,61,38267
2022-04-14,43671,12,7763,384,24,38,51892
2022-04-15,56621,20,5595,336,27,52,62651
2022-04-16,42661,9,3192,364,22,79,46327
2022-04-17,41225,10,1495,311,3,67,43111
2022-04-18,74118,9,1818,421,31,52,76449
2022-04-19,44375,15,6761,278,17,48,51494
2022-04-20,29987,16,7095,268,21,53,37440
2022-04-21,35761,18,7722,291,28,58,43878
2022-04-22,46295,15,6797,314,20,24,53465
2022-04-23,52466,12,4574,488,14,90,57644
2022-04-24,42820,12,2157,484,8,95,45576
2022-04-25,41907,17,6251,322,23,48,48568
2022-04-26,32380,18,6720,265,22,34,39439
2022-04-27,36723,11,5563,314,27,55,42693
2022-04-28,34833,16,7119,351,24,70,42413
2022-04-29,49824,16,6817,348,23,57,57085
2022-04-30,60748,10,4964,481,34,108,66345
2022-05-01,62931,11,2565,514,45,115,66181
2022-05-02,48563,12,3108,333,38,61,52115
2022-05-03,37165,13,6529,324,20,67,44118
2022-05-04,29612,16,6392,341,27,60,36448
2022-05-05,33667,20,7456,360,27,81,41611
2022-05-06,37873,18,6480,387,16,69,44843
2022-05-07,38225,10,4138,433,24,82,42912
2022-05-08,51345,14,2772,586,26,106,54849
2022-05-09,34444,18,7080,324,41,57,41964
2022-05-10,26874,22,7171,297,26,60,34450
2022-05-11,26817,13,7650,318,27,79,34904
2022-05-12,30286,17,6987,360,34,95,37779
2022-05-13,36563,19,7520,393,27,78,44600
2022-05-14,38515,13,4299,454,30,135,43446
2022-05-15,58110,14,2926,532,40,139,61761
2022-05-16,33491,18,7124,325,38,64,41060
2022-05-17,28101,19,7099,275,20,75,35589
2022-05-18,27741,17,7693,347,27,83,35908
2022-05-19,30481,15,7221,368,37,69,38191
2022-05-20,37815,14,6973,365,42,75,45284
2022-05-21,43578,15,4135,549,35,184,48496
2022-05-22,64808,13,2652,652,53,159,68337
2022-05-23,36895,16,6939,343,49,72,44314
2022-05-24,30701,14,7282,322,15,77,38411
2022-05-25,35981,15,6811,389,25,105,43326
2022-05-26,47817,17,7518,410,52,120,55934
2022-05-27,44308,15,6742,389,66,83,51603
2022-05-28,48726,13,4034,561,28,128,53490
2022-05-29,80054,13,2275,622,24,177,83165
2022-05-30,38219,17,5063,349,24,82,43754
2022-05-31,29868,16,6963,274,29,86,37236
2022-06-01,31553,17,7203,379,50,108,39310
2022-06-02,38376,17,7534,432,46,131,46536
2022-06-03,52458,13,6276,408,63,96,59314
2022-06-04,55191,14,3628,509,145,172,59659
2022-06-05,77927,15,2543,570,347,141,81543
2022-06-06,58581,19,5836,441,71,120,65068
2022-06-07,41215,16,7049,365,45,113,48803
2022-06-08,35470,17,7795,344,55,100,43781
2022-06-09,40064,17,6828,383,36,69,47397
2022-06-10,49443,16,6732,416,54,118,56779
2022-06-11,56222,11,4060,530,77,198,61098
2022-06-12,82442,11,2631,634,74,197,85989
2022-06-13,45971,16,7444,352,53,89,53925
2022-06-14,38666,17,7176,347,33,122,46361
2022-06-15,46793,21,7382,379,60,136,54771
2022-06-16,60073,17,4946,451,78,149,65714
2022-06-17,65846,24,6161,400,97,107,72635
2022-06-18,78043,12,4027,604,81,198,82965
2022-06-19,109546,14,2300,838,117,249,113064
2022-06-20,56017,15,6741,415,64,123,63375
2022-06-21,42825,17,7299,384,59,121,50705
2022-06-22,40603,14,5902,461,53,133,47166
2022-06-23,45683,17,6878,493,84,153,53308
2022-06-24,60214,18,7296,538,89,127,68282
2022-06-25,69289,12,4332,663,96,214,74606
2022-06-26,82884,11,2314,881,135,211,86436
2022-06-27,62262,18,7296,464,76,157,70273
2022-06-28,45171,17,6848,404,66,164,52670
2022-06-29,46083,17,7121,443,54,151,53869
2022-06-30,55487,19,7287,472,83,125,63473
2022-07-01,66807,14,6903,646,94,173,74637
2022-07-02,74098,15,4624,685,115,253,79790
2022-07-03,86792,16,2637,750,149,238,90582
2022-07-04,58389,16,6032,415,69,166,65087
2022-07-05,44850,18,6506,348,55,155,51932
2022-07-06,50841,17,6910,425,71,166,58430
2022-07-07,67301,18,6571,593,85,141,74709
2022-07-08,81190,18,6002,500,45,147,87902
2022-07-09,87201,13,3245,582,83,267,91391
2022-07-10,94887,11,2190,771,134,249,98242
2022-07-11,70954,20,6518,367,61,134,78054
2022-07-12,53485,18,7000,400,65,180,61148
2022-07-13,57622,15,6874,459,72,163,65205
2022-07-14,66361,14,7837,504,102,190,75008
2022-07-15,88861,16,6449,411,162,148,96047
2022-07-16,110601,12,4511,622,133,211,116090
2022-07-17,111738,10,2165,817,134,249,115113
2022-07-18,78131,17,6793,392,104,175,85612
2022-07-19,60288,19,6788,371,97,163,67726
2022-07-20,64552,12,6849,430,94,172,72109
2022-07-21,74563,17,6600,499,105,188,81972
2022-07-22,91453,12,6026,486,144,181,98302
2022-07-23,119435,11,3386,661,179,260,123932
2022-07-24,121322,10,2088,850,184,256,124710
2022-07-25,84309,15,6126,307,140,162,91059
2022-07-26,67494,15,7032,364,50,173,75128
2022-07-27,67721,15,6926,410,87,171,75330
2022-07-28,82525,17,6594,491,124,194,89945
2022-07-29,121411,17,6310,448,206,182,128574
2022-07-30,143222,12,3488,705,127,285,147839
2022-07-31,128034,11,2149,913,157,233,131497
2022-08-01,89998,16,5853,476,113,226,96682
2022-08-02,67701,14,6215,354,85,214,74583
2022-08-03,72288,15,6308,376,94,228,79309
2022-08-04,85761,20,6375,344,136,207,92843
2022-08-05,102948,19,4588,331,230,227,108343
2022-08-06,120114,13,3257,611,134,332,124461
2022-08-07,113088,12,1522,713,93,287,115715
2022-08-08,86564,16,6428,355,111,179,93653
2022-08-09,70272,16,6308,360,82,236,77274
2022-08-10,75167,13,6134,377,90,225,82006
2022-08-11,81557,19,6373,431,169,233,88782
2022-08-12,104487,22,6201,361,154,171,111396
2022-08-13,122639,8,3133,465,166,294,126705
2022-08-14,115255,12,1320,636,365,246,117834
2022-08-15,107644,10,1873,380,189,221,110317
2022-08-16,76016,15,6774,387,162,180,83534
2022-08-17,76321,9,5475,383,337,167,82692
2022-08-18,83379,18,5698,409,221,204,89929
2022-08-19,104881,18,5411,427,159,155,111051
2022-08-20,114365,15,3336,521,416,303,118956
2022-08-21,110700,16,1707,700,355,245,113723
2022-08-22,82304,18,5412,434,155,186,88509
2022-08-23,66732,19,6506,393,132,204,73986
2022-08-24,65857,16,6380,376,170,187,72986
2022-08-25,85088,15,6224,409,209,214,92159
2022-08-26,95863,19,5840,458,271,188,102639
2022-08-27,116364,17,3180,638,271,226,120696
2022-08-28,108695,14,1783,649,113,250,111504
2022-08-29,83179,14,5743,420,94,169,89619
2022-08-30,69482,14,6804,301,138,200,76939
2022-08-31,30180,14,6911,364,23,73,37565
2022-09-01,65242,20,6690,442,45,165,72604
2022-09-02,74003,15,6043,459,135,150,80805
2022-09-03,88628,14,3850,668,88,266,93514
2022-09-04,94631,12,2780,806,74,266,98569
2022-09-05,55044,16,6362,397,57,146,62022
2022-09-06,49737,18,6633,392,86,149,57015
2022-09-07,48434,17,6980,401,121,151,56104
2022-09-08,62510,14,6860,531,35,146,70096
2022-09-09,70226,16,6485,463,49,148,77387
2022-09-10,73811,12,4388,665,72,210,79158
2022-09-11,81283,14,1948,781,72,217,84315
2022-09-12,49865,16,6630,426,60,149,57146
2022-09-13,41852,16,6701,390,83,131,49173
2022-09-14,46745,19,6513,417,91,118,53903
2022-09-15,50446,14,6905,432,33,166,57996
2022-09-16,60177,15,5737,517,43,113,66602
2022-09-17,58663,10,4153,696,10,216,63748
2022-09-18,67384,16,2532,659,72,169,70832
2022-09-19,43474,17,7230,418,45,116,51300
2022-09-20,39717,13,6901,390,52,117,47190
2022-09-21,40674,11,7076,428,38,123,48350
2022-09-22,44744,13,6971,480,68,133,52409
2022-09-23,55734,15,6208,532,70,161,62720
2022-09-24,65022,10,4283,651,70,176,70212
2022-09-25,66519,14,2717,729,14,206,70199
2022-09-26,39650,17,6798,454,36,107,47062
2022-09-27,32267,14,6179,374,28,129,38991
2022-09-28,34083,13,7102,448,35,122,41803
2022-09-29,37576,16,6847,439,25,126,45029
2022-09-30,49056,18,6324,477,33,117,56025
2022-10-01,47824,5,4079,566,39,197,52710
2022-10-02,55690,9,2033,686,58,175,58651
2022-10-03,39446,14,6432,395,49,74,46410
2022-10-04,30209,17,6326,338,31,111,37032
2022-10-05,29443,14,7076,430,31,92,37086
2022-10-06,33164,12,7012,427,43,113,40771
2022-10-07,40093,13,6706,431,51,95,47389
2022-10-08,43929,6,4577,606,52,144,49314
2022-10-09,50140,10,2104,602,41,133,53030
2022-10-10,33778,14,6962,329,30,99,41212
2022-10-11,27795,19,7477,328,45,101,35765
2022-10-12,27882,18,6920,382,30,66,35298
2022-10-13,31243,15,7128,398,30,83,38897
2022-10-14,39782,15,6546,406,27,96,46872
2022-10-15,42333,19,4310,547,31,139,47379
2022-10-16,53339,12,2266,580,23,94,56314
2022-10-17,32996,17,6200,336,20,67,39636
2022-10-18,26545,14,7193,350,26,103,34231
2022-10-19,27220,15,8041,361,25,66,35728
2022-10-20,30180,14,6911,364,23,73,37565
2022-10-21,39172,17,6464,410,20,66,46149
2022-10-22,39299,11,3960,562,18,133,43983
2022-10-23,46513,12,2930,563,18,106,50142
2022-10-24,30183,16,7510,329,15,68,38121
2022-10-25,27236,17,7036,290,15,86,34680
2022-10-26,34820,17,7297,399,19,83,42635
2022-10-27,35594,14,7312,350,25,82,43377
2022-10-28,50648,15,6840,363,27,56,57949
2022-10-29,60413,8,4032,549,24,116,65142
2022-10-30,49000,10,2401,493,28,81,52013
2022-10-31,51729,13,3892,273,34,38,55979
2022-11-01,61307,12,2480,294,38,25,64156
2022-11-02,42745,15,6882,327,24,25,50018
2022-11-03,31754,18,6968,317,29,38,39124
2022-11-04,36366,15,6619,295,11,16,43322
