,Cestovni,Željeznički,Riječni,Pomorski,Zračni,UKUPNO
2013-01-01,32318,933,0,0,1342,34593
2013-01-02,50731,1221,0,0,1452,53404
2013-01-03,45107,751,0,37,1018,46913
2013-01-04,45104,567,0,19,1059,46749
2013-01-05,58254,600,0,41,881,59776
2013-01-06,44567,452,0,19,1133,46171
2013-01-07,39502,535,0,0,944,40981
2013-01-08,39168,481,0,59,791,40499
2013-01-09,41100,400,0,3,900,42403
2013-01-10,47209,393,0,38,1005,48645
2013-01-11,48917,342,0,3,1123,50385
2013-01-12,71882,466,0,54,1158,73560
2013-01-13,41454,418,0,0,1318,43190
2013-01-14,32155,361,0,0,780,33296
2013-01-15,34251,354,0,42,731,35378
2013-01-16,36878,384,0,0,943,38205
2013-01-17,33917,314,0,2,760,34993
2013-01-18,37589,335,0,2,960,38886
2013-01-19,46038,321,0,63,991,47413
2013-01-20,38056,403,0,0,785,39244
2013-01-21,38248,376,0,0,845,39469
2013-01-22,37155,373,0,33,706,38267
2013-01-23,37111,340,0,44,843,38338
2013-01-24,36817,350,0,10,671,37848
2013-01-25,41424,290,0,0,1157,42871
2013-01-26,43561,422,0,58,1153,45194
2013-01-27,38489,384,0,2,1020,39895
2013-01-28,36586,337,0,7,1124,38054
2013-01-29,34021,346,0,50,625,35042
2013-01-30,38809,337,0,10,863,40019
2013-01-31,42335,353,0,9,897,43594
2013-02-01,45613,404,0,1,1280,47298
2013-02-02,49706,344,0,50,753,50853
2013-02-03,43906,393,0,1000000,777,1045076
2013-02-04,40797,404,0,18,722,41941
2013-02-05,37738,440,0,45,596,38819
2013-02-06,35000,393,0,25,770,36188
2013-02-07,40475,320,0,12,852,41659
2013-02-08,42800,343,0,1,1167,44311
2013-02-09,49531,336,0,44,875,50786
2013-02-10,40098,430,0,8,908,41444
2013-02-11,42195,299,0,0,783,43277
2013-02-12,34058,372,0,36,607,35073
2013-02-13,32970,320,0,1,804,34095
2013-02-14,36194,388,0,3,811,37396
2013-02-15,42473,347,0,25,1047,43892
2013-02-16,51776,284,0,43,909,53012
2013-02-17,41410,312,0,0,1103,42825
2013-02-18,39702,302,0,9,815,40828
2013-02-19,40265,307,0,54,736,41362
2013-02-20,36964,344,0,40,874,38222
2013-02-21,39162,397,0,2,1013,40574
2013-02-22,39857,380,0,2,1207,41446
2013-02-23,42388,331,0,81,885,43685
2013-02-24,40661,378,0,0,1157,42196
2013-02-25,39592,336,0,0,1026,40954
2013-02-26,37603,335,0,56,736,38730
2013-02-27,39193,359,0,7,875,40434
2013-02-28,42393,291,0,4,1015,43703
2013-03-01,47275,327,0,0,1186,48788
2013-03-02,50424,355,0,52,1025,51856
2013-03-03,47499,405,0,8,1243,49155
2013-03-04,42958,312,0,15,955,44240
2013-03-05,40034,338,0,47,785,41204
2013-03-06,40804,297,0,14,957,42072
2013-03-07,43006,319,0,3,1104,44432
2013-03-08,48720,301,0,5,1337,50363
2013-03-09,55804,317,0,47,1113,57281
2013-03-10,44330,494,0,0,1223,46047
2013-03-11,43182,343,0,2,987,44514
2013-03-12,40936,292,0,47,723,41998
2013-03-13,41471,271,0,3,985,42730
2013-03-14,37551,283,0,33,1276,39143
2013-03-15,45092,259,0,11,1481,46843
2013-03-16,60457,283,0,89,1226,62055
2013-03-17,46848,380,0,2,1251,48481
2013-03-18,40948,327,0,3,1128,42406
2013-03-19,41550,321,0,42,229,42142
2013-03-20,42718,305,0,35,1101,44159
2013-03-21,47192,532,0,62,90,47876
2013-03-22,47487,561,0,11,1243,49302
2013-03-23,58429,304,0,127,1389,60249
2013-03-24,49075,360,0,0,1638,51073
2013-03-25,39593,322,0,0,1064,40979
2013-03-26,40646,294,0,126,985,42051
2013-03-27,51809,422,0,8,1736,53975
2013-03-28,55653,863,0,219,1603,58338
2013-03-29,60701,546,0,123,1511,62881
2013-03-30,51146,486,0,235,1114,52981
2013-03-31,35342,326,0,20,1286,36974
2013-04-01,66073,498,0,2,1930,68503
2013-04-02,47004,456,0,42,1187,48689
2013-04-03,40849,370,0,24,954,42197
2013-04-04,46175,348,0,76,1146,47745
2013-04-05,50238,353,0,49,1216,51856
2013-04-06,55495,426,0,171,1235,57327
2013-04-07,51002,406,0,69,1481,52958
2013-04-08,42307,357,0,2,1157,43823
2013-04-09,44065,361,0,42,1324,45792
2013-04-10,43831,408,0,36,1066,45341
2013-04-11,45109,339,0,64,1425,46937
2013-04-12,51088,477,0,37,304,51906
2013-04-13,59632,481,0,54,1273,61440
2013-04-14,51318,563,0,51,1426,53358
2013-04-15,46231,459,15,8,944,47657
2013-04-16,43191,339,0,37,1052,44619
2013-04-17,46536,363,2,48,1017,47966
2013-04-18,49483,366,0,77,1367,51293
2013-04-19,56751,410,1,55,1458,58675
2013-04-20,63292,317,0,99,1227,64935
2013-04-21,56482,385,0,78,1523,58468
2013-04-22,47872,415,0,9,1026,49322
2013-04-23,46802,387,0,143,1442,48774
2013-04-24,49410,356,0,21,1083,50870
2013-04-25,53888,563,0,64,1531,56046
2013-04-26,56275,539,0,53,1461,58328
2013-04-27,60960,536,0,57,1199,62752
2013-04-28,55705,352,0,27,1543,57627
2013-04-29,54133,394,0,4,1036,55567
2013-04-30,63127,432,0,59,1305,64923
2013-05-01,52328,411,0,72,1118,53929
2013-05-02,49037,367,0,46,815,50265
2013-05-03,53016,400,0,57,1004,54477
2013-05-04,60710,406,0,63,1277,62456
2013-05-05,57035,429,0,74,1614,59152
2013-05-06,53011,457,0,11,1078,54557
2013-05-07,51270,533,30,39,1032,52904
2013-05-08,48760,452,2,30,1068,50312
2013-05-09,54991,412,0,62,948,56413
2013-05-10,56618,413,0,45,1031,58107
2013-05-11,63726,411,0,106,1121,65364
2013-05-12,57021,405,0,50,1267,58743
2013-05-13,45911,465,0,4,1064,47444
2013-05-14,48744,372,0,55,1162,50333
2013-05-15,51552,340,0,96,1074,53062
2013-05-16,53294,367,0,81,1271,55013
2013-05-17,57677,438,0,59,1325,59499
2013-05-18,64495,432,0,98,1191,66216
2013-05-19,61341,575,0,37,1363,63316
2013-05-20,52557,555,0,23,1058,54193
2013-05-21,47260,546,0,60,928,48794
2013-05-22,53118,524,0,80,877,54599
2013-05-23,53262,494,0,58,1223,55037
2013-05-24,58864,483,0,66,1011,60424
2013-05-25,62293,419,0,92,1189,63993
2013-05-26,56217,497,0,119,1434,58267
2013-05-27,49415,439,0,5,1089,50948
2013-05-28,51690,464,0,70,1151,53375
2013-05-29,55768,408,0,71,1167,57414
2013-05-30,70026,280,0,66,1114,71486
2013-05-31,63271,464,0,87,1147,64969
2013-06-01,62980,437,0,149,1299,64865
2013-06-02,55614,648,0,49,1655,57966
2013-06-03,50825,475,0,19,1103,52422
2013-06-04,47918,535,0,71,946,49470
2013-06-05,51100,483,0,50,814,52447
2013-06-06,48285,499,0,62,304,49150
2013-06-07,56811,516,0,144,926,58397
2013-06-08,65945,426,0,86,1123,67580
2013-06-09,58781,535,2,35,1080,60433
2013-06-10,51643,508,0,12,848,53011
2013-06-11,49445,543,0,92,982,51062
2013-06-12,51130,452,0,76,946,52604
2013-06-13,57019,420,0,74,692,58205
2013-06-14,71502,512,0,68,922,73004
2013-06-15,68813,445,0,72,1022,70352
2013-06-16,58305,477,0,73,971,59826
2013-06-17,54982,475,0,23,590,56070
2013-06-18,52220,472,0,96,872,53660
2013-06-19,51185,483,0,141,660,52469
2013-06-20,55674,407,0,105,1240,57426
2013-06-21,64585,464,0,108,632,65789
2013-06-22,79618,447,0,129,1106,81300
2013-06-23,61647,487,0,132,630,62896
2013-06-24,65900,518,0,20,1186,67624
2013-06-25,72211,455,0,94,904,73664
2013-06-26,53648,465,0,101,1342,55556
2013-06-27,54832,431,0,59,820,56142
2013-06-28,60578,487,0,162,1067,62294
2013-06-29,68395,643,0,116,780,69934
2013-06-30,62512,874,0,130,1142,64658
2013-07-01,52752,757,0,30,1381,54920
2013-07-02,49314,371,0,90,1256,51031
2013-07-03,51564,265,0,94,1082,53005
2013-07-04,53701,245,0,118,875,54939
2013-07-05,60611,301,0,138,1131,62181
2013-07-06,72269,226,0,116,1037,73648
2013-07-07,61671,259,0,68,984,62982
2013-07-08,59525,408,0,42,883,60858
2013-07-09,53164,490,0,98,919,54671
2013-07-10,55655,326,0,121,891,56993
2013-07-11,58449,236,0,120,1117,59922
2013-07-12,64892,330,0,74,1072,66368
2013-07-13,67912,343,0,143,1207,69605
2013-07-14,65303,458,0,67,1239,67067
2013-07-15,60583,339,0,33,1245,62200
2013-07-16,53008,306,0,115,1325,54754
2013-07-17,55950,390,0,103,1073,57516
2013-07-18,61647,327,0,100,1042,63116
2013-07-19,64592,409,0,80,1173,66254
2013-07-20,67729,389,0,140,797,69055
2013-07-21,64831,565,0,147,967,66510
2013-07-22,62824,409,0,46,955,64234
2013-07-23,54235,241,0,91,615,55182
2013-07-24,53124,380,0,141,1013,54658
2013-07-25,60111,446,0,143,1138,61838
2013-07-26,67560,472,0,169,1240,69441
2013-07-27,63509,463,0,115,919,65006
2013-07-28,65337,413,0,158,849,66757
2013-07-29,64885,408,0,76,1020,66389
2013-07-30,60537,449,0,138,1002,62126
2013-07-31,55907,297,0,129,838,57171
2013-08-01,67010,383,0,123,911,68427
2013-08-02,67653,482,0,166,1200,69501
2013-08-03,73675,566,0,174,908,75323
2013-08-04,64781,347,0,165,751,66044
2013-08-05,78079,384,0,55,960,79478
2013-08-06,59358,441,0,171,1074,61044
2013-08-07,57044,412,0,192,837,58485
2013-08-08,61661,440,0,154,1029,63284
2013-08-09,63674,528,0,100,1032,65334
2013-08-10,76873,572,0,136,1204,78785
2013-08-11,63225,632,0,114,1009,64980
2013-08-12,60925,633,0,76,1079,62713
2013-08-13,61676,383,0,122,910,63091
2013-08-14,69059,587,0,92,1088,70826
2013-08-15,67320,435,0,124,2155,70034
2013-08-16,73232,451,0,112,798,74593
2013-08-17,78938,382,0,94,1126,80540
2013-08-18,79553,422,0,101,1156,81232
2013-08-19,61557,445,0,43,976,63021
2013-08-20,62823,331,0,75,868,64097
2013-08-21,61595,369,0,106,1206,63276
2013-08-22,61645,396,0,132,858,63031
2013-08-23,62619,363,0,111,1072,64165
2013-08-24,65182,413,0,86,979,66660
2013-08-25,58760,331,0,76,868,60035
2013-08-26,59396,296,0,40,1314,61046
2013-08-27,55331,522,0,97,1081,57031
2013-08-28,53144,372,0,68,1419,55003
2013-08-29,58490,353,0,94,1228,60165
2013-08-30,63278,468,0,140,1718,65604
2013-08-31,68165,458,0,165,1004,69792
2013-09-01,58248,335,0,75,1063,59721
2013-09-02,58492,340,0,40,1223,60095
2013-09-03,53860,384,1,99,876,55220
2013-09-04,51010,260,0,104,1153,52527
2013-09-05,57237,291,0,114,880,58522
2013-09-06,60246,380,0,101,1183,61910
2013-09-07,73373,399,0,130,1447,75349
2013-09-08,59580,419,0,55,1152,61206
2013-09-09,52546,483,0,33,814,53876
2013-09-10,51985,370,0,248,1056,53659
2013-09-11,55847,372,0,77,943,57239
2013-09-12,56091,288,0,90,1270,57739
2013-09-13,62960,390,0,55,903,64308
2013-09-14,72428,355,0,157,1489,74429
2013-09-15,64457,314,0,97,746,65614
2013-09-16,52290,204,0,21,1065,53580
2013-09-17,53509,293,0,60,809,54671
2013-09-18,51919,345,0,109,814,53187
2013-09-19,60017,257,0,77,1226,61577
2013-09-20,62066,213,0,98,1281,63658
2013-09-21,68695,324,0,143,1194,70356
2013-09-22,63185,397,0,63,1083,64728
2013-09-23,56532,384,0,39,992,57947
2013-09-24,45328,400,0,119,806,46653
2013-09-25,48344,275,0,164,890,49673
2013-09-26,58027,331,0,63,994,59415
2013-09-27,61852,297,0,136,862,63147
2013-09-28,61886,241,0,242,1193,63562
2013-09-29,58392,360,0,72,1051,59875
2013-09-30,50165,386,0,7,502,51060
2013-10-01,53942,297,0,39,1098,55376
2013-10-02,53979,216,0,109,254,54558
2013-10-03,56116,226,0,125,2003,58470
2013-10-04,60185,394,0,76,1090,61745
2013-10-05,67221,278,0,190,1073,68762
2013-10-06,57036,378,0,41,1185,58640
2013-10-07,57251,337,0,14,815,58417
2013-10-08,81948,437,0,43,1420,83848
2013-10-09,53067,297,0,65,1099,54528
2013-10-10,53685,318,0,45,933,54981
2013-10-11,66795,291,0,1102,1297,69485
2013-10-12,67633,356,0,275,957,69221
2013-10-13,59823,362,0,170,1410,61765
2013-10-14,52504,410,0,24,881,53819
2013-10-15,51441,368,0,134,945,52888
2013-10-16,53992,412,0,38,1179,55621
2013-10-17,57138,296,0,136,1484,59054
2013-10-18,58798,299,0,85,1188,60370
2013-10-19,63350,299,0,104,1259,65012
2013-10-20,57868,360,0,47,1073,59348
2013-10-21,52448,274,0,7,861,53590
2013-10-22,49902,216,0,91,920,51129
2013-10-23,47268,303,0,18,975,48564
2013-10-24,53139,259,0,65,984,54447
2013-10-25,62322,271,0,50,1141,63784
2013-10-26,62704,462,0,135,1009,64310
2013-10-27,56961,468,0,58,1299,58786
2013-10-28,50538,321,0,18,491,51368
2013-10-29,53744,254,0,27,717,54742
2013-10-30,60285,209,0,24,672,61190
2013-10-31,66887,242,0,153,1149,68431
2013-11-01,75778,399,0,57,1043,77277
2013-11-02,73375,326,0,64,717,74482
2013-11-03,70170,437,0,23,1157,71787
2013-11-04,51031,331,0,8,1106,52476
2013-11-05,48912,277,0,42,875,50106
2013-11-06,49231,258,0,9,946,50444
2013-11-07,51838,204,0,47,767,52856
2013-11-08,55474,279,0,16,1159,56928
2013-11-09,57707,313,0,76,678,58774
2013-11-10,51616,285,0,90,676,52667
2013-11-11,46841,213,0,0,894,47948
2013-11-12,47947,209,0,0,642,48798
2013-11-13,47599,284,0,0,837,48720
2013-11-14,51623,252,0,79,872,52826
2013-11-15,57783,232,0,0,759,58774
2013-11-16,59892,268,0,83,839,61082
2013-11-17,50052,277,0,50,842,51221
2013-11-18,47041,195,0,5,901,48142
2013-11-19,51103,254,0,24,780,52161
2013-11-20,45420,203,0,38,56,45717
2013-11-21,48865,226,0,0,256,49347
2013-11-22,57410,329,0,4,510,58253
2013-11-23,59482,248,0,93,801,60624
2013-11-24,51261,337,0,75,1012,52685
2013-11-25,47251,262,0,2,543,48058
2013-11-26,47592,254,0,0,802,48648
2013-11-27,42976,154,0,16,1150,44296
2013-11-28,48384,190,0,91,968,49633
2013-11-29,54919,318,0,19,886,56142
2013-11-30,57583,389,0,113,778,58863
2013-12-01,44109,257,0,2,901,45269
2013-12-02,45410,240,0,0,953,46603
2013-12-03,46752,292,0,38,792,47874
2013-12-04,42196,194,2916,19,924,46249
2013-12-05,49202,278,0,101,691,50272
2013-12-06,54000,234,0,32,667,54933
2013-12-07,55222,218,0,55,925,56420
2013-12-08,50436,332,0,13,821,51602
2013-12-09,46506,181,0,3,654,47344
2013-12-10,45509,271,0,98,834,46712
2013-12-11,49490,221,0,9,741,50461
2013-12-12,51238,242,0,44,774,52298
2013-12-13,51079,201,0,4,1275,52559
2013-12-14,67842,168,0,118,671,68799
2013-12-15,52817,323,0,4,1070,54214
2013-12-16,46450,222,0,8,976,47656
2013-12-17,47022,170,0,38,368,47598
2013-12-18,49066,234,0,41,1522,50863
2013-12-19,58096,335,0,25,828,59284
2013-12-20,61904,353,0,1,1900,64158
2013-12-21,78702,443,0,189,971,80305
2013-12-22,50954,514,0,2,1507,52977
2013-12-23,58861,508,0,4,1101,60474
2013-12-24,50669,274,0,68,630,51641
2013-12-25,31958,118,0,0,214,32290
2013-12-26,48266,226,0,0,423,48915
2013-12-27,54863,423,0,0,1409,56695
2013-12-28,54772,276,0,98,756,55902
2013-12-29,44880,309,0,3,907,46099
2013-12-30,61065,287,0,11,739,62102
2013-12-31,43033,356,0,25,477,43891
2014-01-01,35092,899,0,0,1140,37131
2014-01-02,52481,442,0,0,915,53838
2014-01-03,51370,525,0,179,889,52963
2014-01-04,53807,384,0,38,824,55053
2014-01-05,46397,403,0,45,1040,47885
2014-01-06,53953,363,0,0,832,55148
2014-01-07,42883,185,0,33,1010,44111
2014-01-08,47313,279,0,1,929,48522
2014-01-09,48278,234,0,32,871,49415
2014-01-10,55363,244,0,4,808,56419
2014-01-11,79169,335,0,87,983,80574
2014-01-12,55191,376,0,32,922,56521
2014-01-13,43130,233,0,5,740,44108
2014-01-14,46273,181,0,35,551,47040
2014-01-15,44790,254,0,10,680,45734
2014-01-16,49198,195,0,14,749,50156
2014-01-17,49350,287,0,0,867,50504
2014-01-18,57089,187,0,44,710,58030
2014-01-19,42963,270,0,0,766,43999
2014-01-20,44966,224,0,4,674,45868
2014-01-21,46635,181,0,46,770,47632
2014-01-22,45427,286,0,10,478,46201
2014-01-23,44845,201,0,8,1197,46251
2014-01-24,48281,241,0,0,754,49276
2014-01-25,43349,242,0,52,634,44277
2014-01-26,36982,214,0,34,1037,38267
2014-01-27,41298,301,0,17,907,42523
2014-01-28,37484,127,0,34,768,38413
2014-01-29,38519,168,0,32,947,39666
2014-01-30,41955,181,0,0,655,42791
2014-01-31,45933,216,0,1,1085,47235
2014-02-01,49055,194,0,0,748,49997
2014-02-02,43714,197,0,58,1054,45023
2014-02-03,42005,186,0,0,722,42913
2014-02-04,39385,135,0,47,789,40356
2014-02-05,43076,266,0,25,782,44149
2014-02-06,43126,146,0,42,744,44058
2014-02-07,49214,123,0,1,1014,50352
2014-02-08,50420,237,0,63,873,51593
2014-02-09,43024,302,0,2,938,44266
2014-02-10,44585,242,0,0,1125,45952
2014-02-11,44682,182,0,29,565,45458
2014-02-12,47224,181,0,48,684,48137
2014-02-13,49047,179,0,16,794,50036
2014-02-14,54916,216,0,0,1087,56219
2014-02-15,59796,244,0,97,742,60879
2014-02-16,50837,467,0,1,966,52271
2014-02-17,45078,262,0,3,613,45956
2014-02-18,45201,178,0,55,690,46124
2014-02-19,46994,279,0,0,876,48149
2014-02-20,49166,215,0,19,1157,50557
2014-02-21,57675,212,0,51,1029,58967
2014-02-22,59512,223,0,58,986,60779
2014-02-23,48832,189,0,0,999,50020
2014-02-24,46886,236,0,7,868,47997
2014-02-25,43611,243,0,48,787,44689
2014-02-26,44431,192,0,40,842,45505
2014-02-27,48227,291,0,15,837,49370
2014-02-28,56668,259,0,5,1362,58294
2014-03-01,61075,295,0,62,953,62385
2014-03-02,50497,274,0,0,1245,52016
2014-03-03,50211,258,0,16,863,51348
2014-03-04,43218,248,0,27,836,44329
2014-03-05,45006,219,0,10,704,45939
2014-03-06,53299,204,0,2,1253,54758
2014-03-07,56807,156,0,37,1045,58045
2014-03-08,62816,222,0,45,1221,64304
2014-03-09,54028,327,0,0,763,55118
2014-03-10,45035,215,0,3,1064,46317
2014-03-11,48129,267,0,42,716,49154
2014-03-12,47288,223,0,40,627,48178
2014-03-13,49456,376,0,12,78,49922
2014-03-14,56749,260,0,6,1565,58580
2014-03-15,63815,205,0,99,774,64893
2014-03-16,55785,284,0,2,770,56841
2014-03-17,49876,276,0,0,1016,51168
2014-03-18,48375,232,0,45,863,49515
2014-03-19,51707,172,0,15,909,52803
2014-03-20,51754,197,0,91,935,52977
2014-03-21,56968,207,0,0,972,58147
2014-03-22,61622,239,0,63,593,62517
2014-03-23,54079,290,0,0,852,55221
2014-03-24,49411,205,0,1,864,50481
2014-03-25,48571,244,0,108,786,49709
2014-03-26,50026,193,0,28,1063,51310
2014-03-27,48672,181,0,110,931,49894
2014-03-28,61150,191,0,5,1178,62524
2014-03-29,59683,238,0,110,1057,61088
2014-03-30,53947,382,0,0,1159,55488
2014-03-31,50486,235,0,9,768,51498
2014-04-01,49885,222,0,73,1444,51624
2014-04-02,47994,224,0,14,1468,49700
2014-04-03,50497,308,0,66,1167,52038
2014-04-04,53943,233,0,0,835,55011
2014-04-05,61268,187,1,71,911,62438
2014-04-06,55590,316,0,7,901,56814
2014-04-07,52648,220,0,3,886,53757
2014-04-08,49693,179,0,64,1409,51345
2014-04-09,54412,245,0,43,1311,56011
2014-04-10,53408,180,0,35,1061,54684
2014-04-11,61719,310,0,7,1277,63313
2014-04-12,75942,234,0,83,1138,77397
2014-04-13,63656,331,0,8,1065,65060
2014-04-14,53599,274,0,25,1579,55477
2014-04-15,61088,257,0,59,1251,62655
2014-04-16,68665,428,0,18,327,69438
2014-04-17,73769,325,0,261,1619,75974
2014-04-18,70764,332,0,107,1580,72783
2014-04-19,67423,401,0,207,1657,69688
2014-04-20,41429,258,0,72,737,42496
2014-04-21,72743,414,0,2,1832,74991
2014-04-22,58096,187,0,58,1749,60090
2014-04-23,57161,381,0,54,1395,58991
2014-04-24,61533,206,0,44,1788,63571
2014-04-25,66623,325,0,83,1356,68387
2014-04-26,94544,224,0,57,1531,96356
2014-04-27,75744,428,0,17,1324,77513
2014-04-28,62925,405,0,22,1286,64638
2014-04-29,60472,427,0,185,1350,62434
2014-04-30,70683,344,0,77,1028,72132
2014-05-01,55266,328,0,53,1048,56695
2014-05-02,61886,273,0,50,1838,64047
2014-05-03,68538,310,0,42,1314,70204
2014-05-04,73433,508,0,57,1706,75704
2014-05-05,54833,261,0,6,850,55950
2014-05-06,54438,228,0,49,1201,55916
2014-05-07,57382,228,0,113,1238,58961
2014-05-08,59364,315,0,44,300,60023
2014-05-09,64624,225,0,51,1056,65956
2014-05-10,68443,178,0,72,1622,70315
2014-05-11,59080,290,0,59,1050,60479
2014-05-12,53335,204,0,1,428,53968
2014-05-13,58645,336,0,53,1340,60374
2014-05-14,56846,384,0,23,871,58124
2014-05-15,55781,220,0,34,903,56938
2014-05-16,56701,316,0,92,1221,58330
2014-05-17,70747,244,0,76,671,71738
2014-05-18,50829,309,0,114,1251,52503
2014-05-19,51194,289,0,0,1189,52672
2014-05-20,46800,252,0,89,1482,48623
2014-05-21,50261,194,0,53,907,51415
2014-05-22,52297,319,0,63,1132,53811
2014-05-23,63841,244,0,108,1761,65954
2014-05-24,61523,262,0,81,1317,63183
2014-05-25,57609,200,0,7,1189,59005
2014-05-26,53418,261,0,3,1102,54784
2014-05-27,54883,195,0,32,1666,56776
2014-05-28,52368,207,0,61,1019,53655
2014-05-29,53709,277,0,67,974,55027
2014-05-30,63289,195,0,51,1300,64835
2014-05-31,66637,200,0,90,945,67872
2014-06-01,57956,298,0,13,1085,59352
2014-06-02,57778,301,0,46,1194,59319
2014-06-03,52762,219,0,35,462,53478
2014-06-04,54890,227,0,67,1102,56286
2014-06-05,56360,306,0,67,1074,57807
2014-06-06,76751,263,0,71,1245,78330
2014-06-07,68249,218,2,80,2018,70567
2014-06-08,62268,295,0,63,1267,63893
2014-06-09,54702,227,0,2,1174,56105
2014-06-10,54370,283,0,144,1135,55932
2014-06-11,53229,293,0,74,751,54347
2014-06-12,57951,324,0,101,1196,59572
2014-06-13,56404,220,0,54,1153,57831
2014-06-14,67614,359,0,79,1635,69687
2014-06-15,62770,386,0,26,1531,64713
2014-06-16,59976,358,0,12,1490,61836
2014-06-17,54271,430,0,87,1620,56408
2014-06-18,67535,256,0,88,1354,69233
2014-06-19,75486,225,0,98,871,76680
2014-06-20,65268,266,0,95,1171,66800
2014-06-21,67312,342,0,135,2348,70137
2014-06-22,72936,341,0,31,1580,74888
2014-06-23,59090,271,0,11,1220,60592
2014-06-24,61877,346,0,61,1488,63772
2014-06-25,68608,310,0,104,1037,70059
2014-06-26,68762,393,0,99,1179,70433
2014-06-27,64484,405,0,90,1191,66170
2014-06-28,71961,378,0,111,2099,74549
2014-06-29,67087,395,0,83,1145,68710
2014-06-30,61998,302,0,25,1223,63548
2014-07-01,59441,393,0,61,1313,61208
2014-07-02,57350,365,0,97,1215,59027
2014-07-03,63030,352,0,83,1285,64750
2014-07-04,67811,424,0,94,1230,69559
2014-07-05,77099,466,0,101,1401,79067
2014-07-06,72571,359,0,49,1735,74714
2014-07-07,66659,268,0,24,1536,68487
2014-07-08,68735,378,0,66,1339,70518
2014-07-09,63104,343,0,92,1889,65428
2014-07-10,68025,582,0,85,1334,70026
2014-07-11,68541,496,0,98,1882,71017
2014-07-12,80139,558,0,71,1396,82164
2014-07-13,66556,426,0,59,1064,68105
2014-07-14,65989,374,1,25,1311,67700
2014-07-15,67065,362,0,70,1316,68813
2014-07-16,70119,550,0,122,1598,72389
2014-07-17,71706,357,0,77,1785,73925
2014-07-18,74850,447,0,94,1539,76930
2014-07-19,82921,464,0,2276,1620,87281
2014-07-20,76650,530,0,71,1177,78428
2014-07-21,71367,420,0,25,1048,72860
2014-07-22,58981,619,0,2794,2196,64590
2014-07-23,63664,584,0,140,1497,65885
2014-07-24,69179,394,0,129,1277,70979
2014-07-25,75578,380,0,100,827,76885
2014-07-26,76106,410,0,105,1583,78204
2014-07-27,69416,614,0,79,1259,71368
2014-07-28,69496,379,0,29,1253,71157
2014-07-29,70429,433,0,79,1183,72124
2014-07-30,64582,380,0,106,1575,66643
2014-07-31,71461,495,0,82,1245,73283
2014-08-01,77340,407,0,143,1492,79382
2014-08-02,90902,442,0,102,1141,92587
2014-08-03,72370,497,0,74,1380,74321
2014-08-04,69918,401,0,27,1137,71483
2014-08-05,77752,453,0,121,1048,79374
2014-08-06,72276,338,0,151,939,73704
2014-08-07,62631,333,0,137,1044,64145
2014-08-08,71520,383,0,128,1203,73234
2014-08-09,77705,509,0,116,1017,79347
2014-08-10,77232,404,0,95,1034,78765
2014-08-11,71713,389,0,83,1194,73379
2014-08-12,62944,492,0,120,1109,64665
2014-08-13,65102,469,0,179,761,66511
2014-08-14,78330,376,0,130,1497,80333
2014-08-15,76697,398,0,138,1253,78486
2014-08-16,83129,518,0,58,1425,85130
2014-08-17,76522,474,0,91,1378,78465
2014-08-18,77192,347,0,52,803,78394
2014-08-19,63229,344,0,82,1042,64697
2014-08-20,61943,399,0,100,958,63400
2014-08-21,73799,438,0,89,944,75270
2014-08-22,68055,304,0,79,881,69319
2014-08-23,1427623,514,0,64,1056,1429257
2014-08-24,66914,476,0,79,964,68433
2014-08-25,66804,428,0,38,613,67883
2014-08-26,59236,227,0,81,1194,60738
2014-08-27,61531,418,4,105,1300,63358
2014-08-28,63544,418,0,65,1002,65029
2014-08-29,69020,396,0,88,1079,70583
2014-08-30,70284,511,0,77,1120,71992
2014-08-31,66997,572,0,21,1218,68808
2014-09-01,59839,384,0,44,1602,61869
2014-09-02,66146,455,0,55,1021,67677
2014-09-03,63670,285,0,116,803,64874
2014-09-04,61791,252,0,145,837,63025
2014-09-05,68373,303,0,105,1630,70411
2014-09-06,79439,321,0,202,1328,81290
2014-09-07,67944,313,0,27,1014,69298
2014-09-08,61491,272,0,9,1131,62903
2014-09-09,56315,220,0,284,1027,57846
2014-09-10,62404,431,0,127,926,63888
2014-09-11,65472,324,0,47,1058,66901
2014-09-12,63155,432,0,67,1063,64717
2014-09-13,70430,379,0,75,1297,72181
2014-09-14,67522,327,0,36,1353,69238
2014-09-15,61628,238,0,6,882,62754
2014-09-16,56996,293,0,68,1018,58375
2014-09-17,54065,270,0,75,862,55272
2014-09-18,62424,284,0,63,972,63743
2014-09-19,75612,273,0,73,1192,77150
2014-09-20,74210,382,0,116,1319,76027
2014-09-21,61176,310,0,30,1092,62608
2014-09-22,60762,263,0,41,1020,62086
2014-09-23,56370,273,0,44,986,57673
2014-09-24,61232,206,0,86,1389,62913
2014-09-25,58083,270,0,100,839,59292
2014-09-26,64440,302,0,210,1240,66192
2014-09-27,75355,330,0,217,1367,77269
2014-09-28,65266,442,0,35,1131,66874
2014-09-29,54910,268,0,5,1065,56248
2014-09-30,56851,287,0,34,1188,58360
2014-10-01,56957,404,0,120,1135,58616
2014-10-02,64623,208,0,174,1157,66162
2014-10-03,65590,294,0,45,1357,67286
2014-10-04,69263,252,0,305,1113,70933
2014-10-05,67401,251,0,54,777,68483
2014-10-06,59553,348,0,28,1126,61055
2014-10-07,53931,203,0,55,1246,55435
2014-10-08,80247,302,0,36,1021,81606
2014-10-09,59866,337,1,48,1276,61528
2014-10-10,68490,296,0,29,977,69792
2014-10-11,74645,264,0,255,1512,76676
2014-10-12,78854,347,0,65,1526,80792
2014-10-13,4504629,272,0,12,1053,4505966
2014-10-14,57648,241,0,89,1009,58987
2014-10-15,57200,223,0,18,1017,58458
2014-10-16,59069,205,0,47,894,60215
2014-10-17,66848,287,0,21,1126,68282
2014-10-18,74911,440,0,98,1047,76496
2014-10-19,65294,340,0,21,1644,67299
2014-10-20,57267,374,0,3,1178,58822
2014-10-21,56268,306,0,74,1042,57690
2014-10-22,54875,294,0,32,720,55921
2014-10-23,53462,223,0,32,1245,54962
2014-10-24,59790,206,0,37,1141,61174
2014-10-25,70055,289,0,151,1272,71767
2014-10-26,66288,489,0,23,1086,67886
2014-10-27,54656,236,1,1,971,55865
2014-10-28,54357,222,0,152,886,55617
2014-10-29,58995,197,1,23,551,59767
2014-10-30,61088,182,0,88,589,61947
2014-10-31,63281,324,0,31,1034,64670
2014-11-01,77170,195,0,87,759,78211
2014-11-02,78702,253,0,18,881,79854
2014-11-03,59092,261,0,22,727,60102
2014-11-04,52676,216,0,45,1001,53938
2014-11-05,52876,242,0,0,781,53899
2014-11-06,57619,180,0,0,813,58612
2014-11-07,63933,164,0,53,1037,65187
2014-11-08,65297,206,0,53,693,66249
2014-11-09,59308,262,0,24,941,60535
2014-11-10,55964,210,0,27,802,57003
2014-11-11,53829,215,0,30,642,54716
2014-11-12,53127,237,0,0,838,54202
2014-11-13,50104,272,0,9,698,51083
2014-11-14,60754,299,0,37,729,61819
2014-11-15,67746,199,0,78,990,69013
2014-11-16,58325,384,0,0,1277,59986
2014-11-17,54650,246,0,1,578,55475
2014-11-18,52396,214,0,83,1028,53721
2014-11-19,54687,218,0,37,674,55616
2014-11-20,55270,202,0,16,1041,56529
2014-11-21,61280,299,0,11,1563,63153
2014-11-22,65652,284,0,45,804,66785
2014-11-23,55668,263,0,6,1064,57001
2014-11-24,53233,198,0,18,598,54047
2014-11-25,50080,271,0,43,735,51129
2014-11-26,54905,162,0,13,676,55756
2014-11-27,55350,155,0,38,977,56520
2014-11-28,59743,285,0,25,743,60796
2014-11-29,62088,256,0,69,609,63022
2014-11-30,54573,228,0,15,787,55603
2014-12-01,50521,183,0,7,874,51585
2014-12-02,50102,226,0,41,607,50976
2014-12-03,52475,289,0,1,880,53645
2014-12-04,52594,293,0,0,968,53855
2014-12-05,58797,228,0,8,852,59885
2014-12-06,61162,299,0,52,933,62446
2014-12-07,53385,261,0,0,957,54603
2014-12-08,51608,188,0,0,890,52686
2014-12-09,50512,203,0,27,140,50882
2014-12-10,51808,200,0,30,94,52132
2014-12-11,53535,275,0,13,597,54420
2014-12-12,58754,228,0,19,868,59869
2014-12-13,77088,285,0,46,863,78282
2014-12-14,61777,527,0,5,1094,63403
2014-12-15,55950,296,0,11,964,57221
2014-12-16,54956,217,0,52,819,56044
2014-12-17,58648,323,0,9,712,59692
2014-12-18,62073,224,0,14,803,63114
2014-12-19,68536,321,0,2,1034,69893
2014-12-20,73697,425,0,108,827,75057
2014-12-21,65010,505,0,5,832,66352
2014-12-22,67510,337,0,5,949,68801
2014-12-23,70254,318,0,87,1064,71723
2014-12-24,56191,460,0,5,684,57340
2014-12-25,37306,112,0,0,149,37567
2014-12-26,55595,491,0,0,529,56615
2014-12-27,71214,331,0,4,711,72260
2014-12-28,35850,423,0,0,932,37205
2014-12-29,48522,556,0,28,528,49634
2014-12-30,60052,434,0,26,816,61328
2014-12-31,43055,312,0,0,533,43900
2015-01-01,32929,421,0,4,343,33697
2015-01-02,59666,755,0,2,845,61268
2015-01-03,56820,510,0,32,736,58098
2015-01-04,52793,441,0,0,1105,54339
2015-01-05,55098,386,0,0,685,56169
2015-01-06,57954,245,0,39,908,59146
2015-01-07,49498,251,0,1,714,50464
2015-01-08,56210,378,0,1,556,57145
2015-01-09,63678,281,0,0,712,64671
2015-01-10,93890,228,0,64,629,94811
2015-01-11,60753,166,0,2,916,61837
2015-01-12,51352,196,0,0,927,52475
2015-01-13,53480,179,0,76,871,54606
2015-01-14,49298,200,0,5,844,50347
2015-01-15,52596,248,0,10,468,53322
2015-01-16,51179,232,0,56,909,52376
2015-01-17,57941,214,0,56,463,58674
2015-01-18,47983,228,0,0,865,49076
2015-01-19,46493,171,0,1,776,47441
2015-01-20,44825,161,0,56,689,45731
2015-01-21,44713,132,0,16,714,45575
2015-01-22,48085,146,0,0,772,49003
2015-01-23,49595,215,0,0,1132,50942
2015-01-24,53451,162,0,41,972,54626
2015-01-25,40838,173,0,0,950,41961
2015-01-26,44798,172,0,2,935,45907
2015-01-27,45012,182,0,43,869,46106
2015-01-28,44863,254,0,18,638,45773
2015-01-29,44075,171,0,6,737,44989
2015-01-30,48127,169,0,0,891,49187
2015-01-31,52841,165,0,43,543,53592
2015-02-01,41401,193,0,0,688,42282
2015-02-02,45069,211,0,8,670,45958
2015-02-03,44872,163,0,28,852,45915
2015-02-04,42999,190,0,0,661,43850
2015-02-05,43183,206,0,1,687,44077
2015-02-06,35766,169,0,0,846,36781
2015-02-07,41811,128,0,41,662,42642
2015-02-08,40656,147,0,7,873,41683
2015-02-09,42665,168,0,0,828,43661
2015-02-10,42966,227,0,31,588,43812
2015-02-11,45614,139,0,39,724,46516
2015-02-12,51433,225,0,0,1040,52698
2015-02-13,56542,245,0,4,955,57746
2015-02-14,59492,220,0,95,564,60371
2015-02-15,54052,235,0,0,893,55180
2015-02-16,48307,153,0,7,600,49067
2015-02-17,48904,116,0,57,927,50004
2015-02-18,45806,202,0,8,819,46835
2015-02-19,50752,156,0,9,711,51628
2015-02-20,56837,297,0,22,934,58090
2015-02-21,58371,167,0,77,602,59217
2015-02-22,49341,190,0,0,824,50355
2015-02-23,48507,192,0,13,1000,49712
2015-02-24,46097,139,3,50,1172,47461
2015-02-25,49129,294,1,21,749,50194
2015-02-26,48268,201,0,17,878,49364
2015-02-27,55017,182,0,6,1018,56223
2015-02-28,58691,263,0,58,1203,60215
2015-03-01,52202,293,0,2,996,53493
2015-03-02,48311,239,0,14,1031,49595
2015-03-03,46892,93,0,55,740,47780
2015-03-04,48952,185,0,14,1320,50471
2015-03-05,46097,225,0,0,737,47059
2015-03-06,50979,152,0,0,723,51854
2015-03-07,60817,219,0,0,866,61902
2015-03-08,54336,862,0,0,1336,56534
2015-03-09,50758,150,0,2,738,51648
2015-03-10,49917,127,0,51,1136,51231
2015-03-11,50059,108,0,43,768,50978
2015-03-12,54052,184,0,1,1288,55525
2015-03-13,57561,146,0,43,1116,58866
2015-03-14,68362,150,0,76,730,69318
2015-03-15,57641,225,0,10,1046,58922
2015-03-16,51264,153,0,2,1078,52497
2015-03-17,50651,114,0,53,688,51506
2015-03-18,50670,93,0,5,868,51636
2015-03-19,58100,259,0,40,772,59171
2015-03-20,59407,214,0,15,787,60423
2015-03-21,64477,318,0,38,519,65352
2015-03-22,53884,193,0,0,963,55040
2015-03-23,53084,195,0,12,796,54087
2015-03-24,50778,227,0,91,850,51946
2015-03-25,52626,183,0,11,1327,54147
2015-03-26,56198,170,0,36,1327,57731
2015-03-27,61032,200,0,32,812,62076
2015-03-28,70508,227,0,67,858,71660
2015-03-29,59350,212,0,28,1155,60745
2015-03-30,59456,347,0,17,894,60714
2015-03-31,57979,252,0,45,1692,59968
2015-04-01,66025,216,0,64,1630,67935
2015-04-02,73294,340,0,250,1942,75826
2015-04-03,101136,375,0,214,2112,103837
2015-04-04,76108,321,0,47,883,77359
2015-04-05,51207,198,0,20,1801,53226
2015-04-06,91605,400,0,1,1469,93475
2015-04-07,64902,219,0,69,1500,66690
2015-04-08,57700,188,0,36,1072,58996
2015-04-09,54262,256,0,50,1457,56025
2015-04-10,66543,231,0,18,1073,67865
2015-04-11,65492,245,0,47,1562,67346
2015-04-12,56649,282,0,21,971,57923
2015-04-13,52227,328,0,8,1502,54065
2015-04-14,55433,193,0,54,965,56645
2015-04-15,54635,216,0,44,1483,56378
2015-04-16,58602,180,0,89,1873,60744
2015-04-17,63562,192,0,25,1323,65102
2015-04-18,69295,183,0,78,1248,70804
2015-04-19,64346,223,0,30,2061,66660
2015-04-20,57489,243,0,19,1444,59195
2015-04-21,53819,202,0,40,1661,55722
2015-04-22,56778,217,0,21,1295,58311
2015-04-23,61232,153,0,34,2042,63461
2015-04-24,68228,244,0,132,911,69515
2015-04-25,75703,256,0,104,1224,77287
2015-04-26,66582,356,0,22,1366,68326
2015-04-27,53099,269,0,4,1548,54920
2015-04-28,59428,209,0,20,1287,60944
2015-04-29,61196,310,0,39,1094,62639
2015-04-30,79367,329,0,65,1029,80790
2015-05-01,58082,206,0,126,1979,60393
2015-05-02,71571,360,0,34,1261,73226
2015-05-03,83079,515,0,55,1681,85330
2015-05-04,60165,267,0,7,1603,62042
2015-05-05,55537,186,0,41,1620,57384
2015-05-06,62169,230,0,44,1329,63772
2015-05-07,62996,294,0,44,570,63904
2015-05-08,65202,271,0,76,1214,66763
2015-05-09,71296,215,0,103,1876,73490
2015-05-10,64506,269,0,38,1255,66068
2015-05-11,61565,199,0,28,1282,63074
2015-05-12,57669,180,0,32,1332,59213
2015-05-13,64798,269,0,53,1904,67024
2015-05-14,67076,174,0,48,1248,68546
2015-05-15,71152,236,0,60,1106,72554
2015-05-16,89400,277,0,72,1310,91059
2015-05-17,62347,230,0,52,2241,64870
2015-05-18,58207,196,0,23,1403,59829
2015-05-19,57270,183,0,106,1778,59337
2015-05-20,56488,151,0,34,1527,58200
2015-05-21,57440,180,0,41,2281,59942
2015-05-22,72083,208,0,34,1210,73535
2015-05-23,72232,204,0,57,946,73439
2015-05-24,62969,302,0,26,1364,64661
2015-05-25,63751,134,0,19,1082,64986
2015-05-26,57146,126,0,35,1515,58822
2015-05-27,58442,106,0,56,1011,59615
2015-05-28,60300,172,0,76,1362,61910
2015-05-29,65584,216,0,100,1239,67139
2015-05-30,67333,164,0,95,1251,68843
2015-05-31,65602,182,0,55,1190,67029
2015-06-01,66377,375,0,31,1347,68130
2015-06-02,59861,89,0,75,1162,61187
2015-06-03,70509,175,0,94,1205,71983
2015-06-04,85655,272,0,75,1116,87118
2015-06-05,74451,202,0,76,1145,75874
2015-06-06,85724,101,0,59,1478,87362
2015-06-07,77914,304,0,107,1084,79409
2015-06-08,68190,241,0,18,1252,69701
2015-06-09,66717,190,2,74,1454,68437
2015-06-10,68404,129,0,59,2047,70639
2015-06-11,71672,169,0,60,1280,73181
2015-06-12,80935,306,0,63,1224,82528
2015-06-13,92238,320,0,61,1244,93863
2015-06-14,74689,146,0,100,1955,76890
2015-06-15,72407,81,0,35,1015,73538
2015-06-16,70456,128,0,34,1175,71793
2015-06-17,73343,92,0,40,1311,74786
2015-06-18,67994,231,0,52,1496,69773
2015-06-19,81097,118,0,69,1037,82321
2015-06-20,82163,128,0,65,1464,83820
2015-06-21,71808,236,0,74,1396,73514
2015-06-22,89170,263,1,69,1783,91286
2015-06-23,67858,296,0,134,919,69207
2015-06-24,83681,293,0,76,1204,85254
2015-06-25,88927,392,0,129,1751,91199
2015-06-26,78219,276,0,159,2487,81141
2015-06-27,84286,228,0,134,1521,86169
2015-06-28,86945,320,0,174,1870,89309
2015-06-29,73947,305,0,42,1280,75574
2015-06-30,70328,370,0,39,1551,72288
2015-07-01,76318,306,0,90,1404,78118
2015-07-02,73051,273,0,88,1544,74956
2015-07-03,81934,298,0,82,1442,83756
2015-07-04,81430,324,0,76,1488,83318
2015-07-05,77655,298,0,65,1417,79435
2015-07-06,76346,353,0,44,1686,78429
2015-07-07,73226,265,0,42,1675,75208
2015-07-08,69976,279,0,64,1700,72019
2015-07-09,80585,175,0,37,1961,82758
2015-07-10,95002,200,0,74,1339,96615
2015-07-11,88541,246,0,112,671,89570
2015-07-12,80705,253,0,64,3010,84032
2015-07-13,76715,308,0,58,1466,78547
2015-07-14,81862,319,0,80,1373,83634
2015-07-15,83230,350,0,65,1225,84870
2015-07-16,86113,329,0,71,1435,87948
2015-07-17,89111,249,0,74,2262,91696
2015-07-18,96070,280,0,97,1170,97617
2015-07-19,89273,282,0,80,1336,90971
2015-07-20,74537,242,0,35,1332,76146
2015-07-21,83307,263,0,68,1161,84799
2015-07-22,76938,261,0,84,1247,78530
2015-07-23,73656,263,0,54,1525,75498
2015-07-24,81984,113,0,76,1714,83887
2015-07-25,102313,259,1,101,1204,103878
2015-07-26,88310,351,0,66,1160,89887
2015-07-27,79832,302,0,48,1464,81646
2015-07-28,70980,360,0,74,1077,72491
2015-07-29,73569,298,1,125,1414,75407
2015-07-30,86791,326,0,109,1470,88696
2015-07-31,91370,295,0,94,2255,94014
2015-08-01,103912,315,0,127,1174,105528
2015-08-02,93639,275,0,91,1089,95094
2015-08-03,86466,368,0,79,1402,88315
2015-08-04,84103,346,0,100,1756,86305
2015-08-05,87922,326,0,119,1087,89454
2015-08-06,81496,262,0,89,992,82839
2015-08-07,98648,375,0,134,1585,100742
2015-08-08,116159,244,0,111,1772,118286
2015-08-09,81108,432,0,69,1897,83506
2015-08-10,91668,280,0,46,1139,93133
2015-08-11,83019,423,0,96,1436,84974
2015-08-12,83921,399,0,57,1671,86048
2015-08-13,84607,436,0,89,1779,86911
2015-08-14,89192,278,0,80,1187,90737
2015-08-15,109362,390,1,91,1467,111311
2015-08-16,99505,382,0,45,1465,101397
2015-08-17,83548,558,0,45,1914,86065
2015-08-18,85746,369,0,69,1234,87418
2015-08-19,79397,212,0,59,1436,81104
2015-08-20,77978,241,0,65,1393,79677
2015-08-21,84334,424,0,122,1298,86178
2015-08-22,91502,264,0,72,1323,93161
2015-08-23,85008,274,0,37,663,85982
2015-08-24,74414,288,1,24,1740,76467
2015-08-25,68418,233,0,56,1346,70053
2015-08-26,78593,245,0,140,972,79950
2015-08-27,76790,224,0,76,1506,78596
2015-08-28,76913,282,0,85,1306,78586
2015-08-29,86148,296,0,102,1676,88222
2015-08-30,85626,282,0,47,1088,87043
2015-08-31,77162,249,0,54,1038,78503
2015-09-01,66690,270,0,51,1691,68702
2015-09-02,65716,273,12,77,2247,68325
2015-09-03,71113,248,53,149,1226,72789
2015-09-04,72570,274,0,57,1002,73903
2015-09-05,75444,288,0,47,1557,77336
2015-09-06,71057,320,0,102,1442,72921
2015-09-07,66851,267,0,8,1244,68370
2015-09-08,64641,283,0,50,1188,66162
2015-09-09,66871,430,0,98,1297,68696
2015-09-10,67209,327,0,77,1476,69089
2015-09-11,73139,284,0,62,1208,74693
2015-09-12,77678,250,0,77,1387,79392
2015-09-13,72282,274,0,80,1104,73740
2015-09-14,61135,269,0,87,1533,63024
2015-09-15,67530,207,0,128,1079,68944
2015-09-16,61723,169,0,51,1354,63297
2015-09-17,62746,170,0,63,1061,64040
2015-09-18,63966,23,0,85,1799,65873
2015-09-19,71884,9,0,99,1061,73053
2015-09-20,62875,37,0,51,1393,64356
2015-09-21,58841,16,0,54,1205,60116
2015-09-22,53856,12,0,34,1159,55061
2015-09-23,59295,10,0,86,1291,60682
2015-09-24,60637,6,0,27,1143,61813
2015-09-25,64548,24,0,82,1509,66163
2015-09-26,70609,15,0,137,1308,72069
2015-09-27,65280,36,0,71,1020,66407
2015-09-28,58641,22,0,15,1035,59713
2015-09-29,57177,17,0,29,1306,58529
2015-09-30,59472,16,0,63,1488,61039
2015-10-01,62844,20,0,50,767,63681
2015-10-02,65973,5,0,46,1082,67106
2015-10-03,67527,6,0,135,1223,68891
2015-10-04,62332,63,0,151,1043,63589
2015-10-05,59451,120,0,19,1448,61038
2015-10-06,50857,67,0,42,799,51765
2015-10-07,59762,100,0,55,1570,61487
2015-10-08,82161,109,0,113,1116,83499
2015-10-09,69231,96,0,69,1448,70844
2015-10-10,71987,81,0,85,1066,73219
2015-10-11,69500,172,0,189,1198,71059
2015-10-12,59757,131,0,41,969,60898
2015-10-13,53612,144,0,33,1302,55091
2015-10-14,53480,98,0,32,1191,54801
2015-10-15,60209,211,0,40,1198,61658
2015-10-16,63476,59,0,48,1494,65077
2015-10-17,69857,23,0,77,1367,71324
2015-10-18,58792,44,0,59,1518,60413
2015-10-19,54442,20,0,41,1374,55877
2015-10-20,54714,33,0,104,1083,55934
2015-10-21,55547,21,0,50,919,56537
2015-10-22,61835,15,0,35,1293,63178
2015-10-23,63397,24,0,58,1203,64682
2015-10-24,68737,21,0,61,1107,69926
2015-10-25,63017,366,0,86,868,64337
2015-10-26,53854,38,0,1,775,54668
2015-10-27,53617,29,0,97,1000,54743
2015-10-28,57529,32,0,14,922,58497
2015-10-29,60960,24,0,83,968,62035
2015-10-30,67366,39,0,14,1013,68432
2015-10-31,79504,62,0,92,1244,80902
2015-11-01,84095,124,0,5,807,85031
2015-11-02,63670,106,0,20,1021,64817
2015-11-03,57809,133,0,28,879,58849
2015-11-04,54647,107,0,32,794,55580
2015-11-05,56860,117,0,34,960,57971
2015-11-06,64973,78,1,18,1075,66145
2015-11-07,67024,82,0,51,887,68044
2015-11-08,62746,99,0,19,1097,63961
2015-11-09,51061,108,0,2,955,52126
2015-11-10,55747,76,0,23,777,56623
2015-11-11,56804,75,0,24,649,57552
2015-11-12,54635,79,0,7,796,55517
2015-11-13,58764,82,0,25,982,59853
2015-11-14,62610,80,0,141,812,63643
2015-11-15,63312,159,0,14,736,64221
2015-11-16,52387,77,0,2,775,53241
2015-11-17,57450,96,0,37,804,58387
2015-11-18,54596,83,0,40,704,55423
2015-11-19,59181,86,0,23,822,60112
2015-11-20,61657,81,0,51,1009,62798
2015-11-21,60422,48,0,83,372,60925
2015-11-22,52373,118,0,68,1370,53929
2015-11-23,52574,144,0,7,982,53707
2015-11-24,46605,127,0,32,909,47673
2015-11-25,48980,101,0,18,1337,50436
2015-11-26,51928,75,0,32,1200,53235
2015-11-27,55713,145,0,5,1527,57390
2015-11-28,55425,82,0,48,1051,56606
2015-11-29,50330,104,0,10,1378,51822
2015-11-30,46875,93,0,4,854,47826
2015-12-01,48977,74,0,40,916,50007
2015-12-02,50546,150,0,2,1223,51921
2015-12-03,50900,122,4,12,1323,52361
2015-12-04,57192,71,0,0,1180,58443
2015-12-05,63400,165,0,39,1022,64626
2015-12-06,54020,118,0,2,1503,55643
2015-12-07,46700,117,0,2,1252,48071
2015-12-08,47377,62,0,24,901,48364
2015-12-09,45403,79,0,2,1019,46503
2015-12-10,49468,84,0,1,1292,50845
2015-12-11,54979,65,0,0,1407,56451
2015-12-12,67922,99,0,57,1213,69291
2015-12-13,57447,113,0,0,1515,59075
2015-12-14,48682,171,0,1,1200,50054
2015-12-15,54835,120,0,50,1280,56285
2015-12-16,59441,128,0,3,1134,60706
2015-12-17,59634,74,0,0,1733,61441
2015-12-18,69859,200,0,12,1851,71922
2015-12-19,87420,167,0,88,1449,89124
2015-12-20,66585,202,0,0,1714,68501
2015-12-21,67919,154,0,2,914,68989
2015-12-22,69661,111,4,79,1775,71630
2015-12-23,74780,195,0,6,1559,76540
2015-12-24,61179,144,0,2,1446,62771
2015-12-25,45322,170,0,0,219,45711
2015-12-26,59459,272,0,1,984,60716
2015-12-27,62499,259,0,3,969,63730
2015-12-28,60637,159,0,29,571,61396
2015-12-29,62428,273,0,35,739,63475
2015-12-30,76122,273,0,2,1056,77453
2015-12-31,51325,223,12,19,659,52238
2016-01-01,35977,194,0,2,308,36481
2016-01-02,71563,682,0,0,1199,73444
2016-01-03,47062,371,0,0,2056,49489
2016-01-04,43818,318,0,2,1079,45217
2016-01-05,48309,190,0,69,1033,49601
2016-01-06,45801,191,0,0,1277,47269
2016-01-07,49639,149,0,0,992,50780
2016-01-08,56353,198,0,4,1375,57930
2016-01-09,72463,239,0,61,1049,73812
2016-01-10,61234,242,0,0,1520,62996
2016-01-11,55855,173,0,0,1233,57261
2016-01-12,49953,139,0,42,1011,51145
2016-01-13,51999,208,0,0,826,53033
2016-01-14,50590,124,0,0,925,51639
2016-01-15,58232,157,0,0,1513,59902
2016-01-16,60636,186,0,51,818,61691
2016-01-17,44436,183,0,0,1117,45736
2016-01-18,40860,110,0,3,586,41559
2016-01-19,43231,172,0,68,830,44301
2016-01-20,42797,139,0,2,1045,43983
2016-01-21,48907,147,0,1,918,49973
2016-01-22,49013,150,0,1,1327,50491
2016-01-23,54681,130,0,40,968,55819
2016-01-24,43538,158,0,1,1316,45013
2016-01-25,44291,130,0,4,763,45188
2016-01-26,38668,169,0,56,781,39674
2016-01-27,43289,108,1,1,1236,44635
2016-01-28,46175,115,0,28,1207,47525
2016-01-29,51736,155,0,10,1541,53442
2016-01-30,53437,138,0,48,913,54536
2016-01-31,45264,120,0,3,1525,46912
2016-02-01,43882,122,0,3,1135,45142
2016-02-02,44603,155,0,26,930,45714
2016-02-03,42705,108,0,7,823,43643
2016-02-04,47103,138,0,17,1305,48563
2016-02-05,50939,108,0,32,1295,52374
2016-02-06,58574,126,0,54,959,59713
2016-02-07,50360,134,0,2,1145,51641
2016-02-08,44954,70,0,0,894,45918
2016-02-09,43120,133,0,20,850,44123
2016-02-10,45929,159,0,0,938,47026
2016-02-11,52238,91,0,4,1018,53351
2016-02-12,53260,197,0,3,1488,54948
2016-02-13,56576,109,0,66,899,57650
2016-02-14,49138,137,0,0,1547,50822
2016-02-15,49897,119,0,0,1125,51141
2016-02-16,47039,185,0,32,1048,48304
2016-02-17,45695,160,0,2,1273,47130
2016-02-18,50682,136,0,13,1191,52022
2016-02-19,56662,127,0,3,1473,58265
2016-02-20,59276,177,0,45,1105,60603
2016-02-21,51516,193,0,0,1430,53139
2016-02-22,47317,138,0,3,707,48165
2016-02-23,48339,136,0,32,983,49490
2016-02-24,48173,116,0,2,1149,49440
2016-02-25,46905,128,0,9,1077,48119
2016-02-26,55436,150,0,3,1484,57073
2016-02-27,58634,100,0,55,1071,59860
2016-02-28,50717,155,0,0,1483,52355
2016-02-29,46752,190,0,1,1192,48135
2016-03-01,48306,131,0,87,1554,50078
2016-03-02,49360,146,0,3,1162,50671
2016-03-03,48884,112,0,1,990,49987
2016-03-04,50192,90,0,2,1031,51315
2016-03-05,64342,89,0,44,733,65208
2016-03-06,52564,557,0,0,1144,54265
2016-03-07,50351,142,0,8,1048,51549
2016-03-08,47294,162,0,47,961,48464
2016-03-09,50815,117,0,5,972,51909
2016-03-10,58897,152,0,1,1306,60356
2016-03-11,61596,150,0,5,1157,62908
2016-03-12,63127,103,0,46,981,64257
2016-03-13,53192,111,0,0,1282,54585
2016-03-14,51837,110,0,2,1252,53201
2016-03-15,53502,113,0,55,1133,54803
2016-03-16,50812,101,0,5,1571,52489
2016-03-17,56636,122,0,4,1418,58180
2016-03-18,61377,145,0,11,1164,62697
2016-03-19,69380,154,0,72,1399,71005
2016-03-20,58623,138,0,11,1430,60202
2016-03-21,56482,181,0,3,984,57650
2016-03-22,59080,187,0,75,1338,60680
2016-03-23,65871,160,0,1,1826,67858
2016-03-24,69686,218,0,255,2031,72190
2016-03-25,77142,249,0,17,1808,79216
2016-03-26,67641,211,0,69,1461,69382
2016-03-27,49551,183,0,2,1526,51262
2016-03-28,76248,216,0,1,1460,77925
2016-03-29,53753,171,0,48,1354,55326
2016-03-30,53444,150,0,22,1069,54685
2016-03-31,54388,206,0,41,1140,55775
2016-04-01,64264,175,0,27,1214,65680
2016-04-02,59216,120,0,61,1540,60937
2016-04-03,57545,165,0,38,1363,59111
2016-04-04,50334,145,0,6,1383,51868
2016-04-05,54453,123,0,50,1360,55986
2016-04-06,46003,144,0,60,1269,47476
2016-04-07,53837,180,0,52,1557,55626
2016-04-08,57787,284,0,10,2040,60121
2016-04-09,66401,113,0,104,1724,68342
2016-04-10,52322,150,0,34,1341,53847
2016-04-11,54619,195,0,4,1346,56164
2016-04-12,51825,178,0,37,1197,53237
2016-04-13,52008,141,0,27,1640,53816
2016-04-14,56439,138,0,32,1547,58156
2016-04-15,64508,213,0,45,1743,66509
2016-04-16,66018,144,0,50,1410,67622
2016-04-17,63058,210,0,23,1453,64744
2016-04-18,53291,198,0,2,1346,54837
2016-04-19,5557,0,0,4,0,5561
2016-04-20,41735,130,0,42,171,42078
2016-04-21,47274,121,0,65,1375,48835
2016-04-22,62762,169,0,70,1727,64728
2016-04-23,60924,122,0,122,592,61760
2016-04-24,57692,206,0,16,1629,59543
2016-04-25,56791,194,0,11,1665,58661
2016-04-26,54336,183,0,22,1207,55748
2016-04-27,55274,110,0,18,1271,56673
2016-04-28,58046,183,0,31,1752,60012
2016-04-29,64847,198,0,49,1932,67026
2016-04-30,66216,171,0,89,1092,67568
2016-05-01,55232,185,0,11,2041,57469
2016-05-02,52050,165,0,3,1420,53638
2016-05-03,55187,150,0,63,1110,56510
2016-05-04,57868,181,0,21,1279,59349
2016-05-05,64569,176,0,40,1253,66038
2016-05-06,62992,228,0,111,1681,65012
2016-05-07,64242,133,0,56,1182,65613
2016-05-08,58710,176,0,21,1454,60361
2016-05-09,55523,181,0,3,1190,56897
2016-05-10,56803,187,0,40,1270,58300
2016-05-11,55893,178,0,63,1556,57690
2016-05-12,60898,184,0,54,1093,62229
2016-05-13,65856,164,0,66,1277,67363
2016-05-14,85897,140,0,47,1185,87269
2016-05-15,68806,192,0,38,1181,70217
2016-05-16,63504,184,0,1,939,64628
2016-05-17,57518,179,0,43,1109,58849
2016-05-18,61431,180,0,64,1235,62910
2016-05-19,64356,149,0,42,1393,65940
2016-05-20,70801,171,0,35,1698,72705
2016-05-21,68862,164,0,84,1245,70355
2016-05-22,65316,223,0,30,1305,66874
2016-05-23,61840,141,0,6,1415,63402
2016-05-24,58874,130,0,105,1310,60419
2016-05-25,66907,166,0,29,1558,68660
2016-05-26,75693,164,0,85,1183,77125
2016-05-27,66522,240,0,76,457,67295
2016-05-28,73129,184,0,94,1530,74937
2016-05-29,73439,243,0,183,1211,75076
2016-05-30,61376,186,0,3,1215,62780
2016-05-31,56998,209,2,84,1318,58611
2016-06-01,69890,294,0,42,1114,71340
2016-06-02,69991,149,0,83,1101,71324
2016-06-03,78432,184,0,34,1310,79960
2016-06-04,84337,150,0,27,1073,85587
2016-06-05,68304,163,0,32,1198,69697
2016-06-06,63323,220,0,11,1157,64711
2016-06-07,65916,179,0,44,655,66794
2016-06-08,67894,200,0,68,1143,69305
2016-06-09,72525,154,0,51,1071,73801
2016-06-10,78961,190,0,31,1317,80499
2016-06-11,82804,236,0,59,956,84055
2016-06-12,66220,219,0,40,1520,67999
2016-06-13,73163,191,0,9,733,74096
2016-06-14,64135,284,0,45,1258,65722
2016-06-15,73613,169,0,94,1239,75115
2016-06-16,76496,215,0,45,1577,78333
2016-06-17,75127,175,0,65,720,76087
2016-06-18,81627,199,0,124,1256,83206
2016-06-19,76536,257,0,111,1123,78027
2016-06-20,76259,249,0,23,1050,77581
2016-06-21,66796,199,0,153,1292,68440
2016-06-22,82321,231,0,76,1132,83760
2016-06-23,77233,199,0,74,1010,78516
2016-06-24,87836,217,0,114,1236,89403
2016-06-25,86922,232,0,129,1974,89257
2016-06-26,80070,293,0,133,1618,82114
2016-06-27,75507,275,0,30,1317,77129
2016-06-28,74241,201,0,75,1246,75763
2016-06-29,71835,213,0,59,1231,73338
2016-06-30,78291,304,0,62,1226,79883
2016-07-01,86636,268,0,68,1469,88441
2016-07-02,89806,257,0,90,1947,92100
2016-07-03,84151,301,0,51,1388,85891
2016-07-04,81162,393,0,50,1333,82938
2016-07-05,74167,280,0,68,1163,75678
2016-07-06,72091,237,0,78,947,73353
2016-07-07,80135,294,0,69,1313,81811
2016-07-08,88835,364,0,76,1390,90665
2016-07-09,88207,344,0,86,915,89552
2016-07-10,83644,357,0,69,2140,86210
2016-07-11,80597,391,0,27,919,81934
2016-07-12,74109,296,0,62,1428,75895
2016-07-13,78877,351,0,109,1293,80630
2016-07-14,79042,231,0,73,2163,81509
2016-07-15,86870,310,0,84,2080,89344
2016-07-16,95831,296,0,100,1287,97514
2016-07-17,90274,301,0,35,1092,91702
2016-07-18,78126,365,0,37,1068,79596
2016-07-19,75218,321,0,84,1107,76730
2016-07-20,82866,401,0,124,1083,84474
2016-07-21,95396,365,0,77,1064,96902
2016-07-22,93208,366,0,142,1755,95471
2016-07-23,90248,364,0,115,1103,91830
2016-07-24,88478,378,0,111,1482,90449
2016-07-25,86802,413,0,80,1241,88536
2016-07-26,77675,372,0,112,1690,79849
2016-07-27,78632,467,0,102,824,80025
2016-07-28,87272,313,0,103,1146,88834
2016-07-29,85373,326,0,112,1536,87347
2016-07-30,96868,319,0,149,1266,98602
2016-07-31,91148,300,0,62,1002,92512
2016-08-01,91494,350,0,108,1262,93214
2016-08-02,86924,174,0,127,1458,88683
2016-08-03,82004,283,0,126,1369,83782
2016-08-04,85199,278,0,95,994,86566
2016-08-05,100148,295,0,114,1454,102011
2016-08-06,91985,212,0,138,1164,93499
2016-08-07,106058,274,0,67,1921,108320
2016-08-08,86156,249,0,57,925,87387
2016-08-09,86999,311,0,113,1575,88998
2016-08-10,90046,238,0,112,1182,91578
2016-08-11,97893,189,0,82,1777,99941
2016-08-12,100927,320,0,97,1007,102351
2016-08-13,99529,286,0,78,1428,101321
2016-08-14,100539,293,0,65,1317,102214
2016-08-15,99635,359,0,63,1819,101876
2016-08-16,99583,303,0,96,786,100768
2016-08-17,85924,397,0,49,1122,87492
2016-08-18,84108,218,0,77,864,85267
2016-08-19,89615,330,0,101,1985,92031
2016-08-20,97051,388,0,94,870,98403
2016-08-21,89411,416,0,54,1302,91183
2016-08-22,85543,235,0,52,1330,87160
2016-08-23,83374,306,0,73,1314,85067
2016-08-24,76242,431,0,90,1227,77990
2016-08-25,81551,415,0,78,1034,83078
2016-08-26,86077,263,0,65,1344,87749
2016-08-27,91385,237,0,75,1421,93118
2016-08-28,84093,273,0,56,973,85395
2016-08-29,82685,395,0,26,1327,84433
2016-08-30,78788,186,0,66,1104,80144
2016-08-31,76310,233,0,100,782,77425
2016-09-01,74267,196,0,106,977,75546
2016-09-02,81226,246,0,54,1236,82762
2016-09-03,97986,244,0,64,1241,99535
2016-09-04,75800,261,0,40,1853,77954
2016-09-05,69234,187,8,92,1101,70622
2016-09-06,70600,186,0,36,1534,72356
2016-09-07,71359,195,0,65,1094,72713
2016-09-08,72852,169,0,117,1359,74497
2016-09-09,69530,192,0,85,1323,71130
2016-09-10,85879,181,0,79,717,86856
2016-09-11,76387,180,0,45,1427,78039
2016-09-12,67119,189,0,112,1537,68957
2016-09-13,61964,167,0,81,991,63203
2016-09-14,71319,150,0,61,1295,72825
2016-09-15,73749,207,0,76,1235,75267
2016-09-16,73244,275,0,94,1346,74959
2016-09-17,78340,196,0,115,823,79474
2016-09-18,70579,243,0,379,1444,72645
2016-09-19,72698,216,0,62,1170,74146
2016-09-20,64460,222,0,60,1485,66227
2016-09-21,63975,248,0,90,398,64711
2016-09-22,68988,159,0,91,1092,70330
2016-09-23,67111,212,0,67,1068,68458
2016-09-24,79180,229,0,103,1288,80800
2016-09-25,74920,220,0,122,1038,76300
2016-09-26,61038,203,1,5,1000,62247
2016-09-27,64545,159,0,35,993,65732
2016-09-28,61562,142,0,76,1210,62990
2016-09-29,66820,149,0,82,1095,68146
2016-09-30,72678,202,0,69,1219,74168
2016-10-01,98313,164,0,199,894,99570
2016-10-02,67586,167,0,90,1151,68994
2016-10-03,68324,186,0,5,931,69446
2016-10-04,61336,104,0,25,928,62393
2016-10-05,61421,191,0,37,1088,62737
2016-10-06,60778,172,0,154,1512,62616
2016-10-07,75384,141,0,35,1599,77159
2016-10-08,86114,113,0,241,1012,87480
2016-10-09,72232,206,0,46,1062,73546
2016-10-10,59393,179,0,7,1610,61189
2016-10-11,58650,199,0,58,1230,60137
2016-10-12,61408,178,0,25,892,62503
2016-10-13,61737,125,0,46,1369,63277
2016-10-14,64266,179,0,14,2081,66540
2016-10-15,74663,198,0,87,1009,75957
2016-10-16,69445,169,0,8,1048,70670
2016-10-17,58485,287,0,37,1269,60078
2016-10-18,55514,161,0,34,1041,56750
2016-10-19,57108,172,0,32,1191,58503
2016-10-20,60371,136,0,25,854,61386
2016-10-21,66883,208,0,503,1393,68987
2016-10-22,70800,274,0,65,1064,72203
2016-10-23,64114,428,0,99,1342,65983
2016-10-24,57852,231,0,2,1004,59089
2016-10-25,41183,163,0,33,286,41665
2016-10-26,54503,160,0,62,298,55023
2016-10-27,55176,165,0,124,399,55864
2016-10-28,67510,64,0,15,1061,68650
2016-10-29,75087,278,0,170,361,75896
2016-10-30,73835,327,0,14,191,74367
2016-10-31,66740,289,0,0,850,67879
2016-11-01,78422,221,0,63,464,79170
2016-11-02,61232,177,8,14,259,61690
2016-11-03,54631,180,0,43,211,55065
2016-11-04,58716,167,0,41,1103,60027
2016-11-05,60905,208,0,69,267,61449
2016-11-06,52532,180,1,14,187,52914
2016-11-07,47848,190,0,3,222,48263
2016-11-08,50997,117,0,27,198,51339
2016-11-09,51103,189,0,0,172,51464
2016-11-10,53800,136,0,19,190,54145
2016-11-11,56325,124,0,9,42,56500
2016-11-12,56705,114,0,173,1174,58166
2016-11-13,52891,122,0,47,829,53889
2016-11-14,46529,97,0,4,0,46630
2016-11-15,49734,158,0,31,1245,51168
2016-11-16,48254,119,0,3,1032,49408
2016-11-17,53182,163,0,48,678,54071
2016-11-18,58173,173,0,3,21,58370
2016-11-19,60381,137,0,77,698,61293
2016-11-20,52191,179,0,10,949,53329
2016-11-21,48389,175,0,0,838,49402
2016-11-22,48680,143,0,103,887,49813
2016-11-23,48418,193,0,2,993,49606
2016-11-24,50719,122,0,18,1115,51974
2016-11-25,56195,135,0,1,731,57062
2016-11-26,57420,149,0,82,594,58245
2016-11-27,49135,188,0,20,1126,50469
2016-11-28,50321,136,0,0,502,50959
2016-11-29,48529,119,0,26,717,49391
2016-11-30,51313,159,0,9,829,52310
2016-12-01,51531,171,0,2,969,52673
2016-12-02,55614,134,0,0,560,56308
2016-12-03,67238,114,0,61,529,67942
2016-12-04,53553,126,0,3,758,54440
2016-12-05,48242,176,0,1,977,49396
2016-12-06,49185,145,0,33,1000,50363
2016-12-07,49298,146,0,0,868,50312
2016-12-08,54107,122,0,4,1025,55258
2016-12-09,56502,154,0,2,1064,57722
2016-12-10,71426,148,0,65,962,72601
2016-12-11,59109,226,0,0,627,59962
2016-12-12,52181,130,0,18,995,53324
2016-12-13,50057,167,0,49,1155,51428
2016-12-14,50660,130,0,17,820,51627
2016-12-15,61945,158,0,8,1101,63212
2016-12-16,71056,161,0,3,1319,72539
2016-12-17,84370,94,0,70,2338,86872
2016-12-18,65128,186,0,13,547,65874
2016-12-19,61878,224,0,0,695,62797
2016-12-20,62597,142,0,78,812,63629
2016-12-21,63709,119,0,39,1597,65464
2016-12-22,78618,210,0,2,1780,80610
2016-12-23,88720,199,0,2,1348,90269
2016-12-24,67663,206,0,102,635,68606
2016-12-25,37023,202,0,0,196,37421
2016-12-26,65896,174,0,18,654,66742
2016-12-27,70664,661,0,0,216,71541
2016-12-28,69975,317,0,0,689,70981
2016-12-29,71713,1367,0,17,617,73714
2016-12-30,78172,386,0,10,1000,79568
2016-12-31,54516,299,0,25,640,55480
2017-01-01,47163,495,0,2,980,48640
2017-01-02,63503,887,0,0,1669,66059
2017-01-03,60793,387,0,0,1449,62629
2017-01-04,65078,187,0,29,1217,66511
2017-01-05,65520,181,0,3,913,66617
2017-01-06,51347,257,0,0,1102,52706
2017-01-07,58463,139,0,49,774,59425
2017-01-08,58534,209,0,0,1323,60066
2017-01-09,51685,225,0,1,1262,53173
2017-01-10,56390,110,0,0,1378,57878
2017-01-11,53467,141,0,74,1116,54798
2017-01-12,61896,144,0,4,848,62892
2017-01-13,56241,116,0,0,1335,57692
2017-01-14,62411,125,0,55,967,63558
2017-01-15,53336,357,0,0,1642,55335
2017-01-16,46158,259,0,0,1088,47505
2017-01-17,36604,112,0,0,1132,37848
2017-01-18,36923,112,0,0,887,37922
2017-01-19,43658,123,0,17,916,44714
2017-01-20,51665,119,0,1,860,52645
2017-01-21,56559,129,0,33,671,57392
2017-01-22,45758,155,0,0,1116,47029
2017-01-23,45555,140,0,2,835,46532
2017-01-24,44876,115,0,4,803,45798
2017-01-25,46581,101,0,92,1084,47858
2017-01-26,45539,104,0,0,1200,46843
2017-01-27,52279,106,0,13,1242,53640
2017-01-28,54120,92,0,40,623,54875
2017-01-29,46268,89,0,0,1201,47558
2017-01-30,44422,124,0,0,965,45511
2017-01-31,45007,111,0,0,856,45974
2017-02-01,42981,95,0,52,855,43983
2017-02-02,50353,123,0,0,1585,52061
2017-02-03,53082,167,0,0,1389,54638
2017-02-04,56347,86,0,37,841,57311
2017-02-05,47584,83,0,38,689,48394
2017-02-06,47479,94,0,0,1011,48584
2017-02-07,44738,108,0,0,1200,46046
2017-02-08,49402,148,0,52,1055,50657
2017-02-09,52873,88,0,0,859,53820
2017-02-10,59740,84,0,1,989,60814
2017-02-11,61878,110,0,28,1010,63026
2017-02-12,53873,132,0,2,1041,55048
2017-02-13,53297,121,0,9,771,54198
2017-02-14,51271,166,0,6,691,52134
2017-02-15,54068,117,0,32,1244,55461
2017-02-16,55207,98,0,0,1026,56331
2017-02-17,57806,79,0,0,1095,58980
2017-02-18,64610,172,0,69,930,65781
2017-02-19,55163,146,0,2,1458,56769
2017-02-20,53313,151,0,4,1309,54777
2017-02-21,50399,129,0,4,892,51424
2017-02-22,52394,119,0,0,1002,53515
2017-02-23,53635,138,0,7,966,54746
2017-02-24,58053,127,0,0,1137,59317
2017-02-25,62170,119,0,40,748,63077
2017-02-26,58034,187,0,1,1173,59395
2017-02-27,51980,159,0,2,1101,53242
2017-02-28,50816,164,0,21,1161,52162
2017-03-01,55467,111,0,38,726,56342
2017-03-02,55921,119,0,1,887,56928
2017-03-03,62806,182,0,9,1450,64447
2017-03-04,64010,128,0,47,909,65094
2017-03-05,58043,574,0,5,942,59564
2017-03-06,52293,144,0,1,999,53437
2017-03-07,51203,132,0,3,1323,52661
2017-03-08,53068,141,0,31,1057,54297
2017-03-09,56520,168,0,0,752,57440
2017-03-10,60042,127,0,0,875,61044
2017-03-11,67962,126,0,44,1029,69161
2017-03-12,58945,152,0,0,859,59956
2017-03-13,53577,98,0,20,946,54641
2017-03-14,49866,118,0,0,813,50797
2017-03-15,55154,127,0,39,1164,56484
2017-03-16,58270,139,0,3,1225,59637
2017-03-17,63659,151,0,0,953,64763
2017-03-18,64698,139,0,42,1065,65944
2017-03-19,62074,200,0,1,958,63233
2017-03-20,55379,229,0,2,915,56525
2017-03-21,53832,156,0,0,798,54786
2017-03-22,55612,97,0,38,1133,56880
2017-03-23,58164,103,0,11,757,59035
2017-03-24,57357,171,0,6,1441,58975
2017-03-25,69410,95,0,52,713,70270
2017-03-26,53922,129,0,0,147,54198
2017-03-27,52826,157,0,3,2202,55188
2017-03-28,50806,136,0,43,776,51761
2017-03-29,56954,101,0,31,178,57264
2017-03-30,59097,144,0,5,248,59494
2017-03-31,65225,132,0,10,237,65604
2017-04-01,73525,97,0,63,814,74499
2017-04-02,62529,95,0,11,76,62711
2017-04-03,56420,146,0,3,384,56953
2017-04-04,54250,99,0,24,416,54789
2017-04-05,57817,173,0,1,1254,59245
2017-04-06,60672,100,0,50,866,61688
2017-04-07,67039,93,0,4,1957,69093
2017-04-08,81006,171,0,83,1937,83197
2017-04-09,68476,122,0,9,1850,70457
2017-04-10,58723,137,0,4,1531,60395
2017-04-11,61778,123,0,97,1746,63744
2017-04-12,70807,115,0,30,2063,73015
2017-04-13,76339,145,0,96,1847,78427
2017-04-14,93543,267,0,34,1935,95779
2017-04-15,66821,96,0,71,1854,68842
2017-04-16,47102,85,0,11,373,47571
2017-04-17,76282,87,0,4,692,77065
2017-04-18,70456,166,0,36,1703,72361
2017-04-19,65812,124,0,59,1629,67624
2017-04-20,67167,130,0,52,641,67990
2017-04-21,73500,147,0,68,555,74270
2017-04-22,77369,134,0,260,2405,80168
2017-04-23,70179,128,0,268,728,71303
2017-04-24,63467,74,0,14,1605,65160
2017-04-25,61704,101,0,34,1874,63713
2017-04-26,62836,72,0,10,1852,64770
2017-04-27,64258,148,0,41,1959,66406
2017-04-28,72287,132,0,43,1661,74123
2017-04-29,75367,178,0,85,1818,77448
2017-04-30,67514,138,0,80,2064,69796
2017-05-01,64261,242,0,0,2575,67078
2017-05-02,54569,122,0,60,975,55726
2017-05-03,61854,101,0,88,1587,63630
2017-05-04,62005,90,0,71,432,62598
2017-05-05,69159,79,0,82,373,69693
2017-05-06,65968,121,0,71,899,67059
2017-05-07,64009,113,0,35,738,64895
2017-05-08,62035,122,0,23,607,62787
2017-05-09,57744,82,0,34,703,58563
2017-05-10,59125,74,0,80,547,59826
2017-05-11,64657,110,0,38,619,65424
2017-05-12,63985,84,0,61,377,64507
2017-05-13,73015,113,0,65,708,73901
2017-05-14,61161,164,0,19,838,62182
2017-05-15,63471,120,0,14,804,64409
2017-05-16,59934,101,0,79,770,60884
2017-05-17,62811,102,0,97,402,63412
2017-05-18,62620,86,0,82,1811,64599
2017-05-19,69003,171,0,48,2130,71352
2017-05-20,75003,144,0,82,656,75885
2017-05-21,64413,252,0,43,588,65296
2017-05-22,57595,120,0,12,824,58551
2017-05-23,63234,110,0,48,677,64069
2017-05-24,62927,123,0,43,426,63519
2017-05-25,74525,125,1,93,354,75098
2017-05-26,69432,135,0,29,504,70100
2017-05-27,76451,145,0,74,591,77261
2017-05-28,70868,126,0,78,659,71731
2017-05-29,61439,84,0,33,883,62439
2017-05-30,57396,118,0,77,679,58270
2017-05-31,63545,125,0,41,411,64122
2017-06-01,70616,131,0,73,520,71340
2017-06-02,81812,196,0,78,489,82575
2017-06-03,73820,160,0,70,442,74492
2017-06-04,76666,149,0,74,769,77658
2017-06-05,75510,228,0,30,662,76430
2017-06-06,64837,91,0,72,664,65664
2017-06-07,67547,123,0,47,497,68214
2017-06-08,71192,111,0,61,534,71898
2017-06-09,75245,194,2,87,622,76150
2017-06-10,79217,161,0,80,577,80035
2017-06-11,74390,120,0,46,652,75208
2017-06-12,75687,121,0,37,842,76687
2017-06-13,71261,144,0,83,665,72153
2017-06-14,77976,170,0,84,541,78771
2017-06-15,90551,129,0,73,508,91261
2017-06-16,82407,139,0,67,503,83116
2017-06-17,87824,154,0,89,509,88576
2017-06-18,79900,216,0,83,908,81107
2017-06-19,75489,143,0,43,786,76461
2017-06-20,70995,111,0,144,767,72017
2017-06-21,71923,120,0,94,687,72824
2017-06-22,91267,120,0,101,642,92130
2017-06-23,82703,173,0,64,496,83436
2017-06-24,91558,189,0,117,560,92424
2017-06-25,88340,223,0,146,736,89445
2017-06-26,77330,133,0,21,706,78190
2017-06-27,67124,203,0,102,660,68089
2017-06-28,69808,151,0,70,532,70561
2017-06-29,75494,200,0,37,744,76475
2017-06-30,82252,267,0,64,526,83109
2017-07-01,81407,195,0,92,812,82506
2017-07-02,80543,220,0,99,763,81625
2017-07-03,75022,165,0,29,737,75953
2017-07-04,73629,180,0,97,773,74679
2017-07-05,66918,129,2,94,658,67801
2017-07-06,81096,177,0,111,629,82013
2017-07-07,79320,156,0,90,896,80462
2017-07-08,84996,216,0,84,575,85871
2017-07-09,81233,275,0,63,1046,82617
2017-07-10,79908,199,0,48,673,80828
2017-07-11,71771,240,0,96,860,72967
2017-07-12,75011,240,0,141,489,75881
2017-07-13,79782,180,0,77,559,80598
2017-07-14,86440,220,0,96,589,87345
2017-07-15,87500,204,0,102,429,88235
2017-07-16,80043,285,0,40,917,81285
2017-07-17,77719,214,0,33,1023,78989
2017-07-18,76863,200,0,60,1151,78274
2017-07-19,72129,218,0,93,716,73156
2017-07-20,92347,248,0,115,745,93455
2017-07-21,80522,196,0,150,638,81506
2017-07-22,100261,185,0,161,596,101203
2017-07-23,87595,189,0,95,874,88753
2017-07-24,74910,202,0,99,1588,76799
2017-07-25,67466,220,0,112,678,68476
2017-07-26,82397,167,0,88,677,83329
2017-07-27,82969,216,0,93,853,84131
2017-07-28,84977,223,2,161,953,86316
2017-07-29,89947,199,0,147,655,90948
2017-07-30,89696,185,0,63,640,90584
2017-07-31,83181,226,0,43,765,84215
2017-08-01,84762,209,0,104,1004,86079
2017-08-02,76098,213,0,123,929,77363
2017-08-03,87498,175,0,109,762,88544
2017-08-04,95988,190,0,82,669,96929
2017-08-05,109400,255,0,167,745,110567
2017-08-06,76227,208,0,78,691,77204
2017-08-07,88870,160,0,35,709,89774
2017-08-08,80253,182,0,130,723,81288
2017-08-09,83243,173,0,59,686,84161
2017-08-10,73970,186,0,176,808,75140
2017-08-11,79684,175,0,86,558,80503
2017-08-12,97506,276,0,106,985,98873
2017-08-13,93433,225,0,65,842,94565
2017-08-14,82168,227,0,37,735,83167
2017-08-15,93402,205,0,95,758,94460
2017-08-16,90199,201,0,81,728,91209
2017-08-17,88364,190,0,60,787,89401
2017-08-18,78523,293,0,82,806,79704
2017-08-19,87473,183,0,83,786,88525
2017-08-20,81885,125,0,9,754,82773
2017-08-21,82707,186,0,51,692,83636
2017-08-22,74130,200,0,92,581,75003
2017-08-23,73290,153,0,95,577,74115
2017-08-24,69633,180,0,99,747,70659
2017-08-25,83182,160,0,84,691,84117
2017-08-26,78047,132,0,76,570,78825
2017-08-27,80026,103,0,34,645,80808
2017-08-28,76347,159,0,14,592,77112
2017-08-29,73032,143,0,57,732,73964
2017-08-30,72044,196,0,68,633,72941
2017-08-31,76128,144,0,85,505,76862
2017-09-01,73205,111,0,27,1723,75066
2017-09-02,77506,96,0,100,702,78404
2017-09-03,68245,149,0,31,944,69369
2017-09-04,66157,116,0,32,646,66951
2017-09-05,61197,130,0,66,368,61761
2017-09-06,61398,134,0,43,513,62088
2017-09-07,65008,112,12,86,501,65719
2017-09-08,81995,101,0,74,418,82588
2017-09-09,78325,87,0,167,429,79008
2017-09-10,70518,170,12,24,499,71223
2017-09-11,61150,161,0,6,623,61940
2017-09-12,65441,104,0,92,403,66040
2017-09-13,58914,75,0,45,502,59536
2017-09-14,62288,127,0,103,483,63001
2017-09-15,70910,141,0,9,584,71644
2017-09-16,78352,109,0,84,390,78935
2017-09-17,74565,132,0,44,601,75342
2017-09-18,62533,143,4,37,697,63414
2017-09-19,60249,97,0,31,572,60949
2017-09-20,64646,103,0,65,488,65302
2017-09-21,67856,95,1,43,554,68549
2017-09-22,69286,133,1,42,463,69925
2017-09-23,73092,94,0,153,559,73898
2017-09-24,67838,137,0,95,663,68733
2017-09-25,62514,136,0,35,601,63286
2017-09-26,57967,133,0,61,558,58719
2017-09-27,58336,97,0,97,573,59103
2017-09-28,66921,131,0,93,570,67715
2017-09-29,67838,112,0,76,554,68580
2017-09-30,80070,100,0,165,619,80954
2017-10-01,74005,149,0,78,973,75205
2017-10-02,67522,105,0,25,706,68358
2017-10-03,59075,138,0,45,612,59870
2017-10-04,59960,83,0,52,461,60556
2017-10-05,59524,86,0,129,569,60308
2017-10-06,71091,95,0,25,778,71989
2017-10-07,75676,89,0,156,869,76790
2017-10-08,74480,118,0,64,1174,75836
2017-10-09,57425,108,0,14,903,58450
2017-10-10,60953,129,0,16,975,62073
2017-10-11,59466,93,0,50,919,60528
2017-10-12,60865,69,8,138,809,61889
2017-10-13,64929,98,8,16,860,65911
2017-10-14,76610,61,12,77,781,77541
2017-10-15,72642,531,0,38,1206,74417
2017-10-16,59286,77,0,26,1130,60519
2017-10-17,54785,97,0,54,1081,56017
2017-10-18,59053,80,0,117,909,60159
2017-10-19,60532,88,0,94,969,61683
2017-10-20,65451,112,0,31,956,66550
2017-10-21,69793,86,0,86,1154,71119
2017-10-22,67004,142,0,11,1224,68381
2017-10-23,59806,131,0,10,1047,60994
2017-10-24,55269,82,0,21,1242,56614
2017-10-25,58622,84,0,8,1051,59765
2017-10-26,63911,101,0,111,1143,65266
2017-10-27,72273,214,0,80,1051,73618
2017-10-28,78073,123,0,62,1880,80138
2017-10-29,72291,137,0,11,755,73194
2017-10-30,66662,136,0,11,703,67512
2017-10-31,65567,108,0,7,821,66503
2017-11-01,72945,162,0,79,698,73884
2017-11-02,65819,92,0,1,716,66628
2017-11-03,68231,101,0,55,802,69189
2017-11-04,70253,73,0,68,847,71241
2017-11-05,65591,103,0,0,644,66338
2017-11-06,53807,167,0,1,529,54504
2017-11-07,58653,89,0,0,550,59292
2017-11-08,57318,61,0,112,490,57981
2017-11-09,58184,64,0,17,717,58982
2017-11-10,61610,103,0,85,639,62437
2017-11-11,70223,61,0,76,708,71068
2017-11-12,57728,92,0,24,675,58519
2017-11-13,54049,107,0,0,374,54530
2017-11-14,53746,115,0,0,710,54571
2017-11-15,55321,77,0,0,314,55712
2017-11-16,61008,73,0,22,486,61589
2017-11-17,62036,75,0,82,610,62803
2017-11-18,63133,73,0,134,588,63928
2017-11-19,61159,81,0,5,579,61824
2017-11-20,55679,64,0,11,339,56093
2017-11-21,53238,73,0,0,599,53910
2017-11-22,54091,81,0,40,383,54595
2017-11-23,59095,78,0,22,476,59671
2017-11-24,65839,119,0,120,414,66492
2017-11-25,62220,82,0,53,433,62788
2017-11-26,54406,82,0,1,670,55159
2017-11-27,55854,100,0,5,492,56451
2017-11-28,55440,68,0,28,502,56038
2017-11-29,52236,79,0,33,406,52754
2017-11-30,54164,88,0,0,601,54853
2017-12-01,64234,119,0,5,626,64984
2017-12-02,63630,64,0,39,575,64308
2017-12-03,54317,106,0,13,700,55136
2017-12-04,52719,97,0,4,381,53201
2017-12-05,53975,78,0,0,529,54582
2017-12-06,52564,97,0,67,404,53132
2017-12-07,59167,71,0,0,422,59660
2017-12-08,62380,95,0,41,504,63020
2017-12-09,61084,190,0,30,487,61791
2017-12-10,58455,369,0,12,642,59478
2017-12-11,56369,79,0,0,303,56751
2017-12-12,54938,101,0,0,533,55572
2017-12-13,55244,88,0,41,430,55803
2017-12-14,58383,179,0,9,720,59291
2017-12-15,69582,220,0,60,826,70688
2017-12-16,81900,278,0,47,698,82923
2017-12-17,68428,367,0,2,678,69475
2017-12-18,61005,159,0,9,497,61670
2017-12-19,67733,98,0,22,776,68629
2017-12-20,70150,113,0,45,716,71024
2017-12-21,80434,183,0,18,943,81578
2017-12-22,81375,562,0,60,1000,82997
2017-12-23,101053,503,0,123,778,102457
2017-12-24,51008,130,0,0,498,51636
2017-12-25,46364,101,0,1,74,46540
2017-12-26,66174,223,0,0,426,66823
2017-12-27,73688,194,0,12,292,74186
2017-12-28,73407,192,0,5,539,74143
2017-12-29,79682,123,0,36,328,80169
2017-12-30,79568,244,0,52,451,80315
2017-12-31,47196,117,0,0,241,47554
2018-01-01,51733,216,0,0,316,52265
2018-01-02,69250,556,0,0,800,70606
2018-01-03,74237,270,0,44,468,75019
2018-01-04,70941,214,0,6,823,71984
2018-01-05,72638,137,0,28,641,73444
2018-01-06,66014,164,0,49,528,66755
2018-01-07,67693,201,0,0,868,68762
2018-01-08,63524,113,0,0,413,64050
2018-01-09,56446,147,0,0,866,57459
2018-01-10,61936,116,0,39,578,62669
2018-01-11,62147,129,0,16,775,63067
2018-01-12,74566,148,0,0,639,75353
2018-01-13,78502,123,0,64,840,79529
2018-01-14,58766,170,0,0,1099,60035
2018-01-15,37541,74,0,20,551,38186
2018-01-16,37187,77,0,0,640,37904
2018-01-17,42423,103,0,35,408,42969
2018-01-18,45567,107,0,0,449,46123
2018-01-19,44292,112,0,8,559,44971
2018-01-20,49600,69,0,43,504,50216
2018-01-21,41898,94,0,0,713,42705
2018-01-22,40065,92,5,0,370,40532
2018-01-23,36425,68,0,16,499,37008
2018-01-24,37466,131,0,62,410,38069
2018-01-25,41997,70,0,31,427,42525
2018-01-26,48441,78,0,0,594,49113
2018-01-27,50142,90,0,41,460,50733
2018-01-28,44969,104,0,6,642,45721
2018-01-29,37915,74,0,10,328,38327
2018-01-30,41165,102,0,10,497,41774
2018-01-31,39692,66,0,46,438,40242
2018-02-01,42438,104,0,0,442,42984
2018-02-02,45352,84,0,0,545,45981
2018-02-03,41478,132,0,39,308,41957
2018-02-04,45716,111,0,17,618,46462
2018-02-05,37276,57,0,9,433,37775
2018-02-06,39015,66,0,12,550,39643
2018-02-07,33077,74,0,29,362,33542
2018-02-08,39111,54,0,1,546,39712
2018-02-09,45375,84,0,0,558,46017
2018-02-10,52976,87,0,67,391,53521
2018-02-11,49578,94,0,0,664,50336
2018-02-12,38721,69,0,0,388,39178
2018-02-13,31956,44,0,0,530,32530
2018-02-14,40958,81,0,46,328,41413
2018-02-15,42788,65,0,7,564,43424
2018-02-16,47492,90,0,11,596,48189
2018-02-17,53865,75,0,76,514,54530
2018-02-18,46630,134,0,0,767,47531
2018-02-19,42739,94,0,0,420,43253
2018-02-20,39767,69,0,1,589,40426
2018-02-21,38651,58,0,40,496,39245
2018-02-22,37285,77,0,0,535,37897
2018-02-23,42826,122,0,0,639,43587
2018-02-24,46462,129,0,57,491,47139
2018-02-25,34768,65,0,0,774,35607
2018-02-26,32341,92,0,2,304,32739
2018-02-27,25235,27,0,2,533,25797
2018-02-28,31736,47,0,21,531,32335
2018-03-01,34269,51,0,6,642,34968
2018-03-02,37426,52,0,5,570,38053
2018-03-03,44358,32,0,55,496,44941
2018-03-04,39757,119,0,6,631,40513
2018-03-05,39200,83,0,13,409,39705
2018-03-06,37674,49,0,25,495,38243
2018-03-07,40665,70,0,63,460,41258
2018-03-08,45417,82,0,13,558,46070
2018-03-09,53580,93,0,2,583,54258
2018-03-10,58918,65,0,48,493,59524
2018-03-11,52326,335,0,0,749,53410
2018-03-12,42383,138,0,5,410,42936
2018-03-13,40108,97,0,12,558,40775
2018-03-14,43377,117,0,62,423,43979
2018-03-15,47268,90,0,9,573,47940
2018-03-16,57103,71,0,0,629,57803
2018-03-17,58100,56,0,48,539,58743
2018-03-18,49863,89,0,0,741,50693
2018-03-19,43382,88,0,0,488,43958
2018-03-20,41933,52,0,36,637,42658
2018-03-21,40798,78,2,24,468,41370
2018-03-22,44130,68,0,2,541,44741
2018-03-23,51571,124,0,10,613,52318
2018-03-24,61730,118,0,65,573,62486
2018-03-25,53874,107,0,0,1057,55038
2018-03-26,49193,79,0,4,903,50179
2018-03-27,48225,113,0,4,989,49331
2018-03-28,53420,98,0,72,1076,54666
2018-03-29,62635,184,0,14,865,63698
2018-03-30,71340,133,0,13,1060,72546
2018-03-31,54946,157,0,55,1275,56433
2018-04-01,43042,116,0,6,790,43954
2018-04-02,76131,109,0,3,1225,77468
2018-04-03,60076,80,0,126,1174,61456
2018-04-04,58047,93,0,21,1039,59200
2018-04-05,63338,88,0,38,1140,64604
2018-04-06,61830,82,0,18,1252,63182
2018-04-07,64457,117,0,304,2124,67002
2018-04-08,64933,127,6,6,1418,66490
2018-04-09,54050,137,0,1,1472,55660
2018-04-10,52133,93,0,46,1021,53293
2018-04-11,47676,118,0,38,772,48604
2018-04-12,52086,85,0,47,755,52973
2018-04-13,55491,116,0,19,941,56567
2018-04-14,60234,71,0,60,1133,61498
2018-04-15,60823,106,0,2,958,61889
2018-04-16,51781,137,0,18,1070,53006
2018-04-17,47641,116,0,113,1592,49462
2018-04-18,48946,77,0,17,774,49814
2018-04-19,50111,113,0,38,780,51042
2018-04-20,60939,100,0,24,1021,62084
2018-04-21,69851,118,2,120,1146,71237
2018-04-22,64434,150,0,175,1142,65901
2018-04-23,52312,162,0,2,1057,53533
2018-04-24,53553,109,0,61,1234,54957
2018-04-25,55376,70,0,110,828,56384
2018-04-26,57815,78,0,62,793,58748
2018-04-27,69619,99,0,11,1087,70816
2018-04-28,67008,124,0,89,1040,68261
2018-04-29,66482,115,0,31,1204,67832
2018-04-30,66212,117,1,63,1205,67598
2018-05-01,60894,121,0,94,1845,62954
2018-05-02,52962,99,0,22,1020,54103
2018-05-03,54227,114,0,73,741,55155
2018-05-04,61894,123,0,36,825,62878
2018-05-05,66509,115,0,91,1091,67806
2018-05-06,63851,105,0,22,1066,65044
2018-05-07,51458,154,0,7,1018,52637
2018-05-08,53395,160,0,190,1030,54775
2018-05-09,52830,95,0,59,819,53803
2018-05-10,71834,112,0,65,759,72770
2018-05-11,60127,166,0,44,901,61238
2018-05-12,72101,84,0,134,1264,73583
2018-05-13,61930,209,0,18,930,63087
2018-05-14,54953,103,0,4,911,55971
2018-05-15,51131,114,0,41,1321,52607
2018-05-16,54393,114,0,46,977,55530
2018-05-17,60505,110,1,76,776,61468
2018-05-18,63728,219,0,28,939,64914
2018-05-19,70088,116,0,94,1226,71524
2018-05-20,67039,790,0,51,972,68852
2018-05-21,59095,90,0,25,1184,60394
2018-05-22,54337,100,0,45,1024,55506
2018-05-23,50175,98,0,41,862,51176
2018-05-24,58451,92,21,106,799,59469
2018-05-25,62776,93,0,60,892,63821
2018-05-26,62918,98,0,74,1289,64379
2018-05-27,64392,108,0,46,1110,65656
2018-05-28,55621,89,0,31,869,56610
2018-05-29,52838,76,0,71,930,53915
2018-05-30,58889,119,0,9,946,59963
2018-05-31,70408,95,1,89,787,71380
2018-06-01,71815,100,0,46,783,72744
2018-06-02,74247,135,0,80,829,75291
2018-06-03,68750,163,0,96,2032,71041
2018-06-04,58600,98,0,7,950,59655
2018-06-05,53804,58,0,81,1005,54948
2018-06-06,57063,113,0,73,738,57987
2018-06-07,59370,91,0,58,678,60197
2018-06-08,65055,133,0,45,889,66122
2018-06-09,67947,83,0,73,1122,69225
2018-06-10,64325,134,0,34,1038,65531
2018-06-11,64245,92,0,68,903,65308
2018-06-12,55363,84,0,103,834,56384
2018-06-13,58719,70,1,31,658,59479
2018-06-14,64590,136,0,47,1003,65776
2018-06-15,85394,152,0,34,824,86404
2018-06-16,66216,168,0,80,1161,67625
2018-06-17,67095,65,0,41,1059,68260
2018-06-18,66056,128,0,25,930,67139
2018-06-19,57102,94,0,82,937,58215
2018-06-20,59849,90,0,62,1110,61111
2018-06-21,66178,130,0,95,724,67127
2018-06-22,83107,133,0,19,901,84160
2018-06-23,76807,196,0,140,857,78000
2018-06-24,72663,121,0,84,1315,74183
2018-06-25,82582,237,0,83,1740,84642
2018-06-26,63053,141,0,312,1573,65079
2018-06-27,60273,127,1,47,1361,61809
2018-06-28,62118,108,0,112,1368,63706
2018-06-29,79474,119,0,73,1020,80686
2018-06-30,84265,180,0,117,945,85507
2018-07-01,75764,229,0,71,1396,77460
2018-07-02,63406,185,0,34,1107,64732
2018-07-03,62624,125,16,137,1094,63996
2018-07-04,62380,159,0,63,903,63505
2018-07-05,67111,168,0,61,1165,68505
2018-07-06,73065,136,0,103,1076,74380
2018-07-07,75765,248,0,131,1086,77230
2018-07-08,73605,158,0,50,999,74812
2018-07-09,66702,180,0,100,1021,68003
2018-07-10,61395,196,0,70,1060,62721
2018-07-11,63074,168,0,48,994,64284
2018-07-12,66907,121,0,77,1188,68293
2018-07-13,73751,107,0,51,1121,75030
2018-07-14,90957,267,0,99,1048,92371
2018-07-15,74044,543,0,62,1089,75738
2018-07-16,70200,318,0,27,2121,72666
2018-07-17,68843,161,0,78,1166,70248
2018-07-18,65973,224,0,75,1256,67528
2018-07-19,72523,268,0,82,942,73815
2018-07-20,86349,299,3,83,884,87618
2018-07-21,95930,287,0,113,1347,97677
2018-07-22,81069,264,0,56,994,82383
2018-07-23,79019,278,0,74,941,80312
2018-07-24,69174,272,0,98,1112,70656
2018-07-25,71155,192,0,98,1174,72619
2018-07-26,76518,290,0,107,1266,78181
2018-07-27,84844,343,0,96,2220,87503
2018-07-28,88342,301,0,144,957,89744
2018-07-29,88039,162,0,87,693,88981
2018-07-30,86257,269,0,49,659,87234
2018-07-31,77211,224,0,104,1022,78561
2018-08-01,75346,224,0,96,1139,76805
2018-08-02,79557,163,0,97,1205,81022
2018-08-03,58212,160,0,81,1127,59580
2018-08-04,98747,270,0,174,1121,100312
2018-08-05,83381,303,0,82,980,84746
2018-08-06,84961,211,0,76,1107,86355
2018-08-07,74589,227,0,99,1016,75931
2018-08-08,71682,138,0,134,946,72900
2018-08-09,73791,318,0,136,1069,75314
2018-08-10,77227,247,0,81,1117,78672
2018-08-11,83227,317,0,117,1004,84665
2018-08-12,80611,267,0,69,1098,82045
2018-08-13,77071,271,0,53,936,78331
2018-08-14,76903,220,0,90,1326,78539
2018-08-15,89911,293,0,74,1277,91555
2018-08-16,86762,160,0,83,895,87900
2018-08-17,80377,201,0,94,1029,81701
2018-08-18,94994,246,0,88,1233,96561
2018-08-19,105845,170,0,46,979,107040
2018-08-20,72029,214,0,83,836,73162
2018-08-21,72324,247,0,105,845,73521
2018-08-22,72441,238,0,94,1076,73849
2018-08-23,77035,84,0,109,628,77856
2018-08-24,73314,213,0,55,715,74297
2018-08-25,85543,142,0,79,926,86690
2018-08-26,74628,188,0,40,1100,75956
2018-08-27,75017,162,0,28,975,76182
2018-08-28,64327,112,0,67,819,65325
2018-08-29,68160,266,0,60,1052,69538
2018-08-30,68459,134,0,72,1128,69793
2018-08-31,78433,189,0,62,979,79663
2018-09-01,75839,118,0,73,947,76977
2018-09-02,72242,242,0,39,986,73509
2018-09-03,65818,163,0,48,1024,67053
2018-09-04,61576,122,0,60,581,62339
2018-09-05,61441,110,0,100,798,62449
2018-09-06,62311,121,0,112,712,63256
2018-09-07,66501,124,0,35,736,67396
2018-09-08,82383,232,2,78,721,83416
2018-09-09,70838,156,0,68,947,72009
2018-09-10,60214,107,0,24,688,61033
2018-09-11,58181,108,0,161,842,59292
2018-09-12,54800,168,0,62,921,55951
2018-09-13,62911,100,1,65,690,63767
2018-09-14,68196,105,0,102,887,69290
2018-09-15,74746,107,1,102,928,75884
2018-09-16,75097,226,0,43,730,76096
2018-09-17,60091,119,0,42,667,60919
2018-09-18,56793,78,0,89,810,57770
2018-09-19,62243,94,0,63,931,63331
2018-09-20,68820,234,0,127,738,69919
2018-09-21,76921,90,0,107,1280,78398
2018-09-22,74937,123,0,81,828,75969
2018-09-23,71261,149,0,49,1145,72604
2018-09-24,87451,353,0,43,5934,93781
2018-09-25,55782,99,0,120,1044,57045
2018-09-26,54702,154,0,23,1041,55920
2018-09-27,61905,120,0,113,1108,63246
2018-09-28,68885,118,0,81,1209,70293
2018-09-29,75818,114,0,132,861,76925
2018-09-30,69327,98,0,115,1505,71045
2018-10-01,57279,129,0,37,828,58273
2018-10-02,52331,103,0,86,1178,53698
2018-10-03,55323,101,0,23,808,56255
2018-10-04,59060,100,0,92,1004,60256
2018-10-05,67856,107,0,119,1067,69149
2018-10-06,63981,60,0,221,1005,65267
2018-10-07,65189,137,0,77,1501,66904
2018-10-08,99577,213,0,1,1978,101769
2018-10-09,53188,95,0,86,1500,54869
2018-10-10,56634,71,0,27,1035,57767
2018-10-11,57941,82,0,65,1129,59217
2018-10-12,62388,141,0,76,1126,63731
2018-10-13,67382,81,0,76,1385,68924
2018-10-14,66552,75,0,58,1532,68217
2018-10-15,50185,83,0,48,1434,51750
2018-10-16,42922,86,0,122,1285,44415
2018-10-17,56991,71,0,10,918,57990
2018-10-18,56838,118,0,108,1095,58159
2018-10-19,59791,143,0,10,1250,61194
2018-10-20,63926,74,0,189,1326,65515
2018-10-21,64083,567,0,63,1493,66206
2018-10-22,51832,94,0,1,1366,53293
2018-10-23,48841,74,0,100,1496,50511
2018-10-24,47459,102,0,16,1313,48890
2018-10-25,53215,76,0,95,1485,54871
2018-10-26,66735,84,0,82,1331,68232
2018-10-27,67689,71,0,208,2566,70534
2018-10-28,61051,85,0,9,763,61908
2018-10-29,48235,75,0,0,499,48809
2018-10-30,56726,93,0,0,776,57595
2018-10-31,62370,107,0,74,693,63244
2018-11-01,64898,115,0,8,464,65485
2018-11-02,68421,124,0,20,490,69055
2018-11-03,69387,69,0,35,579,70070
2018-11-04,69895,187,0,2,1021,71105
2018-11-05,51551,122,0,0,652,52325
2018-11-06,46206,87,0,7,531,46831
2018-11-07,46824,70,0,46,433,47373
2018-11-08,49753,84,0,6,665,50508
2018-11-09,55354,105,0,18,699,56176
2018-11-10,62788,98,0,87,493,63466
2018-11-11,59137,69,0,2,767,59975
2018-11-12,48624,67,0,3,567,49261
2018-11-13,48389,87,0,8,843,49327
2018-11-14,48439,85,0,57,458,49039
2018-11-15,50260,68,0,20,656,51004
2018-11-16,58156,77,0,73,817,59123
2018-11-17,58796,73,0,70,582,59521
2018-11-18,53491,79,0,1,722,54293
2018-11-19,47900,66,0,1,514,48481
2018-11-20,40882,56,0,0,713,41651
2018-11-21,42381,91,0,33,386,42891
2018-11-22,49972,72,0,11,586,50641
2018-11-23,57382,53,0,86,735,58256
2018-11-24,55588,55,0,73,627,56343
2018-11-25,51811,81,0,21,713,52626
2018-11-26,46663,67,0,18,472,47220
2018-11-27,42216,48,0,4,525,42793
2018-11-28,43075,57,0,37,490,43659
2018-11-29,43399,51,0,1,669,44120
2018-11-30,53793,100,0,39,1007,54939
2018-12-01,54921,221,0,56,676,55874
2018-12-02,50817,445,0,4,741,52007
2018-12-03,42993,79,0,9,525,43606
2018-12-04,44754,89,0,0,545,45388
2018-12-05,44762,80,0,45,473,45360
2018-12-06,47056,89,0,7,604,47756
2018-12-07,54229,69,0,48,693,55039
2018-12-08,59817,407,0,421,595,61240
2018-12-09,54686,141,0,0,663,55490
2018-12-10,48321,82,0,32,540,48975
2018-12-11,47400,99,0,0,573,48072
2018-12-12,47248,75,0,62,565,47950
2018-12-13,50217,113,0,1,620,50951
2018-12-14,52822,300,0,18,864,54004
2018-12-15,56471,397,0,59,594,57521
2018-12-16,56260,556,0,0,811,57627
2018-12-17,48926,71,0,3,509,49509
2018-12-18,51659,131,0,18,759,52567
2018-12-19,54834,106,0,44,430,55414
2018-12-20,62974,265,0,11,1020,64270
2018-12-21,77446,382,0,32,1075,78935
2018-12-22,105257,1267,0,140,773,107437
2018-12-23,66740,1109,0,1,933,68783
2018-12-24,49185,270,0,12,557,50024
2018-12-25,33563,222,0,3,169,33957
2018-12-26,56306,890,0,0,368,57564
2018-12-27,64837,124,0,1,391,65353
2018-12-28,68882,166,0,4,485,69537
2018-12-29,73988,1338,0,49,331,75706
2018-12-30,62703,285,0,0,681,63669
2018-12-31,46800,127,0,14,219,47160
2019-01-01,41102,87,0,0,347,41536
2019-01-02,65587,686,0,11,703,66987
2019-01-03,63918,246,0,0,745,64909
2019-01-04,62641,163,0,5,890,63699
2019-01-05,67879,171,0,53,665,68768
2019-01-06,56776,157,0,13,791,57737
2019-01-07,49311,103,0,28,766,50208
2019-01-08,49673,164,0,4,643,50484
2019-01-09,44610,102,0,67,601,45380
2019-01-10,50285,80,0,0,478,50843
2019-01-11,56807,99,0,0,892,57798
2019-01-12,75977,98,0,53,868,76996
2019-01-13,53469,129,0,0,1115,54713
2019-01-14,43308,48,0,1,610,43967
2019-01-15,47068,64,0,2,654,47788
2019-01-16,43462,85,0,39,475,44061
2019-01-17,45394,63,0,2,591,46050
2019-01-18,50625,89,0,10,700,51424
2019-01-19,52690,61,0,39,573,53363
2019-01-20,44483,57,0,16,706,45262
2019-01-21,40935,82,0,1,463,41481
2019-01-22,43267,50,0,73,2891,46281
2019-01-23,35364,50,0,71,430,35915
2019-01-24,38998,32,0,2,539,39571
2019-01-25,43774,63,0,0,697,44534
2019-01-26,49260,48,0,37,536,49881
2019-01-27,43017,60,0,0,662,43739
2019-01-28,40473,65,0,6,432,40976
2019-01-29,37862,53,0,0,429,38344
2019-01-30,43167,58,0,42,443,43710
2019-01-31,45430,68,0,4,512,46014
2019-02-01,53207,99,0,7,642,53955
2019-02-02,52504,81,0,32,425,53042
2019-02-03,47376,84,0,11,491,47962
2019-02-04,44027,46,0,0,449,44522
2019-02-05,41474,93,0,15,455,42037
2019-02-06,43807,75,0,19,377,44278
2019-02-07,47694,66,0,9,582,48351
2019-02-08,51465,51,0,8,718,52242
2019-02-09,57552,42,0,35,503,58132
2019-02-10,51023,85,0,3,711,51822
2019-02-11,44816,86,0,1,468,45371
2019-02-12,43387,85,0,1,580,44053
2019-02-13,44675,52,0,44,435,45206
2019-02-14,50842,50,0,0,745,51637
2019-02-15,55279,92,0,22,731,56124
2019-02-16,63596,83,0,45,608,64332
2019-02-17,56420,98,0,13,888,57419
2019-02-18,46876,77,0,48,557,47558
2019-02-19,42560,77,0,27,585,43249
2019-02-20,46540,81,0,54,484,47159
2019-02-21,49918,84,0,13,607,50622
2019-02-22,49870,94,0,28,578,50570
2019-02-23,54977,67,0,35,691,55770
2019-02-24,52587,95,0,0,756,53438
2019-02-25,43569,78,0,2,664,44313
2019-02-26,42766,57,0,6,560,43389
2019-02-27,45566,86,0,61,512,46225
2019-02-28,53245,70,0,3,679,53997
2019-03-01,60243,84,0,8,724,61059
2019-03-02,60932,83,0,70,542,61627
2019-03-03,55869,92,0,7,675,56643
2019-03-04,48847,71,0,31,549,49498
2019-03-05,48741,78,0,21,606,49446
2019-03-06,47009,72,0,167,459,47707
2019-03-07,49671,94,0,5,690,50460
2019-03-08,59671,98,0,0,660,60429
2019-03-09,64839,71,0,56,556,65522
2019-03-10,59957,739,0,2,614,61312
2019-03-11,46478,121,0,16,575,47190
2019-03-12,46190,48,0,6,660,46904
2019-03-13,48091,61,0,55,460,48667
2019-03-14,49959,102,0,15,560,50636
2019-03-15,60491,71,0,7,680,61249
2019-03-16,66566,80,0,61,517,67224
2019-03-17,59198,100,0,3,837,60138
2019-03-18,48764,80,0,18,525,49387
2019-03-19,46842,77,0,1,933,47853
2019-03-20,49252,68,0,29,447,49796
2019-03-21,50779,74,0,15,522,51390
2019-03-22,61762,67,0,8,710,62547
2019-03-23,60508,61,0,114,567,61250
2019-03-24,61420,102,0,4,655,62181
2019-03-25,50270,120,0,9,488,50887
2019-03-26,44643,74,0,7,598,45322
2019-03-27,46771,54,0,51,501,47377
2019-03-28,51509,52,0,7,539,52107
2019-03-29,58962,87,0,13,658,59720
2019-03-30,60974,81,0,68,491,61614
2019-03-31,57969,84,0,5,1113,59171
2019-04-01,50076,70,1,38,1384,51569
2019-04-02,47203,102,0,23,1134,48462
2019-04-03,51443,69,11,13,1005,52541
2019-04-04,51499,49,0,38,907,52493
2019-04-05,57353,138,0,9,1024,58524
2019-04-06,66203,98,0,106,1353,67760
2019-04-07,60854,91,1,5,1208,62159
2019-04-08,47587,109,0,13,1727,49436
2019-04-09,48431,103,1,34,1423,49992
2019-04-10,51761,88,0,26,1120,52995
2019-04-11,56045,83,5,42,1051,57226
2019-04-12,60474,90,0,1,1208,61773
2019-04-13,70575,143,0,137,1177,72032
2019-04-14,68731,112,0,1,1327,70171
2019-04-15,59336,68,0,21,1368,60793
2019-04-16,56383,69,0,135,1326,57913
2019-04-17,61603,118,0,72,1162,62955
2019-04-18,86707,143,0,104,1179,88133
2019-04-19,93710,208,0,23,1091,95032
2019-04-20,62836,113,0,170,1320,64439
2019-04-21,49114,100,0,8,1087,50309
2019-04-22,85860,108,0,2,1830,87800
2019-04-23,66461,109,0,67,1689,68326
2019-04-24,60706,111,0,14,1380,62211
2019-04-25,63954,119,0,82,1495,65650
2019-04-26,71446,125,0,194,1397,73162
2019-04-27,77877,143,0,214,1792,80026
2019-04-28,63091,156,0,11,1951,65209
2019-04-29,57561,105,0,20,1804,59490
2019-04-30,68805,135,0,135,1610,70685
2019-05-01,57085,150,0,47,1201,58483
2019-05-02,52951,130,0,74,952,54107
2019-05-03,61350,115,1,62,1047,62575
2019-05-04,70329,99,0,80,1721,72229
2019-05-05,62909,79,0,2,1829,64819
2019-05-06,57432,66,0,8,1278,58784
2019-05-07,51627,109,24,57,1231,53048
2019-05-08,54960,102,0,25,1058,56145
2019-05-09,59070,75,0,57,2428,61630
2019-05-10,65321,111,0,131,1149,66712
2019-05-11,63529,166,0,71,1611,65377
2019-05-12,58605,368,0,17,1408,60398
2019-05-13,53868,93,0,0,1316,55277
2019-05-14,50165,57,0,55,1367,51644
2019-05-15,52468,74,0,35,996,53573
2019-05-16,56132,83,0,65,1027,57307
2019-05-17,63321,136,0,26,1081,64564
2019-05-18,65352,132,0,66,1375,66925
2019-05-19,59444,95,0,12,1565,61116
2019-05-20,55829,81,0,7,1734,57651
2019-05-21,53927,82,0,53,1490,55552
2019-05-22,52585,65,0,29,1057,53736
2019-05-23,53797,81,0,59,991,54928
2019-05-24,64677,136,0,42,968,65823
2019-05-25,66017,98,0,50,1218,67383
2019-05-26,55666,93,0,76,1092,56927
2019-05-27,51858,105,0,10,1131,53104
2019-05-28,52497,93,1,107,1144,53842
2019-05-29,56051,109,0,4,845,57009
2019-05-30,68330,114,4,57,838,69343
2019-05-31,62621,97,1,49,1083,63851
2019-06-01,70592,101,1,70,960,71724
2019-06-02,65239,117,0,18,1434,66808
2019-06-03,58154,85,0,7,1192,59438
2019-06-04,57538,73,0,64,1120,58795
2019-06-05,57541,89,0,43,1116,58789
2019-06-06,67459,181,1,67,1030,68738
2019-06-07,72111,131,0,43,988,73273
2019-06-08,86125,94,0,123,1136,87478
2019-06-09,74453,208,0,44,1129,75834
2019-06-10,62205,175,0,40,1115,63535
2019-06-11,56165,109,0,54,942,57270
2019-06-12,65042,77,8,71,1063,66261
2019-06-13,62195,107,0,91,1047,63440
2019-06-14,72741,109,0,43,1158,74051
2019-06-15,80916,169,0,110,1015,82210
2019-06-16,69459,112,42,46,1318,70977
2019-06-17,65215,154,0,38,1030,66437
2019-06-18,66233,155,0,70,1434,67892
2019-06-19,70896,103,0,50,1172,72221
2019-06-20,89507,180,0,124,1326,91137
2019-06-21,73334,170,0,69,934,74507
2019-06-22,82402,126,0,108,1158,83794
2019-06-23,82800,219,0,78,2011,85108
2019-06-24,79834,194,1,106,1735,81870
2019-06-25,77446,232,1,213,2517,80409
2019-06-26,64598,170,0,92,1522,66382
2019-06-27,67663,139,0,91,1369,69262
2019-06-28,76141,130,0,48,1440,77759
2019-06-29,92849,189,1,138,1362,94539
2019-06-30,72870,227,0,62,1857,75016
2019-07-01,71744,140,0,28,1288,73200
2019-07-02,63806,171,1,101,1514,65593
2019-07-03,66534,134,0,75,1163,67906
2019-07-04,66977,167,0,71,1521,68736
2019-07-05,79925,139,0,68,1031,81163
2019-07-06,89136,115,12,95,1349,90707
2019-07-07,75139,120,0,90,1703,77052
2019-07-08,67153,339,0,132,1201,68825
2019-07-09,65637,253,0,73,1202,67165
2019-07-10,72301,154,1,7,1353,73816
2019-07-11,65846,188,0,75,1127,67236
2019-07-12,81266,172,0,102,1221,82761
2019-07-13,85611,205,0,107,1179,87102
2019-07-14,82382,205,0,102,1543,84232
2019-07-15,74261,241,0,36,1081,75619
2019-07-16,67334,220,1,124,1293,68972
2019-07-17,73760,157,0,55,1066,75038
2019-07-18,81491,273,0,92,1458,83314
2019-07-19,84085,274,0,102,1190,85651
2019-07-20,106668,205,1,108,1281,108263
2019-07-21,98910,338,0,31,1462,100741
2019-07-22,80064,238,0,55,1002,81359
2019-07-23,67899,138,0,71,1266,69374
2019-07-24,69341,173,0,65,1234,70813
2019-07-25,75684,225,0,101,1553,77563
2019-07-26,90043,260,0,72,1479,91854
2019-07-27,88819,126,0,145,1160,90250
2019-07-28,79605,356,0,29,1652,81642
2019-07-29,88020,142,0,50,1240,89452
2019-07-30,78029,224,0,89,1373,79715
2019-07-31,75766,202,1,97,1400,77466
2019-08-01,76809,236,0,126,1435,78606
2019-08-02,94475,221,1,90,1224,96011
2019-08-03,109750,260,0,146,2108,112264
2019-08-04,85385,222,0,84,1525,87216
2019-08-05,91881,242,1,103,1264,93491
2019-08-06,63120,204,0,70,1239,64633
2019-08-07,77816,112,0,58,1080,79066
2019-08-08,85535,173,0,109,1327,87144
2019-08-09,88472,191,0,92,1257,90012
2019-08-10,126532,196,0,167,1411,128306
2019-08-11,94719,207,0,95,1434,96455
2019-08-12,100230,258,0,98,1045,101631
2019-08-13,75342,216,0,83,1245,76886
2019-08-14,94357,278,0,55,1281,95971
2019-08-15,89640,192,0,120,1224,91176
2019-08-16,99812,225,0,77,946,101060
2019-08-17,95947,172,0,91,1153,97363
2019-08-18,99079,229,0,57,1460,100825
2019-08-19,82737,161,0,119,1057,84074
2019-08-20,72319,133,0,73,336,72861
2019-08-21,73189,186,0,48,998,74421
2019-08-22,75974,135,0,75,1101,77285
2019-08-23,86354,114,0,51,1098,87617
2019-08-24,80593,197,2,112,824,81728
2019-08-25,75443,101,1,53,1336,76934
2019-08-26,70806,104,0,47,989,71946
2019-08-27,69026,117,0,133,1066,70342
2019-08-28,69887,141,0,80,1077,71185
2019-08-29,69056,127,0,69,1175,70427
2019-08-30,76731,135,0,90,1025,77981
2019-08-31,83437,172,0,74,1135,84818
2019-09-01,76854,145,0,50,1506,78555
2019-09-02,65525,149,0,57,952,66683
2019-09-03,63917,76,0,50,898,64941
2019-09-04,62788,84,0,49,793,63714
2019-09-05,64244,121,0,75,1076,65516
2019-09-06,72468,144,0,43,874,73529
2019-09-07,83383,158,0,98,1066,84705
2019-09-08,71779,103,1,36,1282,73201
2019-09-09,61753,124,0,9,963,62849
2019-09-10,60945,100,0,100,1021,62166
2019-09-11,55910,150,1,45,886,56992
2019-09-12,60083,98,0,66,985,61232
2019-09-13,72019,118,0,27,1088,73252
2019-09-14,75898,120,0,128,973,77119
2019-09-15,72941,131,0,31,1328,74431
2019-09-16,60721,102,0,32,822,61677
2019-09-17,56473,105,0,207,999,57784
2019-09-18,59131,78,1,43,978,60231
2019-09-19,62170,94,0,35,1127,63426
2019-09-20,70290,103,0,54,941,71388
2019-09-21,74650,106,0,393,1028,76177
2019-09-22,67217,126,0,69,1473,68885
2019-09-23,53580,144,0,13,1156,54893
2019-09-24,58395,93,0,131,1115,59734
2019-09-25,57456,113,1,12,714,58296
2019-09-26,62021,100,2,87,1148,63358
2019-09-27,64975,147,0,19,734,65875
2019-09-28,69351,111,0,136,1125,70723
2019-09-29,69583,180,0,44,1751,71558
2019-09-30,58791,84,0,12,1204,60091
2019-10-01,55660,71,0,196,1147,57074
2019-10-02,53987,119,0,8,1023,55137
2019-10-03,63764,78,0,34,1199,65075
2019-10-04,64006,98,0,53,852,65009
2019-10-05,68549,153,2,324,1063,70091
2019-10-06,70663,95,0,107,1950,72815
2019-10-07,65216,79,0,2,1416,66713
2019-10-08,85822,148,0,136,2205,88311
2019-10-09,48810,172,0,113,1438,50533
2019-10-10,62701,103,0,143,1257,64204
2019-10-11,62637,139,0,80,1094,63950
2019-10-12,70942,138,0,175,1562,72817
2019-10-13,72995,399,0,62,1913,75369
2019-10-14,54970,93,2,44,1430,56539
2019-10-15,53328,138,0,29,1677,55172
2019-10-16,51505,110,0,6,1299,52920
2019-10-17,54796,80,0,181,1110,56167
2019-10-18,61775,77,0,11,1234,63097
2019-10-19,69113,142,0,152,1580,70987
2019-10-20,63777,372,0,14,1638,65801
2019-10-21,51609,69,0,12,1716,53406
2019-10-22,49921,106,2,222,1775,52026
2019-10-23,49383,67,0,45,1344,50839
2019-10-24,53842,112,0,138,1273,55365
2019-10-25,64875,110,0,21,1827,66833
2019-10-26,69190,116,0,59,2757,72122
2019-10-27,70458,139,11,35,758,71401
2019-10-28,56506,110,1,2,671,57290
2019-10-29,55264,58,0,61,808,56191
2019-10-30,58670,95,0,4,527,59296
2019-10-31,68133,114,0,115,521,68883
2019-11-01,71757,68,0,19,645,72489
2019-11-02,77236,63,0,86,819,78204
2019-11-03,78678,163,0,39,894,79774
2019-11-04,59576,102,0,13,685,60376
2019-11-05,50446,122,0,66,760,51394
2019-11-06,53401,57,0,39,460,53957
2019-11-07,53315,69,0,44,594,54022
2019-11-08,60091,73,0,69,401,60634
2019-11-09,63135,165,0,84,489,63873
2019-11-10,57873,96,0,2,393,58364
2019-11-11,51468,88,0,30,364,51950
2019-11-12,48133,97,0,13,907,49150
2019-11-13,50210,85,0,2,481,50778
2019-11-14,52388,94,0,44,706,53232
2019-11-15,59882,67,0,78,663,60690
2019-11-16,64073,103,0,56,654,64886
2019-11-17,57120,95,0,11,781,58007
2019-11-18,51422,71,0,0,419,51912
2019-11-19,50816,53,0,22,643,51534
2019-11-20,51202,68,0,148,466,51884
2019-11-21,53616,94,0,3,632,54345
2019-11-22,61051,65,0,99,741,61956
2019-11-23,59971,70,0,76,528,60645
2019-11-24,58205,85,0,0,753,59043
2019-11-25,51197,142,0,30,441,51810
2019-11-26,47579,81,0,9,699,48368
2019-11-27,46973,41,0,74,591,47679
2019-11-28,51839,65,0,1,536,52441
2019-11-29,58852,154,0,28,638,59672
2019-11-30,61825,172,0,114,542,62653
2019-12-01,54632,140,0,1,771,55544
2019-12-02,46878,64,0,2,412,47356
2019-12-03,47320,89,0,1,571,47981
2019-12-04,50124,55,0,52,507,50738
2019-12-05,50561,68,0,53,526,51208
2019-12-06,59454,132,0,1,628,60215
2019-12-07,65974,374,0,80,625,67053
2019-12-08,56632,148,0,4,842,57626
2019-12-09,47011,101,0,0,392,47504
2019-12-10,43652,122,0,0,494,44268
2019-12-11,48186,96,0,33,469,48784
2019-12-12,49463,107,0,14,638,50222
2019-12-13,55926,180,0,0,721,56827
2019-12-14,71040,441,0,68,677,72226
2019-12-15,68104,458,0,0,917,69479
2019-12-16,52312,103,0,22,461,52898
2019-12-17,55663,134,0,1,734,56532
2019-12-18,59804,123,0,39,755,60721
2019-12-19,68428,202,0,3,931,69564
2019-12-20,84618,434,0,30,1129,86211
2019-12-21,102942,499,0,116,690,104247
2019-12-22,65202,199,0,0,904,66305
2019-12-23,75105,140,0,19,606,75870
2019-12-24,51499,132,0,35,636,52302
2019-12-25,39263,69,0,9,134,39475
2019-12-26,60244,205,0,4,310,60763
2019-12-27,72412,212,0,13,420,73057
2019-12-28,76767,342,0,62,309,77480
2019-12-29,69795,270,0,41,556,70662
2019-12-30,74482,138,0,4,437,75061
2019-12-31,46073,135,0,39,433,46680
2020-01-01,46357,17,0,2,1143,47519
2020-01-02,70046,654,0,6,984,71690
2020-01-03,70702,194,0,5,909,71810
2020-01-04,72343,270,0,100,511,73224
2020-01-05,70421,214,0,1,866,71502
2020-01-06,64605,145,0,0,708,65458
2020-01-07,47505,72,0,27,918,48522
2020-01-08,52354,95,0,41,590,53080
2020-01-09,53115,83,0,0,717,53915
2020-01-10,61451,117,0,6,716,62290
2020-01-11,68818,92,0,61,708,69679
2020-01-12,57081,193,0,15,965,58254
2020-01-13,45236,70,0,0,489,45795
2020-01-14,44884,58,0,6,552,45500
2020-01-15,46398,59,0,38,576,47071
2020-01-16,50330,86,0,4,803,51223
2020-01-17,51176,58,0,20,673,51927
2020-01-18,57483,69,0,35,560,58147
2020-01-19,46655,92,0,0,727,47474
2020-01-20,45930,57,0,0,324,46311
2020-01-21,43735,54,0,0,529,44318
2020-01-22,43064,67,0,46,541,43718
2020-01-23,47307,58,0,2,473,47840
2020-01-24,52360,70,0,9,600,53039
2020-01-25,56333,46,0,45,619,57043
2020-01-26,45181,64,0,0,796,46041
2020-01-27,40857,70,0,6,323,41256
2020-01-28,43972,53,0,2,499,44526
2020-01-29,41303,51,0,22,495,41871
2020-01-30,47983,51,0,2,642,48678
2020-01-31,50146,75,0,14,203,50438
2020-02-01,57523,55,0,59,539,58176
2020-02-02,49016,99,0,10,719,49844
2020-02-03,45961,82,0,47,311,46401
2020-02-04,41474,100,0,23,401,41998
2020-02-05,40752,85,0,20,504,41361
2020-02-06,43411,36,0,6,524,43977
2020-02-07,51805,59,0,11,237,52112
2020-02-08,56603,118,0,53,387,57161
2020-02-09,52527,70,0,11,642,53250
2020-02-10,45120,59,0,0,331,45510
2020-02-11,45329,57,0,6,620,46012
2020-02-12,45826,99,0,48,425,46398
2020-02-13,49164,100,0,8,583,49855
2020-02-14,53080,70,0,15,660,53825
2020-02-15,65751,85,0,53,582,66471
2020-02-16,58003,112,0,0,800,58915
2020-02-17,47443,137,0,31,380,47991
2020-02-18,45107,46,0,0,581,45734
2020-02-19,48243,70,0,44,485,48842
2020-02-20,50395,76,0,1,623,51095
2020-02-21,58799,105,0,2,680,59586
2020-02-22,58708,74,0,46,483,59311
2020-02-23,59294,83,0,4,652,60033
2020-02-24,46879,94,0,10,419,47402
2020-02-25,43699,62,0,1,666,44428
2020-02-26,40180,64,0,44,441,40729
2020-02-27,46345,79,0,17,580,47021
2020-02-28,50914,80,0,0,537,51531
2020-02-29,54360,80,0,52,487,54979
2020-03-01,48633,84,0,0,767,49484
2020-03-02,44047,73,0,0,426,44546
2020-03-03,39702,37,0,0,623,40362
2020-03-04,43198,52,0,68,441,43759
2020-03-05,46095,52,0,0,507,46654
2020-03-06,52760,68,0,4,567,53399
2020-03-07,52705,32,0,43,378,53158
2020-03-08,52636,52,0,0,913,53601
2020-03-09,44108,45,0,0,400,44553
2020-03-10,42423,53,0,3,536,43015
2020-03-11,41217,57,0,76,364,41714
2020-03-12,43654,74,0,38,500,44266
2020-03-13,39237,93,0,12,484,39826
2020-03-14,32381,275,0,0,323,32979
2020-03-15,13039,189,0,1,527,13756
2020-03-16,12009,16,0,4,282,12311
2020-03-17,8730,0,0,2,279,9011
2020-03-18,7354,5,0,7,199,7565
2020-03-19,6162,14,0,19,123,6318
2020-03-20,6167,0,0,0,112,6279
2020-03-21,3435,0,0,6,110,3551
2020-03-22,1909,0,0,1,140,2050
2020-03-23,3900,2,0,0,52,3954
2020-03-24,3385,0,0,18,53,3456
2020-03-25,3157,0,0,28,70,3255
2020-03-26,3888,17,0,0,22,3927
2020-03-27,3781,0,0,0,35,3816
2020-03-28,1988,0,0,0,52,2040
2020-03-29,679,0,0,43,1,723
2020-03-30,3564,0,0,0,22,3586
2020-03-31,3655,0,0,0,2,3657
2020-04-01,4364,0,0,3,44,4411
2020-04-02,4359,0,0,9,0,4368
2020-04-03,5343,4,0,0,0,5347
2020-04-04,2199,0,0,8,0,2207
2020-04-05,948,0,0,22,2,972
2020-04-06,3639,0,0,0,0,3639
2020-04-07,4481,0,0,0,0,4481
2020-04-08,4637,0,0,6,0,4643
2020-04-09,5202,17,0,1,12,5232
2020-04-10,4914,0,0,18,0,4932
2020-04-11,1227,0,0,0,0,1227
2020-04-12,318,0,0,0,0,318
2020-04-13,1093,0,0,0,0,1093
2020-04-14,4054,0,0,0,0,4054
2020-04-15,4645,0,0,0,0,4645
2020-04-16,4873,0,0,0,0,4873
2020-04-17,6076,0,0,0,2,6078
2020-04-18,2804,0,0,0,0,2804
2020-04-19,920,0,0,6,0,926
2020-04-20,5091,0,0,0,0,5091
2020-04-21,5219,0,0,1,0,5220
2020-04-22,5825,0,0,0,0,5825
2020-04-23,6083,0,0,7,0,6090
2020-04-24,7768,0,0,3,0,7771
2020-04-25,2994,24,0,0,0,3018
2020-04-26,1181,0,0,0,0,1181
2020-04-27,4303,0,0,32,0,4335
2020-04-28,6358,0,0,19,0,6377
2020-04-29,6840,22,0,18,0,6880
2020-04-30,10242,0,0,12,0,10254
2020-05-01,5664,0,0,0,0,5664
2020-05-02,2402,0,0,18,73,2493
2020-05-03,1932,0,0,0,0,1932
2020-05-04,7216,0,0,20,0,7236
2020-05-05,8083,0,0,7,0,8090
2020-05-06,7931,0,0,4,0,7935
2020-05-07,8524,0,0,2,0,8526
2020-05-08,11102,0,0,0,0,11102
2020-05-09,5142,0,0,12,0,5154
2020-05-10,2750,21,0,0,0,2771
2020-05-11,9361,27,0,0,1,9389
2020-05-12,9798,0,0,1,0,9799
2020-05-13,11325,0,0,8,0,11333
2020-05-14,12411,0,0,0,31,12442
2020-05-15,16278,0,0,0,1,16279
2020-05-16,11920,0,0,17,0,11937
2020-05-17,9829,0,0,8,4,9841
2020-05-18,15383,0,0,2,6,15391
2020-05-19,15816,2,0,1,0,15819
2020-05-20,23047,0,0,7,0,23054
2020-05-21,26550,0,6,8,1,26565
2020-05-22,22686,0,0,19,1,22706
2020-05-23,17972,8,0,29,3,18012
2020-05-24,17091,0,0,5,0,17096
2020-05-25,24477,0,0,141,8,24626
2020-05-26,24147,0,0,0,4,24151
2020-05-27,24467,0,0,16,10,24493
2020-05-28,28396,0,4,13,3,28416
2020-05-29,42271,0,0,6,93,42370
2020-05-30,38185,0,0,41,60,38286
2020-05-31,32444,0,0,17,38,32499
2020-06-01,41451,0,0,11,0,41462
2020-06-02,40667,0,0,9,78,40754
2020-06-03,43087,0,0,22,2,43111
2020-06-04,42280,0,0,0,64,42344
2020-06-05,48392,0,0,8,21,48421
2020-06-06,54600,0,8,40,210,54858
2020-06-07,44215,0,0,12,72,44299
2020-06-08,45511,0,0,33,0,45544
2020-06-09,44144,0,0,53,57,44254
2020-06-10,56384,0,0,25,9,56418
2020-06-11,67021,0,0,5,43,67069
2020-06-12,61926,0,0,3,19,61948
2020-06-13,56150,12,0,35,143,56340
2020-06-14,53063,0,0,0,76,53139
2020-06-15,45015,0,0,1,84,45100
2020-06-16,42628,0,0,2,105,42735
2020-06-17,45115,0,0,65,65,45245
2020-06-18,48887,0,0,11,89,48987
2020-06-19,58114,0,0,28,99,58241
2020-06-20,53592,1,0,32,364,53989
2020-06-21,34524,0,0,5,139,34668
2020-06-22,55457,30,0,37,68,55592
2020-06-23,40951,25,0,24,119,41119
2020-06-24,56562,27,0,1,152,56742
2020-06-25,26156,31,0,37,143,26367
2020-06-26,37299,29,0,9,101,37438
2020-06-27,24790,22,0,51,338,25201
2020-06-28,22421,13,0,21,234,22689
2020-06-29,21646,72,0,13,123,21854
2020-06-30,24644,36,0,32,116,24828
2020-07-01,38822,45,0,5,417,39289
2020-07-02,44789,142,0,14,270,45215
2020-07-03,57764,60,0,40,379,58243
2020-07-04,48024,74,0,45,772,48915
2020-07-05,47999,55,0,6,895,48955
2020-07-06,39508,44,0,45,400,39997
2020-07-07,39052,37,0,23,384,39496
2020-07-08,42730,51,0,10,362,43153
2020-07-09,44241,62,0,28,303,44634
2020-07-10,48768,52,0,11,422,49253
2020-07-11,47868,68,0,52,661,48649
2020-07-12,42619,96,0,13,814,43542
2020-07-13,37153,51,0,3,338,37545
2020-07-14,33831,78,0,30,431,34370
2020-07-15,39305,65,0,16,316,39702
2020-07-16,39842,42,0,64,413,40361
2020-07-17,47407,67,0,15,438,47927
2020-07-18,42527,69,0,37,734,43367
2020-07-19,37250,73,0,14,614,37951
2020-07-20,40039,62,5,40,398,40544
2020-07-21,39442,65,0,14,410,39931
2020-07-22,39514,100,0,17,373,40004
2020-07-23,41361,54,0,35,347,41797
2020-07-24,53339,39,0,44,536,53958
2020-07-25,53636,86,0,45,741,54508
2020-07-26,45585,36,0,21,836,46478
2020-07-27,43003,78,0,26,401,43508
2020-07-28,42540,40,0,36,459,43075
2020-07-29,45415,66,0,20,495,45996
2020-07-30,47677,26,0,36,409,48148
2020-07-31,57275,102,0,19,606,58002
2020-08-01,64157,89,0,48,1070,65364
2020-08-02,51220,71,0,25,938,52254
2020-08-03,46674,54,0,29,435,47192
2020-08-04,43876,84,0,34,560,44554
2020-08-05,46280,72,0,13,397,46762
2020-08-06,48356,77,0,46,494,48973
2020-08-07,52403,60,0,22,647,53132
2020-08-08,58999,85,0,66,997,60147
2020-08-09,54198,114,0,30,929,55271
2020-08-10,54022,26,0,9,393,54450
2020-08-11,47669,28,0,40,496,48233
2020-08-12,47710,112,0,30,418,48270
2020-08-13,53458,50,0,72,525,54105
2020-08-14,59473,69,0,20,627,60189
2020-08-15,53985,74,0,35,798,54892
2020-08-16,49820,69,0,30,740,50659
2020-08-17,46647,55,0,31,306,47039
2020-08-18,39267,43,0,19,369,39698
2020-08-19,41382,36,0,9,323,41750
2020-08-20,40878,42,0,18,351,41289
2020-08-21,46059,64,0,20,456,46599
2020-08-22,45246,42,0,27,604,45919
2020-08-23,47881,43,0,25,617,48566
2020-08-24,32873,64,0,39,225,33201
2020-08-25,34047,51,0,12,286,34396
2020-08-26,35944,57,0,12,292,36305
2020-08-27,39211,66,0,17,319,39613
2020-08-28,42042,60,0,39,365,42506
2020-08-29,40896,39,0,34,574,41543
2020-08-30,37015,62,0,11,530,37618
2020-08-31,33759,32,0,40,202,34033
2020-09-01,32551,45,0,9,194,32799
2020-09-02,34639,24,0,8,287,34958
2020-09-03,35541,36,0,22,195,35794
2020-09-04,37585,29,0,16,283,37913
2020-09-05,37607,33,0,31,424,38095
2020-09-06,33696,39,0,2,383,34120
2020-09-07,31453,16,0,11,203,31683
2020-09-08,32045,25,0,31,147,32248
2020-09-09,31534,28,0,13,118,31693
2020-09-10,35879,50,0,21,189,36139
2020-09-11,40478,36,0,11,262,40787
2020-09-12,36814,44,0,42,357,37257
2020-09-13,34923,20,0,5,267,35215
2020-09-14,33631,32,0,23,140,33826
2020-09-15,32507,48,0,21,178,32754
2020-09-16,32125,42,0,16,130,32313
2020-09-17,34792,21,0,32,208,35053
2020-09-18,39308,20,0,7,209,39544
2020-09-19,36925,16,0,35,360,37336
2020-09-20,32402,20,0,1,241,32664
2020-09-21,31923,27,0,11,174,32135
2020-09-22,30611,47,0,6,137,30801
2020-09-23,31017,26,0,32,187,31262
2020-09-24,33519,24,0,27,183,33753
2020-09-25,37395,36,0,5,246,37682
2020-09-26,35930,53,0,31,387,36401
2020-09-27,32218,31,0,2,281,32532
2020-09-28,29728,17,0,3,209,29957
2020-09-29,33438,41,0,24,134,33637
2020-09-30,35396,45,0,28,152,35621
2020-10-01,38356,37,0,43,189,38625
2020-10-02,42977,65,0,35,248,43325
2020-10-03,41154,30,0,30,451,41665
2020-10-04,35902,37,0,2,204,36145
2020-10-05,35410,31,0,0,163,35604
2020-10-06,33271,23,0,16,136,33446
2020-10-07,34492,49,0,13,93,34647
2020-10-08,38404,31,0,41,166,38642
2020-10-09,44637,33,0,17,215,44902
2020-10-10,41692,53,0,75,457,42277
2020-10-11,35925,40,0,2,209,36176
2020-10-12,35453,41,0,2,145,35641
2020-10-13,34730,14,0,37,169,34950
2020-10-14,34591,31,0,43,117,34782
2020-10-15,35262,36,0,33,168,35499
2020-10-16,40774,47,0,16,196,41033
2020-10-17,38518,37,0,39,400,38994
2020-10-18,33148,20,0,18,227,33413
2020-10-19,33062,18,0,2,181,33263
2020-10-20,32085,33,0,20,143,32281
2020-10-21,31455,23,0,41,98,31617
2020-10-22,34556,29,0,36,147,34768
2020-10-23,41535,27,0,9,300,41871
2020-10-24,36158,24,0,34,504,36720
2020-10-25,30745,39,0,19,133,30936
2020-10-26,31220,37,0,14,131,31402
2020-10-27,28407,27,0,0,0,28434
2020-10-28,30351,32,0,43,63,30489
2020-10-29,31348,25,0,8,54,31435
2020-10-30,42408,32,0,61,270,42771
2020-10-31,36974,29,0,41,136,37180
2020-11-01,33159,42,0,0,116,33317
2020-11-02,36001,34,0,4,112,36151
2020-11-03,32407,22,0,2,6,32437
2020-11-04,30598,21,0,33,55,30707
2020-11-05,30301,46,0,1,67,30415
2020-11-06,35956,30,0,0,112,36098
2020-11-07,30272,28,5,33,131,30469
2020-11-08,26614,24,0,3,62,26703
2020-11-09,28995,17,0,0,102,29114
2020-11-10,27778,18,0,0,1,27797
2020-11-11,28463,5,0,52,36,28556
2020-11-12,29283,16,0,4,51,29354
2020-11-13,35888,20,0,25,137,36070
2020-11-14,29809,29,0,29,67,29934
2020-11-15,24266,22,0,9,163,24460
2020-11-16,29076,10,0,3,110,29199
2020-11-17,27662,13,0,0,0,27675
2020-11-18,30791,21,0,48,106,30966
2020-11-19,28782,26,5,7,16,28836
2020-11-20,32808,18,0,0,118,32944
2020-11-21,27866,14,0,28,87,27995
2020-11-22,24528,18,0,0,68,24614
2020-11-23,27017,19,0,16,81,27133
2020-11-24,27149,35,0,13,2,27199
2020-11-25,29398,23,4,37,52,29514
2020-11-26,27527,21,8,22,23,27601
2020-11-27,34184,16,3,0,191,34394
2020-11-28,26304,25,0,37,69,26435
2020-11-29,23557,24,0,2,58,23641
2020-11-30,31582,17,0,0,105,31704
2020-12-01,14754,32,0,39,3,14828
2020-12-02,13527,14,0,22,54,13617
2020-12-03,13199,19,0,27,22,13267
2020-12-04,17704,10,0,6,194,17914
2020-12-05,9439,24,10,27,119,9619
2020-12-06,6915,13,0,0,48,6976
2020-12-07,13356,16,0,1,96,13469
2020-12-08,12083,11,0,3,0,12097
2020-12-09,13523,13,4,12,29,13581
2020-12-10,14776,12,0,19,24,14831
2020-12-11,19012,17,0,1,148,19178
2020-12-12,11645,24,0,29,140,11838
2020-12-13,7798,19,0,9,86,7912
2020-12-14,14107,9,0,0,117,14233
2020-12-15,16242,14,0,1,1,16258
2020-12-16,18669,32,0,27,64,18792
2020-12-17,20162,32,0,60,61,20315
2020-12-18,28643,54,0,11,216,28924
2020-12-19,30723,104,0,46,281,31154
2020-12-20,12901,30,0,18,314,13263
2020-12-21,17711,43,0,7,145,17906
2020-12-22,16586,48,0,7,53,16694
2020-12-23,21664,43,0,75,265,22047
2020-12-24,13125,28,0,1,26,13180
2020-12-25,5630,10,0,0,43,5683
2020-12-26,5257,18,0,0,36,5311
2020-12-27,6036,11,0,7,111,6165
2020-12-28,9151,11,0,0,50,9212
2020-12-29,10914,14,0,0,6,10934
2020-12-30,13071,28,0,29,68,13196
2020-12-31,8730,10,0,4,2,8746
2021-01-01,5361,11,0,0,0,5372
2021-01-02,7854,12,0,0,77,7943
2021-01-03,9813,36,0,0,116,9965
2021-01-04,13040,12,0,0,90,13142
2021-01-05,14240,21,0,6,0,14267
2021-01-06,11999,17,0,13,62,12091
2021-01-07,15588,6,0,7,130,15731
2021-01-08,17317,14,0,32,75,17438
2021-01-09,14409,10,0,19,64,14502
2021-01-10,12242,24,0,0,133,12399
2021-01-11,15967,13,0,3,81,16064
2021-01-12,15084,11,0,0,13,15108
2021-01-13,15643,16,0,60,27,15746
2021-01-14,15382,4,0,6,20,15412
2021-01-15,21223,8,0,11,197,21439
2021-01-16,13859,13,0,51,92,14015
2021-01-17,11060,9,0,6,101,11176
2021-01-18,15706,17,0,12,96,15831
2021-01-19,17037,9,0,18,4,17068
2021-01-20,17012,28,0,21,45,17106
2021-01-21,18045,23,0,5,1,18074
2021-01-22,20630,8,0,0,121,20759
2021-01-23,13782,6,0,39,52,13879
2021-01-24,9640,10,0,0,75,9725
2021-01-25,16090,6,0,0,53,16149
2021-01-26,16846,8,0,1,49,16904
2021-01-27,18318,19,0,37,80,18454
2021-01-28,20739,18,0,27,44,20828
2021-01-29,22385,6,0,41,126,22558
2021-01-30,14834,13,0,37,36,14920
2021-01-31,10002,11,0,0,86,10099
2021-02-01,17024,18,0,0,115,17157
2021-02-02,18243,8,0,10,0,18261
2021-02-03,17384,11,0,39,89,17523
2021-02-04,20574,12,0,5,36,20627
2021-02-05,26017,18,0,6,152,26193
2021-02-06,15585,12,0,60,45,15702
2021-02-07,11596,12,0,0,88,11696
2021-02-08,15994,13,0,3,133,16143
2021-02-09,18294,10,0,0,0,18304
2021-02-10,19133,12,0,33,64,19242
2021-02-11,21559,13,0,0,32,21604
2021-02-12,24956,12,0,0,249,25217
2021-02-13,15163,11,0,29,109,15312
2021-02-14,12590,10,0,0,131,12731
2021-02-15,19738,12,0,12,119,19881
2021-02-16,18972,22,0,7,6,19007
2021-02-17,20198,17,0,49,74,20338
2021-02-18,21349,25,0,28,41,21443
2021-02-19,26973,29,0,1,171,27174
2021-02-20,17780,13,0,34,92,17919
2021-02-21,14424,10,0,0,140,14574
2021-02-22,20324,10,0,0,118,20452
2021-02-23,20123,20,0,9,2,20154
2021-02-24,21496,25,0,65,77,21663
2021-02-25,22705,21,0,0,31,22757
2021-02-26,29044,22,0,17,158,29241
2021-02-27,18164,17,0,34,100,18315
2021-02-28,14505,8,0,0,119,14632
2021-03-01,20665,22,0,2,139,20828
2021-03-02,20998,24,0,9,2,21033
2021-03-03,21619,29,0,38,91,21777
2021-03-04,23844,17,0,23,48,23932
2021-03-05,27985,19,0,13,228,28245
2021-03-06,17251,11,0,35,97,17394
2021-03-07,13633,11,0,11,136,13791
2021-03-08,20878,11,0,0,153,21042
2021-03-09,20068,18,0,0,32,20118
2021-03-10,20639,17,0,78,75,20809
2021-03-11,22206,16,0,7,100,22329
2021-03-12,29228,20,0,0,353,29601
2021-03-13,15620,17,0,70,140,15847
2021-03-14,9692,7,0,0,167,9866
2021-03-15,18975,21,0,13,202,19211
2021-03-16,20660,22,0,6,29,20717
2021-03-17,20304,14,0,31,104,20453
2021-03-18,23247,18,0,2,101,23368
2021-03-19,27404,25,0,6,202,27637
2021-03-20,17569,19,0,30,184,17802
2021-03-21,11786,9,0,0,157,11952
2021-03-22,19601,6,0,0,180,19787
2021-03-23,19505,16,0,10,11,19542
2021-03-24,21372,18,0,37,110,21537
2021-03-25,22256,23,0,2,113,22394
2021-03-26,31536,30,0,10,275,31851
2021-03-27,28366,47,0,32,215,28660
2021-03-28,14383,30,0,11,284,14708
2021-03-29,19563,23,0,5,218,19809
2021-03-30,22415,33,0,17,34,22499
2021-03-31,30133,76,0,57,206,30472
2021-04-01,38560,47,0,10,386,39003
2021-04-02,37468,33,0,14,366,37881
2021-04-03,14458,20,0,31,301,14810
2021-04-04,9929,3,0,1,146,10079
2021-04-05,21828,9,0,0,318,22155
2021-04-06,23426,11,0,0,13,23450
2021-04-07,23314,19,0,14,149,23496
2021-04-08,24823,16,0,3,193,25035
2021-04-09,31416,13,0,0,155,31584
2021-04-10,24496,23,0,32,542,25093
2021-04-11,19000,11,0,0,365,19376
2021-04-12,21044,20,0,0,316,21380
2021-04-13,20708,10,0,0,160,20878
2021-04-14,22507,24,0,47,338,22916
2021-04-15,24157,25,0,5,341,24528
2021-04-16,30457,20,0,12,219,30708
2021-04-17,19878,12,0,29,266,20185
2021-04-18,14985,14,0,0,185,15184
2021-04-19,21520,10,0,6,224,21760
2021-04-20,21319,14,0,4,9,21346
2021-04-21,22892,13,0,44,99,23048
2021-04-22,23854,28,0,1,365,24248
2021-04-23,31524,20,0,7,201,31752
2021-04-24,23160,24,0,81,288,23553
2021-04-25,18496,18,0,2,161,18677
2021-04-26,21152,16,0,2,264,21434
2021-04-27,19758,23,0,5,17,19803
2021-04-28,24831,17,0,13,138,24999
2021-04-29,28477,30,0,1,176,28684
2021-04-30,37543,29,0,7,330,37909
2021-05-01,19393,16,0,32,420,19861
2021-05-02,17748,14,0,0,205,17967
2021-05-03,24346,35,0,0,178,24559
2021-05-04,24746,25,0,11,25,24807
2021-05-05,25767,19,0,18,196,26000
2021-05-06,26979,14,0,13,133,27139
2021-05-07,34653,27,0,0,223,34903
2021-05-08,26210,35,0,37,378,26660
2021-05-09,21674,15,0,6,173,21868
2021-05-10,24384,14,0,8,176,24582
2021-05-11,26050,21,0,24,3,26098
2021-05-12,33678,50,0,34,296,34058
2021-05-13,38880,34,0,17,219,39150
2021-05-14,33400,35,0,7,241,33683
2021-05-15,26261,43,0,80,399,26783
2021-05-16,29408,11,0,0,249,29668
2021-05-17,25712,22,0,12,174,25920
2021-05-18,25564,31,0,3,59,25657
2021-05-19,26918,52,0,27,208,27205
2021-05-20,28857,44,0,2,213,29116
2021-05-21,44458,35,0,27,328,44848
2021-05-22,36274,26,0,35,506,36841
2021-05-23,25938,37,0,30,220,26225
2021-05-24,28811,25,0,12,244,29092
2021-05-25,26802,19,0,1,102,26924
2021-05-26,27154,31,0,41,281,27507
2021-05-27,30052,33,0,20,244,30349
2021-05-28,37404,54,0,14,362,37834
2021-05-29,32724,39,0,64,587,33414
2021-05-30,27352,28,0,6,263,27649
2021-05-31,28305,29,0,8,261,28603
2021-06-01,29637,32,0,0,179,29848
2021-06-02,43199,36,64,393,592,44284
2021-06-03,43876,62,96,203,355,44592
2021-06-04,38348,31,38,313,358,39088
2021-06-05,34949,37,61,694,678,36419
2021-06-06,39645,33,183,671,657,41189
2021-06-07,33185,48,0,3,429,33665
2021-06-08,31520,29,0,6,224,31779
2021-06-09,33181,41,0,37,440,33699
2021-06-10,34925,53,0,0,348,35326
2021-06-11,46863,38,0,9,487,47397
2021-06-12,37027,48,0,59,650,37784
2021-06-13,33372,24,0,1,666,34063
2021-06-14,35488,50,0,0,429,35967
2021-06-15,33964,32,0,5,295,34296
2021-06-16,37312,30,0,35,606,37983
2021-06-17,40934,36,0,1,306,41277
2021-06-18,47995,48,0,17,366,48426
2021-06-19,44024,46,0,35,896,45001
2021-06-20,46073,35,0,6,617,46731
2021-06-21,39815,54,0,13,445,40327
2021-06-22,45216,33,0,62,354,45665
2021-06-23,39452,43,0,37,769,40301
2021-06-24,47682,50,0,40,593,48365
2021-06-25,51668,44,0,17,642,52371
2021-06-26,49587,32,0,43,972,50634
2021-06-27,49108,31,0,15,1062,50216
2021-06-28,40320,45,0,14,559,40938
2021-06-29,39153,37,0,29,936,40155
2021-06-30,42555,65,0,4,1019,43643
2021-07-01,46400,67,0,40,810,47317
2021-07-02,59193,53,0,52,841,60139
2021-07-03,56960,87,0,64,1166,58277
2021-07-04,51725,77,0,17,1277,53096
2021-07-05,42056,57,0,5,786,42904
2021-07-06,41425,43,0,68,758,42294
2021-07-07,40647,49,0,30,926,41652
2021-07-08,49358,44,0,46,620,50068
2021-07-09,60728,73,0,4,971,61776
2021-07-10,59628,58,0,56,1046,60788
2021-07-11,52023,75,0,24,1329,53451
2021-07-12,47951,56,0,30,708,48745
2021-07-13,46488,64,0,43,705,47300
2021-07-14,52926,70,0,4,956,53956
2021-07-15,53578,104,1,57,749,54489
2021-07-16,68418,70,0,16,1174,69678
2021-07-17,52249,131,0,46,1311,53737
2021-07-18,59962,60,0,47,1219,61288
2021-07-19,51713,48,6,27,945,52739
2021-07-20,53390,95,0,50,867,54402
2021-07-21,52821,55,0,34,878,53788
2021-07-22,59883,52,1,80,850,60866
2021-07-23,62106,61,0,24,1200,63391
2021-07-24,69198,96,0,90,1188,70572
2021-07-25,65326,63,0,25,1445,66859
2021-07-26,54227,52,0,17,718,55014
2021-07-27,50337,61,0,71,1005,51474
2021-07-28,52341,76,3,21,949,53390
2021-07-29,61470,66,0,78,934,62548
2021-07-30,78607,81,0,33,1366,80087
2021-07-31,75871,118,0,73,1382,77444
2021-08-01,77937,75,0,58,1254,79324
2021-08-02,73238,96,0,21,1103,74458
2021-08-03,59867,110,0,53,927,60957
2021-08-04,58130,87,0,0,976,59193
2021-08-05,69472,67,0,51,865,70455
2021-08-06,73777,59,0,63,1284,75183
2021-08-07,73440,87,0,100,1275,74902
2021-08-08,74305,119,0,57,1590,76071
2021-08-09,69872,83,0,39,940,70934
2021-08-10,63706,73,12,58,641,64490
2021-08-11,61253,82,0,33,1005,62373
2021-08-12,65277,74,0,63,772,66186
2021-08-13,71376,90,4,38,1111,72619
2021-08-14,70612,85,5,72,933,71707
2021-08-15,71822,80,0,55,1194,73151
2021-08-16,72344,43,8,25,838,73258
2021-08-17,64483,47,10,22,646,65208
2021-08-18,58804,73,8,13,774,59672
2021-08-19,62463,52,9,36,626,63186
2021-08-20,70274,90,6,17,987,71374
2021-08-21,70455,89,0,41,1032,71617
2021-08-22,65834,90,0,33,1182,67139
2021-08-23,60111,59,0,21,722,60913
2021-08-24,54546,68,0,21,545,55180
2021-08-25,54684,75,6,11,783,55559
2021-08-26,55444,46,0,51,660,56201
2021-08-27,63494,91,0,38,945,64568
2021-08-28,61300,72,0,52,934,62358
2021-08-29,58046,79,0,15,989,59129
2021-08-30,54273,54,0,33,916,55276
2021-08-31,50095,65,0,20,624,50804
2021-09-01,48975,60,0,1,781,49817
2021-09-02,53439,60,0,37,551,54087
2021-09-03,61924,86,0,46,895,62951
2021-09-04,61801,91,0,60,814,62766
2021-09-05,54645,100,0,27,1134,55906
2021-09-06,47143,80,0,26,721,47970
2021-09-07,44466,53,0,50,504,45073
2021-09-08,48704,53,16,2,679,49454
2021-09-09,48179,70,0,37,694,48980
2021-09-10,58078,56,2,15,769,58920
2021-09-11,56163,79,0,71,864,57177
2021-09-12,54415,95,0,12,1052,55574
2021-09-13,45208,57,0,48,872,46185
2021-09-14,46504,58,0,32,593,47187
2021-09-15,43021,69,0,39,667,43796
2021-09-16,49937,70,0,56,502,50565
2021-09-17,53757,89,0,22,856,54724
2021-09-18,52073,73,0,76,755,52977
2021-09-19,48514,44,0,5,1046,49609
2021-09-20,48341,59,0,11,824,49235
2021-09-21,42502,55,0,97,627,43281
2021-09-22,42736,63,0,2,603,43404
2021-09-23,45230,62,0,57,595,45944
2021-09-24,55181,49,0,13,984,56227
2021-09-25,50462,38,0,35,935,51470
2021-09-26,54905,100,0,12,1040,56057
2021-09-27,38594,92,0,1,1046,39733
2021-09-28,38905,53,0,79,704,39741
2021-09-29,38513,86,0,0,768,39367
2021-09-30,42692,50,0,31,679,43452
2021-10-01,47089,74,1,28,1059,48251
2021-10-02,46601,38,0,72,942,47653
2021-10-03,47947,67,0,11,1160,49185
2021-10-04,40822,63,14,0,677,41576
2021-10-05,35393,72,0,2,618,36085
2021-10-06,36688,30,1,81,703,37503
2021-10-07,37467,19,0,3,761,38250
2021-10-08,50045,63,0,4,942,51054
2021-10-09,48754,93,1,58,1015,49921
2021-10-10,42207,45,0,25,1132,43409
2021-10-11,39395,23,0,13,1338,40769
2021-10-12,41147,66,0,2,657,41872
2021-10-13,37477,29,0,54,718,38278
2021-10-14,38746,34,0,0,679,39459
2021-10-15,49502,49,0,47,1072,50670
2021-10-16,47417,61,0,57,1164,48699
2021-10-17,46050,83,0,5,1120,47258
2021-10-18,37142,41,0,7,1075,38265
2021-10-19,37900,56,0,2,677,38635
2021-10-20,38848,64,0,63,744,39719
2021-10-21,41050,54,0,27,749,41880
2021-10-22,50573,54,1,39,1029,51696
2021-10-23,48125,58,0,34,1110,49327
2021-10-24,44840,51,1,1,1069,45962
2021-10-25,40398,26,0,0,1095,41519
2021-10-26,36661,25,0,29,625,37340
2021-10-27,40642,55,0,53,821,41571
2021-10-28,47080,62,0,33,857,48032
2021-10-29,58908,63,0,12,1108,60091
2021-10-30,53872,75,0,137,1371,55455
2021-10-31,51078,31,0,14,565,51688
2021-11-01,59780,102,0,12,545,60439
2021-11-02,50411,59,0,3,1322,51795
2021-11-03,41776,33,0,24,601,42434
2021-11-04,39429,57,0,28,722,40236
2021-11-05,46680,47,0,0,607,47334
2021-11-06,41396,42,0,42,664,42144
2021-11-07,37796,46,0,40,764,38646
2021-11-08,34910,58,0,0,520,35488
2021-11-09,33749,56,0,0,268,34073
2021-11-10,36170,51,0,37,398,36656
2021-11-11,38883,31,0,38,641,39593
2021-11-12,44818,60,0,7,773,45658
2021-11-13,41443,44,0,28,612,42127
2021-11-14,36154,46,0,8,805,37013
2021-11-15,33155,22,0,3,379,33559
2021-11-16,32424,44,0,0,335,32803
2021-11-17,37870,50,2,28,396,38346
2021-11-18,43242,60,0,31,561,43894
2021-11-19,42364,27,0,10,546,42947
2021-11-20,39131,47,0,29,522,39729
2021-11-21,44474,74,0,7,971,45526
2021-11-22,33457,33,0,2,834,34326
2021-11-23,31427,21,0,38,230,31716
2021-11-24,34475,28,0,23,343,34869
2021-11-25,39294,50,0,39,409,39792
2021-11-26,42792,45,0,4,399,43240
2021-11-27,32963,42,0,28,649,33682
2021-11-28,31370,31,0,0,569,31970
2021-11-29,33090,29,0,10,398,33527
2021-11-30,33131,25,0,12,251,33419
2021-12-01,32369,32,0,17,336,32754
2021-12-02,36190,47,0,16,376,36629
2021-12-03,43738,60,0,0,509,44307
2021-12-04,38174,47,0,48,544,38813
2021-12-05,30871,25,0,43,613,31552
2021-12-06,33515,55,0,0,436,34006
2021-12-07,35870,22,0,9,219,36120
2021-12-08,35635,39,0,22,338,36034
2021-12-09,32236,35,0,36,669,32976
2021-12-10,42607,53,0,0,547,43207
2021-12-11,39317,41,0,26,687,40071
2021-12-12,36824,62,0,0,702,37588
2021-12-13,34158,19,0,0,669,34846
2021-12-14,34726,29,0,0,415,35170
2021-12-15,38795,71,0,39,715,39620
2021-12-16,41683,52,0,65,771,42571
2021-12-17,51382,31,0,4,731,52148
2021-12-18,56912,128,0,52,845,57937
2021-12-19,49267,121,0,0,1030,50418
2021-12-20,43300,82,0,6,769,44157
2021-12-21,44183,90,0,2,699,44974
2021-12-22,58488,102,0,45,805,59440
2021-12-23,76028,129,0,42,1057,77256
2021-12-24,47076,130,0,33,662,47901
2021-12-25,25316,36,0,0,87,25439
2021-12-26,38613,112,0,4,311,39040
2021-12-27,47814,78,0,1,501,48394
2021-12-28,47474,58,0,28,505,48065
2021-12-29,44594,61,0,16,406,45077
2021-12-30,52655,48,0,36,461,53200
2021-12-31,34175,53,0,11,188,34427
2022-01-01,31506,29,0,2,231,31768
2022-01-02,56700,91,0,0,733,57524
2022-01-03,44526,70,0,1,659,45256
2022-01-04,44999,75,0,1,520,45595
2022-01-05,46637,59,0,14,460,47170
2022-01-06,43247,32,0,0,473,43752
2022-01-07,46102,39,0,35,548,46724
2022-01-08,57806,88,0,23,805,58722
2022-01-09,52908,70,0,12,865,53855
2022-01-10,37700,31,0,5,504,38240
2022-01-11,32006,41,0,0,353,32400
2022-01-12,33747,40,0,23,297,34107
2022-01-13,34145,43,0,52,347,34587
2022-01-14,40716,49,0,12,303,41080
2022-01-15,39412,49,0,29,450,39940
2022-01-16,40363,33,0,0,483,40879
2022-01-17,33110,42,0,5,264,33421
2022-01-18,32175,28,0,0,151,32354
2022-01-19,32683,36,0,35,248,33002
2022-01-20,34613,38,0,26,240,34917
2022-01-21,39672,59,0,0,345,40076
2022-01-22,36891,18,0,30,482,37421
2022-01-23,35375,65,0,0,348,35788
2022-01-24,31194,44,0,12,246,31496
2022-01-25,29898,72,0,52,147,30169
2022-01-26,32036,26,0,13,170,32245
2022-01-27,34410,42,0,35,274,34761
2022-01-28,38574,45,0,4,319,38942
2022-01-29,37550,73,0,40,465,38128
2022-01-30,36278,20,0,1,366,36665
2022-01-31,31356,31,0,0,347,31734
2022-02-01,33045,37,0,2,175,33259
2022-02-02,32301,56,0,25,213,32595
2022-02-03,37203,49,0,0,379,37631
2022-02-04,41113,57,0,1,317,41488
2022-02-05,44296,45,0,35,515,44891
2022-02-06,39532,58,0,17,376,39983
2022-02-07,33392,40,0,0,393,33825
2022-02-08,30762,34,0,23,149,30968
2022-02-09,36169,57,0,17,237,36480
2022-02-10,38984,55,0,12,327,39378
2022-02-11,42989,60,0,0,535,43584
2022-02-12,45144,77,0,32,522,45775
2022-02-13,45922,142,0,3,512,46579
2022-02-14,37184,43,0,15,460,37702
2022-02-15,35742,39,0,0,213,35994
2022-02-16,36115,33,0,30,277,36455
2022-02-17,41555,35,0,6,366,41962
2022-02-18,46032,82,0,15,484,46613
2022-02-19,46256,44,0,47,529,46876
2022-02-20,44194,59,0,0,768,45021
2022-02-21,41300,48,0,12,421,41781
2022-02-22,39277,35,0,30,278,39620
2022-02-23,41620,29,0,33,313,41995
2022-02-24,45170,21,0,21,634,45846
2022-02-25,56393,61,0,17,596,57067
2022-02-26,52374,96,0,54,752,53276
2022-02-27,50183,75,0,0,873,51131
2022-02-28,37581,27,0,0,700,38308
2022-03-01,40085,44,0,1,281,40411
2022-03-02,36306,36,0,31,330,36703
2022-03-03,40518,24,0,17,478,41037
2022-03-04,47468,50,0,8,636,48162
2022-03-05,47756,61,0,41,398,48256
2022-03-06,42682,90,0,2,666,43440
2022-03-07,38405,16,10,1,675,39107
2022-03-08,33854,20,0,22,424,34320
2022-03-09,35425,42,0,21,398,35886
2022-03-10,39329,61,0,24,589,40003
2022-03-11,44408,32,0,12,556,45008
2022-03-12,46116,30,0,31,637,46814
2022-03-13,45449,47,0,2,694,46192
2022-03-14,36813,61,0,2,679,37555
2022-03-15,37060,21,0,11,366,37458
2022-03-16,35534,43,0,63,410,36050
2022-03-17,41368,49,0,20,479,41916
2022-03-18,43653,56,0,10,531,44250
2022-03-19,47907,20,0,45,552,48524
2022-03-20,44257,32,0,0,687,44976
2022-03-21,36118,35,0,2,687,36842
2022-03-22,34104,47,0,27,353,34531
2022-03-23,35518,13,0,45,461,36037
2022-03-24,38028,32,0,2,573,38635
2022-03-25,47888,43,0,7,589,48527
2022-03-26,46112,61,0,63,668,46904
2022-03-27,45284,34,0,0,1206,46524
2022-03-28,34488,35,0,2,1303,35828
2022-03-29,34741,48,0,11,697,35497
2022-03-30,35167,52,0,39,836,36094
2022-03-31,39698,13,0,0,1041,40752
2022-04-01,42985,63,0,5,898,43951
2022-04-02,44217,21,0,34,1317,45589
2022-04-03,39066,63,0,0,1450,40579
2022-04-04,37702,28,0,1,1274,39005
2022-04-05,35204,47,0,33,1021,36305
2022-04-06,37657,26,0,29,756,38468
2022-04-07,42176,44,0,22,1047,43289
2022-04-08,48177,29,0,3,1348,49557
2022-04-09,57888,44,0,56,1522,59510
2022-04-10,51390,62,0,7,1824,53283
2022-04-11,43915,70,0,0,1225,45210
2022-04-12,44724,23,0,8,1111,45866
2022-04-13,50444,77,1,47,1151,51720
2022-04-14,71920,83,0,40,1435,73478
2022-04-15,69187,88,0,26,1472,70773
2022-04-16,48812,43,1,39,1510,50405
2022-04-17,39767,89,0,0,1174,41030
2022-04-18,78767,46,0,137,1598,80548
2022-04-19,57485,77,1,26,1334,58923
2022-04-20,54805,30,1,36,1156,56028
2022-04-21,53065,53,0,15,1550,54683
2022-04-22,60891,42,0,0,1326,62259
2022-04-23,62815,32,1,142,2138,65128
2022-04-24,55720,22,0,1,2347,58090
2022-04-25,46191,60,0,3,1540,47794
2022-04-26,46393,51,0,25,1026,47495
2022-04-27,42757,73,0,50,879,43759
2022-04-28,46678,9,0,7,1153,47847
2022-04-29,62052,55,0,11,1282,63400
2022-04-30,58610,37,0,178,1592,60417
2022-05-01,52496,75,0,11,1393,53975
2022-05-02,42614,30,0,7,1074,43725
2022-05-03,41151,24,0,33,881,42089
2022-05-04,41014,32,0,67,965,42078
2022-05-05,47818,41,1,18,982,48860
2022-05-06,55477,24,0,8,1476,56985
2022-05-07,55077,34,0,93,1300,56504
2022-05-08,54754,15,0,5,1739,56513
2022-05-09,45669,20,0,4,1061,46754
2022-05-10,44739,7,0,6,929,45681
2022-05-11,45383,22,0,66,929,46400
2022-05-12,49145,70,0,20,1123,50358
2022-05-13,55641,127,0,13,1300,57081
2022-05-14,57859,31,1,75,1536,59502
2022-05-15,60022,83,0,6,1926,62037
2022-05-16,45001,47,0,9,1177,46234
2022-05-17,44789,31,0,56,1206,46082
2022-05-18,44658,73,0,8,954,45693
2022-05-19,49165,65,0,107,1103,50440
2022-05-20,54686,101,0,52,1185,56024
2022-05-21,59041,48,0,144,1410,60643
2022-05-22,61234,154,0,15,2196,63599
2022-05-23,47116,26,0,9,1245,48396
2022-05-24,44947,46,0,53,1112,46158
2022-05-25,52257,53,0,140,955,53405
2022-05-26,65994,32,0,49,964,67039
2022-05-27,55030,35,1,27,1192,56285
2022-05-28,52778,46,0,90,1182,54096
2022-05-29,55098,57,0,2,1631,56788
2022-05-30,73262,72,13,87,1736,75170
2022-05-31,46378,52,0,98,1770,48298
2022-06-01,49037,43,0,14,973,50067
2022-06-02,52218,13,0,90,887,53208
2022-06-03,59965,25,0,14,1470,61474
2022-06-04,62036,40,0,66,1400,63542
2022-06-05,66357,66,1,19,1880,68323
2022-06-06,62189,25,0,25,1236,63475
2022-06-07,45786,11,0,50,857,46704
2022-06-08,46232,69,0,41,1106,47448
2022-06-09,52185,24,0,42,979,53230
2022-06-10,59941,39,0,25,1352,61357
2022-06-11,63456,22,1,96,1323,64898
2022-06-12,62581,67,0,22,1920,64590
2022-06-13,53648,37,1,65,935,54686
2022-06-14,47984,23,0,74,1198,49279
2022-06-15,67024,29,0,44,1065,68162
2022-06-16,75861,103,0,92,1203,77259
2022-06-17,61952,35,1,48,1393,63429
2022-06-18,65885,17,0,76,1170,67148
2022-06-19,75616,9,0,38,2337,78000
2022-06-20,51556,14,0,50,1367,52987
2022-06-21,50133,30,0,70,1258,51491
2022-06-22,64191,43,1,62,1585,65882
2022-06-23,53916,16,0,73,1476,55481
2022-06-24,64235,50,0,52,1166,65503
2022-06-25,68693,20,2,48,1621,70384
2022-06-26,71055,41,0,81,2701,73878
2022-06-27,56070,29,0,92,2087,58278
2022-06-28,47406,54,0,85,1638,49183
2022-06-29,50298,37,1,24,1615,51975
2022-06-30,54191,53,0,78,1514,55836
2022-07-01,60846,65,0,68,1322,62301
2022-07-02,66454,138,3,128,1466,68189
2022-07-03,67187,72,6,60,2080,69405
2022-07-04,59353,33,0,29,1422,60837
2022-07-05,52317,35,0,53,1320,53725
2022-07-06,49687,81,0,65,1261,51094
2022-07-07,56780,45,0,55,1246,58126
2022-07-08,78701,130,1,113,1174,80119
2022-07-09,70371,102,1,83,1374,71931
2022-07-10,64978,189,0,45,1870,67082
2022-07-11,56323,75,0,46,1231,57675
2022-07-12,58437,94,0,73,1263,59867
2022-07-13,60846,95,1,55,1349,62346
2022-07-14,68382,43,0,90,1278,69793
2022-07-15,72173,97,1,92,1350,73713
2022-07-16,77275,101,0,89,1534,78999
2022-07-17,70090,107,0,35,1832,72064
2022-07-18,58154,128,0,48,1079,59409
2022-07-19,52573,50,0,74,1195,53892
2022-07-20,63454,43,0,55,1363,64915
2022-07-21,60341,21,0,93,1326,61781
2022-07-22,71547,141,0,87,1396,73171
2022-07-23,84061,381,0,129,1389,85960
2022-07-24,66135,88,0,85,1770,68078
2022-07-25,62455,21,0,75,1105,63656
2022-07-26,62646,40,0,78,1338,64102
2022-07-27,64415,105,0,72,1414,66006
2022-07-28,66065,53,0,127,2891,69136
2022-07-29,86265,57,0,83,3277,89682
2022-07-30,79489,195,1,162,2966,82813
2022-07-31,84661,149,0,80,3490,88380
2022-08-01,72227,56,0,121,2411,74815
2022-08-02,70610,32,0,91,2620,73353
2022-08-03,64365,129,0,77,2245,66816
2022-08-04,70408,134,0,113,2160,72815
2022-08-05,81694,145,0,112,2957,84908
2022-08-06,87276,125,0,119,2907,90427
2022-08-07,83246,141,0,59,3592,87038
2022-08-08,72230,73,0,76,2620,74999
2022-08-09,65492,106,0,69,2708,68375
2022-08-10,71757,85,1,26,2505,74374
2022-08-11,68658,90,0,90,2633,71471
2022-08-12,81909,146,0,64,3104,85223
2022-08-13,74644,158,0,163,2694,77659
2022-08-14,77615,131,0,112,3193,81051
2022-08-15,78113,196,0,87,2836,81232
2022-08-16,74123,117,0,47,2378,76665
2022-08-17,69439,113,1,58,2690,72301
2022-08-18,63650,92,0,78,2266,66086
2022-08-19,66166,204,0,60,2468,68898
2022-08-20,72377,216,0,92,2423,75108
2022-08-21,69715,125,0,43,2889,72772
2022-08-22,66282,122,0,41,2194,68639
2022-08-23,51656,109,0,77,2116,53958
2022-08-24,53721,83,0,51,1987,55842
2022-08-25,62598,28,0,151,2076,64853
2022-08-26,68001,107,0,85,2981,71174
2022-08-27,65970,109,0,101,2606,68786
2022-08-28,67409,136,0,53,3068,70666
2022-08-29,55053,70,0,43,2384,57550
2022-08-30,52545,71,0,72,2266,54954
2022-08-31,43267,50,0,73,2891,46281
2022-09-01,57140,155,2,64,2553,59914
2022-09-02,61934,80,0,93,2696,64803
2022-09-03,70979,150,0,135,2734,73998
2022-09-04,62364,72,0,59,3342,65837
2022-09-05,46721,76,0,14,2300,49111
2022-09-06,47675,116,0,122,2144,50057
2022-09-07,46249,120,0,24,3018,49411
2022-09-08,50115,68,1,74,2104,52362
2022-09-09,52169,47,0,45,2769,55030
2022-09-10,59413,64,0,152,2861,62490
2022-09-11,61725,130,0,46,2998,64899
2022-09-12,47245,87,0,19,2635,49986
2022-09-13,41162,148,0,82,2375,43767
2022-09-14,40875,68,0,61,2180,43184
2022-09-15,51544,226,0,26,2528,54324
2022-09-16,51859,84,0,18,1292,53253
2022-09-17,58598,110,0,82,2757,61547
2022-09-18,55116,139,0,45,3683,58983
2022-09-19,47446,159,0,57,1212,48874
2022-09-20,43031,80,0,272,2426,45809
2022-09-21,43517,30,1,30,2194,45772
2022-09-22,45242,67,0,137,2596,48042
2022-09-23,56608,85,0,37,3818,60548
2022-09-24,58507,93,0,222,3125,61947
2022-09-25,57838,167,0,101,4256,62362
2022-09-26,45399,391,0,50,3250,49090
2022-09-27,41353,72,0,48,2936,44409
2022-09-28,42619,54,0,54,2471,45198
2022-09-29,45517,88,0,38,2871,48514
2022-09-30,52838,169,0,21,3150,56178
2022-10-01,55419,74,0,174,2718,58385
2022-10-02,56849,85,0,102,3874,60910
2022-10-03,44467,85,0,53,1236,45841
2022-10-04,40423,196,0,223,2194,43036
2022-10-05,41618,204,0,1,948,42771
2022-10-06,44551,65,0,60,2391,47067
2022-10-07,51479,94,1,24,2750,54348
2022-10-08,60834,55,0,82,3065,64036
2022-10-09,61036,85,0,33,3674,64828
2022-10-10,40351,91,0,7,3886,44335
2022-10-11,39791,18,0,51,2366,42226
2022-10-12,39767,68,0,26,2416,42277
2022-10-13,46098,116,0,77,2478,48769
2022-10-14,52793,111,0,73,3153,56130
2022-10-15,60263,139,0,99,3060,63561
2022-10-16,59505,80,0,24,3301,62910
2022-10-17,42432,75,1,0,2629,45137
2022-10-18,39008,114,0,34,2534,41690
2022-10-19,41052,63,26,11,1183,42335
2022-10-20,43267,50,0,73,2891,46281
2022-10-21,52930,72,0,28,3035,56065
2022-10-22,53577,116,0,158,2883,56734
2022-10-23,57274,120,0,40,3855,61289
2022-10-24,41328,85,0,4,3023,44440
2022-10-25,42695,71,0,33,2593,45392
2022-10-26,43044,73,0,13,2644,45774
2022-10-27,46435,215,0,72,3166,49888
2022-10-28,63382,114,0,51,3710,67257
2022-10-29,70806,82,1,202,2353,73444
2022-10-30,63704,122,0,70,2405,66301
2022-10-31,61309,49,0,2,3002,64362
2022-11-01,70610,82,0,32,2558,73282
2022-11-02,53026,50,0,64,1564,54704
2022-11-03,45115,74,0,29,1934,47152
2022-11-04,48948,79,0,5,982,50014
