,osobni automobili,vlakovi,teretna vozila,autobusi,plovila,zrakoplovi,UKUPNO
2013-01-01,22074,9,185,84,1,11,22364
2013-01-02,31509,12,957,143,3,23,32647
2013-01-03,24203,14,1161,156,4,20,25558
2013-01-04,19650,14,912,151,1,26,20754
2013-01-05,29892,13,913,214,0,18,31050
2013-01-06,18622,14,491,138,3,25,19293
2013-01-07,15962,13,1589,108,1,22,17695
2013-01-08,15216,15,1671,92,2,18,17014
2013-01-09,16085,10,1288,120,4,20,17527
2013-01-10,18652,14,1351,110,5,17,20149
2013-01-11,19605,12,1106,115,1,25,20864
2013-01-12,19739,15,569,149,1,17,20490
2013-01-13,13765,12,536,139,2,23,14477
2013-01-14,12715,14,938,90,0,20,13777
2013-01-15,14335,14,2095,131,2,17,16594
2013-01-16,15052,14,1587,119,0,23,16795
2013-01-17,13992,14,1419,94,2,18,15539
2013-01-18,14880,14,1010,136,1,23,16064
2013-01-19,17665,15,649,148,3,16,18496
2013-01-20,12845,10,649,121,2,23,13650
2013-01-21,15301,15,1684,101,1,18,17120
2013-01-22,14779,15,2106,107,1,16,17024
2013-01-23,15305,20,1736,106,5,22,17194
2013-01-24,15207,18,1568,109,2,17,16921
2013-01-25,16006,16,1016,117,1,24,17180
2013-01-26,17478,14,624,142,0,19,18277
2013-01-27,14232,16,665,130,5,22,15070
2013-01-28,15770,13,1858,93,2,24,17760
2013-01-29,14441,16,1719,99,2,17,16294
2013-01-30,15837,16,1861,99,2,23,17838
2013-01-31,17550,18,1690,113,5,19,19395
2013-02-01,18577,22,1364,123,3,26,20115
2013-02-02,20007,14,678,152,0,17,20868
2013-02-03,13942,15,746,137,3,24,14867
2013-02-04,16698,14,1985,96,4,23,18820
2013-02-05,15471,16,1700,104,2,19,17312
2013-02-06,14155,14,1616,103,2,23,15913
2013-02-07,16607,18,1688,102,4,21,18440
2013-02-08,17714,17,1113,118,0,22,18984
2013-02-09,19599,16,973,203,2,17,20810
2013-02-10,12963,16,541,144,3,23,13690
2013-02-11,17575,15,1985,123,0,22,19720
2013-02-12,14269,16,1778,107,2,19,16191
2013-02-13,13781,15,1727,109,4,22,15658
2013-02-14,14828,15,1618,126,3,20,16610
2013-02-15,17407,17,1711,125,3,24,19287
2013-02-16,20728,15,905,173,0,17,21838
2013-02-17,13894,15,700,164,3,25,14801
2013-02-18,15709,12,2229,110,3,25,18088
2013-02-19,16321,18,1877,98,2,19,18335
2013-02-20,15214,15,2003,111,3,23,17369
2013-02-21,15077,15,1785,127,2,19,17025
2013-02-22,16227,16,1412,122,2,26,17805
2013-02-23,16285,16,714,144,2,17,17178
2013-02-24,13561,11,664,135,2,26,14399
2013-02-25,15492,10,1979,102,4,22,17609
2013-02-26,15333,14,1802,105,2,20,17276
2013-02-27,15966,14,1839,93,5,22,17939
2013-02-28,17204,13,1824,131,4,20,19196
2013-03-01,19507,16,1404,131,3,26,21087
2013-03-02,20608,15,790,241,1,16,21671
2013-03-03,15864,12,682,145,4,29,16736
2013-03-04,17790,14,1971,108,5,22,19910
2013-03-05,16601,21,2011,109,3,19,18764
2013-03-06,16665,14,1905,142,2,22,18750
2013-03-07,17476,18,1813,132,4,20,19463
2013-03-08,19913,15,1484,171,2,26,21611
2013-03-09,22183,17,722,190,2,17,23131
2013-03-10,14217,16,561,129,5,25,14953
2013-03-11,18014,15,2042,120,3,22,20216
2013-03-12,16867,18,2317,110,7,16,19335
2013-03-13,16217,15,1967,117,3,21,18340
2013-03-14,15045,19,1280,167,2,19,16532
2013-03-15,18152,12,1239,139,2,25,19569
2013-03-16,21602,16,752,281,2,18,22671
2013-03-17,15008,19,757,150,3,24,15961
2013-03-18,16638,15,2141,128,0,22,18944
2013-03-19,19082,17,1937,114,3,3,21156
2013-03-20,16694,18,1916,136,4,22,18790
2013-03-21,18500,18,1795,150,1,3,20467
2013-03-22,18288,15,1297,175,4,24,19803
2013-03-23,22871,19,793,272,5,18,23978
2013-03-24,16130,15,688,181,14,24,17052
2013-03-25,16039,15,1976,118,2,22,18172
2013-03-26,15427,20,1835,149,5,18,17454
2013-03-27,19732,16,1955,182,7,23,21915
2013-03-28,21129,20,1686,166,7,20,23028
2013-03-29,21434,17,1120,147,5,27,22750
2013-03-30,20151,16,455,159,4,19,20804
2013-03-31,13376,7,235,100,3,23,13744
2013-04-01,18278,9,625,169,4,26,19111
2013-04-02,17963,14,2244,174,1,21,20417
2013-04-03,16457,13,1861,158,4,22,18515
2013-04-04,18381,12,1910,158,6,23,20490
2013-04-05,20070,17,1555,217,0,27,21886
2013-04-06,21506,18,901,261,2,19,22707
2013-04-07,16814,18,751,209,4,21,17817
2013-04-08,17030,11,2051,111,4,27,19234
2013-04-09,17902,14,2239,139,3,21,20318
2013-04-10,17750,15,2051,169,3,23,20011
2013-04-11,17939,16,1819,179,10,22,19985
2013-04-12,19987,19,1360,170,8,5,21549
2013-04-13,23262,15,781,269,5,21,24353
2013-04-14,16035,18,657,210,3,24,16947
2013-04-15,19021,12,2114,133,5,24,21309
2013-04-16,17374,15,1686,140,7,22,19244
2013-04-17,18006,13,2139,187,9,25,20379
2013-04-18,19042,14,1928,206,6,26,21222
2013-04-19,20775,13,1567,237,10,27,22629
2013-04-20,23286,16,825,342,6,21,24496
2013-04-21,18290,15,763,240,8,23,19339
2013-04-22,18515,15,2558,220,8,22,21338
2013-04-23,18323,16,2079,201,7,22,20648
2013-04-24,18666,11,2390,252,7,27,21353
2013-04-25,19077,22,1965,215,14,27,21320
2013-04-26,21694,15,2212,312,8,30,24271
2013-04-27,24111,20,685,265,6,22,25109
2013-04-28,18111,21,839,211,5,24,19211
2013-04-29,21204,19,2318,223,44,31,23839
2013-04-30,24116,19,2004,284,7,25,26455
2013-05-01,17679,18,630,268,8,23,18626
2013-05-02,18299,15,1348,235,4,28,19929
2013-05-03,22115,12,1865,264,4,31,24291
2013-05-04,24339,19,840,285,9,31,25523
2013-05-05,17255,21,474,222,14,29,18015
2013-05-06,19227,20,2294,215,14,31,21801
2013-05-07,19776,15,2221,219,14,28,22273
2013-05-08,17729,17,2113,287,3,30,20179
2013-05-09,21067,16,1895,265,7,28,23278
2013-05-10,21050,18,1531,255,3,34,22891
2013-05-11,24339,18,758,414,6,31,25566
2013-05-12,18821,17,749,278,6,31,19902
2013-05-13,17969,19,2257,200,7,32,20484
2013-05-14,18423,17,2164,202,11,17,20834
2013-05-15,19254,16,2310,277,12,21,21890
2013-05-16,20840,15,2490,296,6,21,23668
2013-05-17,22063,16,1681,301,6,21,24088
2013-05-18,23863,18,720,316,11,24,24952
2013-05-19,18789,19,631,285,10,19,19753
2013-05-20,20493,20,2568,255,20,17,23373
2013-05-21,18348,17,2154,213,8,18,20758
2013-05-22,19557,18,2061,282,12,31,21961
2013-05-23,20197,16,2249,287,7,28,22784
2013-05-24,22267,18,2011,313,3,30,24642
2013-05-25,23307,21,761,366,8,32,24495
2013-05-26,16879,18,719,280,18,32,17946
2013-05-27,19369,18,2624,222,11,31,22275
2013-05-28,19147,19,2451,306,11,28,21962
2013-05-29,21202,17,1875,295,13,33,23435
2013-05-30,24738,15,1048,265,6,27,26099
2013-05-31,22952,17,1671,338,12,30,25020
2013-06-01,22698,19,1001,377,7,31,24133
2013-06-02,17141,18,653,286,7,30,18135
2013-06-03,19611,17,2334,266,11,35,22274
2013-06-04,18571,17,2540,261,7,28,21424
2013-06-05,19062,18,2305,274,2,29,21690
2013-06-06,19246,18,1825,250,5,9,21353
2013-06-07,22146,22,1572,303,5,31,24079
2013-06-08,23823,17,974,372,4,33,25223
2013-06-09,18930,21,703,310,8,29,20001
2013-06-10,19428,16,2220,261,8,30,21963
2013-06-11,19244,19,2372,262,5,29,21931
2013-06-12,19593,12,2244,260,7,33,22149
2013-06-13,21235,19,2169,305,5,29,23762
2013-06-14,22761,18,1865,370,5,29,25048
2013-06-15,25251,17,926,390,7,36,26627
2013-06-16,19664,19,740,320,17,32,20792
2013-06-17,20387,18,2444,310,5,34,23198
2013-06-18,19774,16,2217,255,3,29,22294
2013-06-19,19785,13,2349,295,13,30,22485
2013-06-20,20044,14,2325,306,13,32,22734
2013-06-21,24443,12,2131,351,9,37,26983
2013-06-22,30763,16,886,498,7,33,32203
2013-06-23,20629,18,786,328,4,33,21798
2013-06-24,24426,19,2436,340,12,33,27266
2013-06-25,23649,19,1314,314,8,31,25335
2013-06-26,20856,20,2161,288,12,29,23366
2013-06-27,21175,16,2084,240,7,30,23552
2013-06-28,23146,19,2240,345,13,33,25796
2013-06-29,24881,19,1101,334,8,31,26374
2013-06-30,20078,22,663,2000304,12,29,2021108
2013-07-01,19021,21,1964,288,10,34,21338
2013-07-02,17637,18,1953,278,7,30,19923
2013-07-03,18587,17,2127,278,8,34,21051
2013-07-04,19780,14,1780,265,8,30,21877
2013-07-05,22225,14,1680,278,10,32,24239
2013-07-06,23936,19,863,338,9,30,25195
2013-07-07,18899,18,771,292,40,31,20051
2013-07-08,21324,15,2512,281,6,35,24173
2013-07-09,19145,16,2043,237,7,30,21478
2013-07-10,19158,17,2191,244,7,31,21648
2013-07-11,21442,15,2245,284,11,30,24027
2013-07-12,22815,14,1547,292,9,34,24711
2013-07-13,23660,15,962,287,8,32,24964
2013-07-14,20471,20,685,279,5,32,21492
2013-07-15,21599,17,2786,286,14,35,24737
2013-07-16,19218,16,2164,256,8,29,21691
2013-07-17,20270,14,2087,250,7,32,22660
2013-07-18,21128,15,2289,302,5,32,23771
2013-07-19,23791,14,2175,276,9,33,26298
2013-07-20,25779,17,1067,311,9,32,27215
2013-07-21,19774,13,767,266,12,33,20865
2013-07-22,21809,14,2504,282,8,34,24651
2013-07-23,19151,16,2160,264,7,29,21627
2013-07-24,19978,18,2232,272,9,29,22538
2013-07-25,21534,19,1935,208,9,31,23736
2013-07-26,23912,16,1548,301,8,33,25818
2013-07-27,23204,15,661,315,9,34,24238
2013-07-28,20057,16,612,273,10,33,21001
2013-07-29,20490,19,2213,253,7,35,23017
2013-07-30,21374,19,2254,260,11,30,23948
2013-07-31,19808,15,2264,277,11,26,22401
2013-08-01,22072,18,1807,300,10,28,24235
2013-08-02,23909,20,1452,260,10,34,25685
2013-08-03,25621,14,668,314,13,55,26685
2013-08-04,21781,16,673,260,14,29,22773
2013-08-05,25316,15,1559,233,8,35,27166
2013-08-06,20046,18,2058,251,6,31,22410
2013-08-07,20827,12,2059,276,12,13,23199
2013-08-08,21363,16,1814,238,12,37,23480
2013-08-09,22408,12,1478,266,4,34,24202
2013-08-10,26065,17,740,314,7,38,27181
2013-08-11,21607,19,613,314,9,34,22596
2013-08-12,21847,14,1985,243,13,36,24138
2013-08-13,22163,15,1770,257,7,31,24243
2013-08-14,25873,20,1721,312,8,32,27966
2013-08-15,24428,19,621,294,8,50,25420
2013-08-16,24413,21,1392,281,9,40,26156
2013-08-17,26663,19,598,297,12,35,27624
2013-08-18,23244,17,568,327,14,30,24200
2013-08-19,21280,15,2017,266,10,38,23626
2013-08-20,22673,14,1572,255,7,31,24552
2013-08-21,21242,14,2045,275,6,34,23616
2013-08-22,21829,14,2154,255,16,33,24301
2013-08-23,22593,18,1616,320,8,32,24587
2013-08-24,24145,16,625,276,12,37,25111
2013-08-25,19691,17,716,279,8,30,20741
2013-08-26,21977,14,2383,249,10,34,24667
2013-08-27,20141,15,1909,267,6,31,22369
2013-08-28,21208,17,2140,248,8,32,23653
2013-08-29,21537,16,1970,259,10,33,23825
2013-08-30,22189,14,1752,225,16,39,24235
2013-08-31,24181,16,858,310,11,50,25426
2013-09-01,18521,19,660,244,9,35,19488
2013-09-02,20925,18,2750,221,11,37,23962
2013-09-03,20037,17,1869,196,12,30,22161
2013-09-04,19344,29,1932,254,10,35,21604
2013-09-05,21823,14,2367,244,10,31,24489
2013-09-06,21582,16,1571,250,6,32,23457
2013-09-07,27239,16,916,307,7,36,28521
2013-09-08,18960,15,746,297,7,30,20055
2013-09-09,19586,13,2322,229,10,35,22195
2013-09-10,18933,16,2143,249,12,30,21383
2013-09-11,19440,13,2120,270,7,33,21883
2013-09-12,20622,16,2095,290,7,30,23060
2013-09-13,22303,16,1658,289,7,31,24304
2013-09-14,25860,13,649,356,5,29,26912
2013-09-15,21266,17,734,300,8,32,22357
2013-09-16,19764,12,2432,307,16,30,22561
2013-09-17,20199,16,2273,295,3,30,22816
2013-09-18,19440,17,1962,274,14,29,21736
2013-09-19,22323,13,1912,263,7,33,24551
2013-09-20,22569,16,1775,334,6,33,24733
2013-09-21,24417,13,1032,387,7,31,25887
2013-09-22,19667,16,721,324,12,31,20771
2013-09-23,20611,12,2469,252,11,31,23386
2013-09-24,17840,25,2239,280,13,29,20426
2013-09-25,18136,16,2382,321,10,30,20895
2013-09-26,21705,14,2257,345,5,29,24355
2013-09-27,22871,15,1707,295,10,33,24931
2013-09-28,23534,20,756,328,6,34,24678
2013-09-29,19940,15,721,333,4,32,21045
2013-09-30,18832,14,2393,226,7,32,21504
2013-10-01,18985,16,2259,256,11,26,21553
2013-10-02,19027,13,2382,243,10,9,21684
2013-10-03,20047,13,2274,278,5,49,22666
2013-10-04,22202,15,1610,310,7,30,24174
2013-10-05,25145,18,830,403,5,29,26430
2013-10-06,20321,11,825,303,8,33,21501
2013-10-07,21891,15,2823,327,5,28,25089
2013-10-08,26870,19,1520,263,2,27,28701
2013-10-09,17999,18,2213,309,12,29,20580
2013-10-10,19724,17,2290,241,5,27,22304
2013-10-11,22608,15,2044,354,10,29,25060
2013-10-12,24870,15,755,375,9,27,26051
2013-10-13,19340,13,700,295,7,31,20386
2013-10-14,19158,16,2503,221,6,25,21929
2013-10-15,18973,17,2456,235,3,23,21707
2013-10-16,19223,15,2124,257,6,26,21651
2013-10-17,19432,16,2051,267,7,27,21800
2013-10-18,21586,18,1949,300,6,26,23885
2013-10-19,23884,16,855,369,1,24,25149
2013-10-20,18812,19,835,298,5,26,19995
2013-10-21,18546,16,2314,200,4,24,21104
2013-10-22,18210,18,2451,199,9,22,20909
2013-10-23,17254,15,2244,215,5,24,19757
2013-10-24,18974,15,2480,228,6,26,21729
2013-10-25,21105,16,1844,252,10,24,23251
2013-10-26,23461,16,952,295,2,24,24750
2013-10-27,19492,17,663,271,3,23,20469
2013-10-28,18178,13,2512,185,7,21,20916
2013-10-29,18824,18,2532,181,8,18,21581
2013-10-30,22403,16,2294,162,5,23,24903
2013-10-31,27657,16,1639,174,7,20,29513
2013-11-01,30376,18,661,214,2,22,31293
2013-11-02,25942,20,704,161,1,18,26846
2013-11-03,19122,17,746,176,2,23,20086
2013-11-04,19596,19,2579,169,2,20,22385
2013-11-05,17328,15,2440,147,2,16,19948
2013-11-06,17485,15,2270,161,4,24,19959
2013-11-07,18656,19,2247,174,4,20,21120
2013-11-08,20385,12,2010,210,3,23,22643
2013-11-09,20854,17,819,195,2,16,21903
2013-11-10,16970,17,717,170,0,21,17895
2013-11-11,17231,16,2245,123,2,21,19638
2013-11-12,17679,17,2362,127,6,17,20208
2013-11-13,18074,14,1964,146,5,23,20226
2013-11-14,18983,18,2094,135,8,16,21254
2013-11-15,20637,15,1836,152,4,21,22665
2013-11-16,22887,17,983,229,5,18,24139
2013-11-17,16795,15,658,189,6,22,17685
2013-11-18,18165,15,2818,113,7,20,21138
2013-11-19,18213,18,2348,127,3,15,20724
2013-11-20,17570,12,2375,122,6,3,20088
2013-11-21,18316,14,2029,126,5,17,20507
2013-11-22,20723,13,1917,144,5,16,22818
2013-11-23,20752,17,834,195,5,17,21820
2013-11-24,16035,18,765,194,10,22,17044
2013-11-25,17853,16,2423,124,4,21,20441
2013-11-26,17289,17,2074,120,4,16,19520
2013-11-27,16548,18,2003,123,5,22,18719
2013-11-28,17682,14,2296,144,9,20,20165
2013-11-29,20442,14,1909,163,10,21,22559
2013-11-30,20277,18,965,221,3,17,21501
2013-12-01,15497,17,641,162,1,21,16339
2013-12-02,17921,16,2467,116,1,23,20544
2013-12-03,17414,21,2094,114,8,16,19667
2013-12-04,17090,14,2165,121,2,23,19415
2013-12-05,18514,19,2146,124,5,20,20828
2013-12-06,19481,19,2020,146,3,23,21692
2013-12-07,20171,18,649,314,1,16,21169
2013-12-08,15753,17,767,208,3,21,16769
2013-12-09,17402,14,2486,110,1,22,20035
2013-12-10,17332,14,2496,115,3,18,19978
2013-12-11,17984,27,2472,138,3,22,20646
2013-12-12,19227,13,1968,124,10,19,21361
2013-12-13,19583,16,1728,189,2,21,21539
2013-12-14,21654,15,896,377,1,15,22958
2013-12-15,16173,18,757,158,2,21,17129
2013-12-16,17638,23,2383,108,2,18,20172
2013-12-17,18219,22,2493,86,5,2,20827
2013-12-18,18860,15,2147,95,3,21,21141
2013-12-19,20630,18,1759,157,1,20,22585
2013-12-20,21220,19,1524,173,1,20,22957
2013-12-21,23913,20,742,256,3,16,24950
2013-12-22,17044,18,556,182,2,17,17819
2013-12-23,22581,22,1226,138,0,20,23987
2013-12-24,19416,19,543,116,1,9,20104
2013-12-25,11518,14,133,47,0,0,11712
2013-12-26,18154,11,367,106,2,19,18659
2013-12-27,22158,17,944,149,3,22,23293
2013-12-28,20964,16,467,166,4,20,21637
2013-12-29,15943,12,485,164,3,21,16628
2013-12-30,23293,16,935,254,1,22,24521
2013-12-31,18323,20,377,122,1,8,18851
2014-01-01,10032,10,213,91,0,17,10363
2014-01-02,19471,17,893,147,4,21,20553
2014-01-03,21398,19,1085,187,3,23,22715
2014-01-04,29464,15,438,248,0,16,30181
2014-01-05,18526,15,318,168,1,21,19049
2014-01-06,18914,14,841,135,1,23,19928
2014-01-07,16591,15,1647,96,2,17,18368
2014-01-08,18606,16,1837,141,2,20,20622
2014-01-09,17167,17,1737,149,3,18,19091
2014-01-10,19676,16,1469,124,2,19,21306
2014-01-11,22348,15,616,137,0,19,23135
2014-01-12,15612,13,614,139,4,24,16406
2014-01-13,16674,22,2189,92,2,19,18998
2014-01-14,17222,17,1843,99,1,17,19199
2014-01-15,17143,18,2014,94,3,20,19292
2014-01-16,17827,18,1533,119,4,21,19522
2014-01-17,18757,19,1626,111,1,20,20534
2014-01-18,21122,13,668,180,0,15,21998
2014-01-19,15230,17,587,115,1,21,15971
2014-01-20,17378,17,2239,115,1,20,19770
2014-01-21,16725,23,2043,97,2,17,18907
2014-01-22,17106,18,1964,125,4,21,19238
2014-01-23,17229,16,2008,112,3,21,19389
2014-01-24,17088,13,1311,142,0,21,18575
2014-01-25,15354,15,613,237,0,17,16236
2014-01-26,12924,18,547,116,3,24,13632
2014-01-27,15640,16,2047,119,2,22,17846
2014-01-28,14457,17,1503,113,1,16,16107
2014-01-29,13775,18,1756,97,3,21,15670
2014-01-30,15431,16,1609,108,1,19,17184
2014-01-31,17244,16,1348,125,1,21,18755
2014-02-01,17233,12,646,148,0,16,18055
2014-02-02,11233,9,573,127,1,20,11963
2014-02-03,15609,11,2018,107,0,21,17766
2014-02-04,14315,12,1738,117,1,17,16200
2014-02-05,15939,14,1824,138,3,22,17940
2014-02-06,15877,10,1993,110,3,19,18012
2014-02-07,18043,12,1421,122,1,23,19622
2014-02-08,18486,16,625,147,0,14,19288
2014-02-09,14379,14,571,143,2,21,15130
2014-02-10,16962,16,2138,113,2,20,19251
2014-02-11,17485,19,2042,131,2,14,19693
2014-02-12,17135,17,2071,127,5,21,19376
2014-02-13,17750,17,1844,116,5,21,19753
2014-02-14,20395,20,1625,129,3,20,22192
2014-02-15,22429,18,666,201,1,15,23330
2014-02-16,16859,15,625,160,1,22,17682
2014-02-17,16812,16,1936,124,0,20,18908
2014-02-18,16389,12,2255,118,1,15,18790
2014-02-19,17614,18,1960,144,1,22,19759
2014-02-20,18358,15,1961,149,6,18,20507
2014-02-21,18901,16,1425,136,3,20,20501
2014-02-22,20417,15,653,246,0,16,21347
2014-02-23,17040,12,1157,198,1,24,18432
2014-02-24,16792,15,2270,130,6,20,19233
2014-02-25,15834,15,1933,115,1,16,17914
2014-02-26,16411,15,2303,130,4,21,18884
2014-02-27,17420,16,1821,119,4,22,19402
2014-02-28,20628,17,1677,155,1,22,22500
2014-03-01,22075,15,799,233,0,17,23139
2014-03-02,16280,14,694,183,2,21,17194
2014-03-03,18907,14,2460,120,4,21,21526
2014-03-04,15305,14,2093,138,0,17,17567
2014-03-05,16712,16,1849,130,2,23,18732
2014-03-06,18285,15,2047,143,2,18,20510
2014-03-07,20961,13,1638,155,3,21,22791
2014-03-08,22804,14,608,261,0,17,23704
2014-03-09,17716,15,622,170,1,20,18544
2014-03-10,18395,17,2417,145,0,22,20996
2014-03-11,17403,18,2184,124,1,15,19745
2014-03-12,17185,15,2004,125,4,24,19357
2014-03-13,18443,16,2058,153,3,2,20675
2014-03-14,21309,15,1866,148,2,21,23361
2014-03-15,23511,17,725,236,1,16,24506
2014-03-16,19739,18,687,208,2,22,20676
2014-03-17,18337,15,2185,137,1,21,20696
2014-03-18,19661,18,2770,160,6,16,22631
2014-03-19,19296,13,2098,128,1,24,21560
2014-03-20,19256,18,2111,170,7,21,21583
2014-03-21,21190,20,1667,175,3,26,23081
2014-03-22,22505,15,917,218,1,17,23673
2014-03-23,18228,14,646,187,1,23,19099
2014-03-24,18651,20,2501,139,3,26,21340
2014-03-25,17720,19,2350,141,3,16,20249
2014-03-26,18017,19,2783,159,2,24,21004
2014-03-27,16641,19,2266,160,2,19,19107
2014-03-28,20590,20,1818,183,3,24,22638
2014-03-29,22003,15,709,242,2,17,22988
2014-03-30,18659,16,724,232,1,22,19654
2014-03-31,17858,17,2660,141,7,24,20707
2014-04-01,18502,17,2446,142,4,24,21135
2014-04-02,17361,18,1905,139,4,23,19450
2014-04-03,17909,16,2098,187,11,22,20243
2014-04-04,20234,19,1984,201,5,24,22467
2014-04-05,22493,14,848,361,2,20,23738
2014-04-06,17790,18,638,241,4,23,18714
2014-04-07,19502,12,2997,173,3,23,22710
2014-04-08,18232,22,2480,166,2,24,20926
2014-04-09,19751,18,2702,195,3,23,22692
2014-04-10,19489,23,2249,188,6,23,21978
2014-04-11,22562,23,2141,255,3,24,25008
2014-04-12,25321,20,1037,325,2,21,26726
2014-04-13,20122,16,887,278,8,23,21334
2014-04-14,20129,19,2520,196,5,24,22893
2014-04-15,22191,25,3062,198,4,23,25503
2014-04-16,22689,21,2160,219,6,4,25099
2014-04-17,25273,15,2199,272,2,25,27786
2014-04-18,23380,8,1064,201,4,27,24684
2014-04-19,24432,25,452,193,3,22,25127
2014-04-20,15537,20,188,103,1,26,15875
2014-04-21,20506,16,636,270,2,30,21460
2014-04-22,20848,21,2612,217,7,26,23731
2014-04-23,20491,17,2562,183,4,27,23284
2014-04-24,22255,24,2022,222,7,26,24556
2014-04-25,21847,20,1957,324,3,26,24177
2014-04-26,25012,21,877,676,0,23,26609
2014-04-27,18463,19,746,711,14,25,19978
2014-04-28,20452,20,2605,291,21,27,23416
2014-04-29,20277,23,2553,241,4,22,23120
2014-04-30,23145,19,1606,236,4,28,25038
2014-05-01,18381,29,320,301,4,30,19065
2014-05-02,23015,21,842,248,5,29,24160
2014-05-03,22772,22,641,303,0,32,23770
2014-05-04,19745,17,660,278,5,26,20731
2014-05-05,19556,23,2401,223,8,30,22241
2014-05-06,19740,22,2039,221,4,26,22052
2014-05-07,19007,21,2092,325,4,29,21478
2014-05-08,21235,26,1917,242,6,10,23436
2014-05-09,22423,24,1737,305,4,28,24521
2014-05-10,24077,22,840,347,2,30,25318
2014-05-11,18863,18,606,279,2,31,19799
2014-05-12,20050,17,2400,216,7,11,22701
2014-05-13,20028,22,2283,261,4,29,22627
2014-05-14,20121,26,2286,235,2,28,22698
2014-05-15,18939,15,2019,313,4,28,21318
2014-05-16,19851,16,1448,316,3,32,21666
2014-05-17,21477,14,597,504,5,18,22615
2014-05-18,16415,17,522,285,9,31,17279
2014-05-19,17439,15,2246,270,10,30,20010
2014-05-20,16633,20,2048,251,5,30,18987
2014-05-21,17572,17,2182,273,10,26,20080
2014-05-22,17831,20,2421,265,2,26,20565
2014-05-23,19012,20,1784,350,9,31,21206
2014-05-24,21431,19,761,369,6,34,22620
2014-05-25,19383,20,698,297,6,34,20438
2014-05-26,19310,19,2601,246,8,31,22215
2014-05-27,18010,24,2091,250,9,27,20411
2014-05-28,18045,17,1888,273,5,30,20258
2014-05-29,17062,22,1907,288,5,29,19313
2014-05-30,21585,17,1775,303,6,32,23718
2014-05-31,22273,21,828,363,4,31,23520
2014-06-01,18999,19,640,318,14,32,20022
2014-06-02,19230,22,2639,267,14,32,22204
2014-06-03,18152,22,2312,260,7,11,20764
2014-06-04,18869,22,2335,320,7,29,21582
2014-06-05,19333,23,2004,276,9,29,21674
2014-06-06,21165,20,2040,342,5,29,23601
2014-06-07,22891,20,686,346,2,32,23977
2014-06-08,19725,20,950,342,7,32,21076
2014-06-09,20392,21,2115,243,8,30,22809
2014-06-10,19714,23,2399,269,9,45,22459
2014-06-11,18814,17,1843,233,11,33,20951
2014-06-12,19428,16,1989,285,11,32,21761
2014-06-13,19328,20,1501,304,3,32,21188
2014-06-14,23704,20,813,349,4,34,24924
2014-06-15,19747,19,707,278,10,31,20792
2014-06-16,21207,21,2873,335,7,31,24474
2014-06-17,18988,22,2216,287,16,32,21561
2014-06-18,21351,22,1992,315,8,30,23718
2014-06-19,25258,22,1142,299,6,30,26757
2014-06-20,22046,19,1408,338,10,34,23855
2014-06-21,22643,19,705,360,4,35,23766
2014-06-22,20400,17,711,350,10,32,21520
2014-06-23,19674,24,2173,268,12,31,22182
2014-06-24,21095,24,2378,319,6,32,23854
2014-06-25,22892,22,1147,342,6,31,24440
2014-06-26,21049,29,2453,500,7,31,24069
2014-06-27,22617,21,1650,274,8,35,24605
2014-06-28,23632,24,727,342,4,34,24763
2014-06-29,20863,22,677,326,15,31,21934
2014-06-30,20967,20,2730,256,4,33,24010
2014-07-01,19386,24,2506,273,6,31,22226
2014-07-02,19299,27,2355,304,8,12,22005
2014-07-03,21767,29,1918,315,5,29,24063
2014-07-04,22293,25,1776,291,6,30,24421
2014-07-05,25226,28,789,403,5,34,26485
2014-07-06,21244,28,674,262,9,31,22248
2014-07-07,23077,23,2420,302,5,32,25859
2014-07-08,22237,30,2493,260,6,32,25058
2014-07-09,21680,26,2076,254,8,34,24078
2014-07-10,22452,27,2032,310,5,28,24854
2014-07-11,23227,27,1696,338,10,30,25328
2014-07-12,25003,22,708,311,8,33,26085
2014-07-13,19521,24,640,277,2,36,20500
2014-07-14,21528,19,2719,244,7,30,24547
2014-07-15,22791,24,2376,277,5,32,25505
2014-07-16,22074,25,2383,309,10,37,24838
2014-07-17,21895,24,2067,281,10,33,24310
2014-07-18,25585,23,1850,314,18,32,27822
2014-07-19,27318,21,843,297,8,35,28522
2014-07-20,22994,23,744,277,12,34,24084
2014-07-21,24382,25,2703,257,9,34,27410
2014-07-22,20208,27,2343,245,9,31,22863
2014-07-23,21615,25,2433,268,9,28,24378
2014-07-24,23244,26,2464,272,8,29,26043
2014-07-25,25220,24,1587,281,8,32,27152
2014-07-26,25181,22,713,306,12,41,26275
2014-07-27,21060,24,661,229,25,32,22031
2014-07-28,21837,21,2632,258,12,30,24790
2014-07-29,22270,25,1952,266,7,32,24552
2014-07-30,21509,24,2180,264,8,33,24018
2014-07-31,23899,33,2125,286,10,32,26385
2014-08-01,25418,26,1524,281,14,33,27296
2014-08-02,29350,22,643,301,15,33,30364
2014-08-03,22617,23,797,272,9,32,23750
2014-08-04,22913,24,2566,231,7,30,25771
2014-08-05,25312,28,1592,276,7,31,27246
2014-08-06,22923,27,1862,266,6,32,25116
2014-08-07,21021,29,2038,267,13,28,23396
2014-08-08,25577,23,1571,270,15,29,27485
2014-08-09,28414,22,729,332,9,35,29541
2014-08-10,22901,20,701,272,19,32,23945
2014-08-11,25040,22,2247,263,7,31,27610
2014-08-12,24124,28,2051,281,10,27,26521
2014-08-13,24427,25,2123,243,11,32,26861
2014-08-14,29142,25,1490,284,10,28,30979
2014-08-15,28455,25,3000569,293,10,32,3029384
2014-08-16,27536,21,783,330,15,32,28717
2014-08-17,23694,24,824,278,23,29,24872
2014-08-18,24766,24,2354,251,6,30,27431
2014-08-19,22435,28,2005,247,12,34,24761
2014-08-20,22427,24,1672,287,6,28,24444
2014-08-21,25214,25,2200,292,7,32,27770
2014-08-22,22946,28,1689,276,11,29,24979
2014-08-23,26380,20,724,320,9,33,27486
2014-08-24,21321,22,693,321,15,30,22402
2014-08-25,23528,20,2851,281,18,31,26729
2014-08-26,20807,21,3059,234,15,33,24169
2014-08-27,21295,24,2058,255,11,31,23674
2014-08-28,22904,22,2284,294,11,32,25547
2014-08-29,24126,24,1902,295,12,32,26391
2014-08-30,25249,22,796,303,30,36,26436
2014-08-31,21218,25,676,262,11,33,22225
2014-09-01,21057,13,2443,252,5,30,23800
2014-09-02,23003,22,2591,265,5,31,25917
2014-09-03,22217,29,2312,235,14,34,24841
2014-09-04,22002,18,2296,302,9,31,24658
2014-09-05,24289,23,1722,279,8,31,26352
2014-09-06,27983,22,706,358,4,30,29103
2014-09-07,20432,20,691,260,14,37,21454
2014-09-08,21181,18,2653,270,8,32,24162
2014-09-09,19992,30,2204,258,8,32,22524
2014-09-10,20870,21,2310,284,10,29,23524
2014-09-11,22334,23,2255,262,5,30,24909
2014-09-12,23417,24,1782,315,5,31,25574
2014-09-13,25400,17,855,381,4,33,26690
2014-09-14,21735,16,865,322,14,30,22982
2014-09-15,21198,22,2824,255,8,34,24341
2014-09-16,19501,22,2312,285,6,33,22159
2014-09-17,19839,20,2171,288,9,31,22358
2014-09-18,21678,27,2383,307,10,32,24437
2014-09-19,22855,23,1893,298,5,31,25105
2014-09-20,25403,20,942,462,3,31,26861
2014-09-21,19936,24,737,308,14,31,21050
2014-09-22,20911,19,2738,299,14,31,24012
2014-09-23,19309,23,2201,258,4,30,21825
2014-09-24,21456,25,2431,294,13,30,24249
2014-09-25,21411,19,2139,263,2,28,23862
2014-09-26,22231,21,1922,328,12,30,24544
2014-09-27,26475,25,1054,381,5,34,27974
2014-09-28,21370,18,731,311,32,31,22493
2014-09-29,20742,20,2647,243,11,30,23693
2014-09-30,19697,26,2692,252,9,31,22707
2014-10-01,20574,22,2419,245,3,30,23293
2014-10-02,21492,21,2177,280,7,32,24009
2014-10-03,23621,24,1739,270,5,32,25691
2014-10-04,25257,19,964,401,3,30,26674
2014-10-05,21321,18,736,292,5,32,22404
2014-10-06,20399,27,3041,238,13,28,23746
2014-10-07,21145,15,2197,246,2,27,23632
2014-10-08,27795,16,1580,318,7,29,29745
2014-10-09,20439,27,2155,273,8,31,22933
2014-10-10,23470,25,1786,372,9,27,25689
2014-10-11,24518,15,866,409,9,25,25842
2014-10-12,21026,23,803,286,6,33,22177
2014-10-13,19970,21,2576,229,8,25,22829
2014-10-14,19654,27,2109,243,5,26,22064
2014-10-15,20790,22,2721,275,5,25,23838
2014-10-16,20924,18,2481,269,3,28,23723
2014-10-17,22764,21,1882,259,5,28,24959
2014-10-18,26398,16,884,386,3,28,27715
2014-10-19,19861,20,621,285,5,25,20817
2014-10-20,19797,20,2368,237,4,25,22451
2014-10-21,19576,20,2513,217,4,27,22357
2014-10-22,19633,23,2294,224,3,24,22201
2014-10-23,19099,21,1757,259,2,23,21161
2014-10-24,21775,21,1597,218,1,26,23638
2014-10-25,23566,20,813,321,2,23,24745
2014-10-26,19310,19,682,267,7,24,20309
2014-10-27,19484,18,2678,197,5,22,22404
2014-10-28,19552,19,2326,206,10,19,22132
2014-10-29,20875,15,2262,206,5,24,23387
2014-10-30,22838,22,2313,216,3,22,25414
2014-10-31,27001,20,1160,200,2,23,28406
2014-11-01,30774,25,359,146,2,18,31324
2014-11-02,22166,28,797,166,4,20,23181
2014-11-03,20792,29,2709,171,3,22,23726
2014-11-04,18867,27,2382,154,1,19,21450
2014-11-05,18350,24,2604,156,0,25,21159
2014-11-06,20026,20,2094,180,3,21,22344
2014-11-07,22455,26,1900,205,1,22,24609
2014-11-08,23226,23,820,263,4,18,24354
2014-11-09,17610,20,648,191,4,21,18494
2014-11-10,18610,22,2634,167,1,23,21457
2014-11-11,19390,25,2475,158,1,18,22067
2014-11-12,19042,21,2283,149,2,23,21520
2014-11-13,18286,24,2207,141,5,22,20685
2014-11-14,22291,23,1905,183,5,22,24429
2014-11-15,24253,20,847,232,3,20,25375
2014-11-16,18692,23,680,210,4,21,19630
2014-11-17,18426,15,2746,161,3,21,21372
2014-11-18,18444,20,2522,168,0,19,21173
2014-11-19,18905,27,2284,161,11,23,21411
2014-11-20,19483,15,2188,175,5,21,21887
2014-11-21,21424,21,1770,175,3,22,23415
2014-11-22,21973,20,870,221,6,17,23107
2014-11-23,16788,10,831,177,4,20,17830
2014-11-24,18435,17,3004,159,5,20,21640
2014-11-25,17395,26,2548,134,6,16,20125
2014-11-26,19020,20,2304,163,3,25,21535
2014-11-27,18527,14,2424,194,5,20,21184
2014-11-28,21476,30,2033,201,4,22,23766
2014-11-29,20493,21,906,247,3,17,21687
2014-11-30,16149,27,707,169,5,21,17078
2014-12-01,18211,19,2616,141,4,21,21012
2014-12-02,17992,25,2434,157,5,19,20632
2014-12-03,17876,22,2253,152,4,22,20329
2014-12-04,18153,22,2182,158,6,20,20541
2014-12-05,19952,18,1629,187,8,21,21815
2014-12-06,20289,25,931,359,5,17,21626
2014-12-07,15432,22,557,171,4,23,16209
2014-12-08,19400,20,2485,167,5,20,22097
2014-12-09,17945,20,2457,138,3,3,20566
2014-12-10,18473,21,2432,151,3,3,21083
2014-12-11,18899,24,2539,164,6,22,21654
2014-12-12,20300,26,2117,199,3,21,22666
2014-12-13,22646,23,933,494,4,18,24118
2014-12-14,16934,23,730,233,4,20,17944
2014-12-15,19697,23,3027,148,6,19,22920
2014-12-16,19199,26,2519,143,3,19,21909
2014-12-17,19375,27,2719,141,6,22,22290
2014-12-18,20843,21,2349,181,5,20,23419
2014-12-19,22294,26,1869,187,6,22,24404
2014-12-20,23029,24,984,396,3,18,24454
2014-12-21,18384,23,688,204,6,23,19328
2014-12-22,23190,25,2123,148,2,22,25510
2014-12-23,25038,26,1710,144,9,20,26947
2014-12-24,20892,26,694,129,2,12,21755
2014-12-25,12292,9,164,58,0,0,12523
2014-12-26,20243,15,373,117,0,21,20769
2014-12-27,23048,26,546,139,5,14,23778
2014-12-28,11127,19,294,188,4,21,11653
2014-12-29,16667,24,1029,175,5,23,17923
2014-12-30,21731,24,835,242,3,22,22857
2014-12-31,16789,23,392,180,1,12,17397
2015-01-01,8724,9,144,87,1,14,8979
2015-01-02,22053,17,645,241,2,23,22981
2015-01-03,26640,25,383,264,1,21,27334
2015-01-04,18171,16,409,178,1,21,18796
2015-01-05,20022,20,1053,125,1,22,21243
2015-01-06,20631,21,758,129,3,20,21562
2015-01-07,16094,21,1330,125,0,23,17593
2015-01-08,17278,23,1719,179,3,20,19222
2015-01-09,20146,26,1302,132,2,17,21625
2015-01-10,25159,16,884,196,0,15,26270
2015-01-11,17110,14,518,127,1,20,17790
2015-01-12,16088,19,1785,131,2,19,18044
2015-01-13,17939,21,1534,111,5,18,19628
2015-01-14,15705,23,1645,143,1,17,17534
2015-01-15,18044,21,1446,149,1,17,19678
2015-01-16,19174,17,1273,130,0,22,20616
2015-01-17,21986,18,718,153,0,17,22892
2015-01-18,14976,20,563,147,3,19,15728
2015-01-19,16797,17,2028,143,3,24,19012
2015-01-20,16487,14,1990,112,1,21,18625
2015-01-21,15614,23,1828,108,2,22,17597
2015-01-22,16610,14,1844,121,2,20,18611
2015-01-23,17520,17,1500,132,0,22,19191
2015-01-24,19349,14,799,177,0,19,20358
2015-01-25,13401,22,626,139,1,22,14211
2015-01-26,15839,15,2217,128,1,23,18223
2015-01-27,15876,18,2015,114,2,21,18046
2015-01-28,15540,11,1911,145,1,21,17629
2015-01-29,15547,22,1805,130,1,22,17527
2015-01-30,16791,19,1437,155,1,19,18422
2015-01-31,19104,15,653,168,1,17,19958
2015-02-01,13348,19,667,128,2,20,14184
2015-02-02,16014,16,1941,128,2,21,18122
2015-02-03,16751,15,2091,135,1,20,19013
2015-02-04,14687,18,1792,130,0,23,16650
2015-02-05,14654,18,1330,134,3,21,16160
2015-02-06,12138,19,765,141,0,21,13084
2015-02-07,14569,19,713,154,1,18,15474
2015-02-08,13143,14,757,152,2,21,14089
2015-02-09,15314,13,1883,129,2,21,17362
2015-02-10,14899,24,4008,166,4,20,19121
2015-02-11,16637,23,2234,145,4,21,19064
2015-02-12,17933,19,1623,144,3,17,19739
2015-02-13,20335,21,1486,170,4,22,22038
2015-02-14,22155,21,965,217,1,17,23376
2015-02-15,16919,17,787,139,3,22,17887
2015-02-16,17792,20,2065,151,0,20,20048
2015-02-17,16987,23,1993,119,1,14,19137
2015-02-18,16649,24,1972,122,2,22,18791
2015-02-19,18000,20,1987,147,2,20,20176
2015-02-20,19941,22,1610,134,2,21,21730
2015-02-21,20874,21,796,194,0,19,21904
2015-02-22,14866,16,793,136,1,21,15833
2015-02-23,17485,17,2307,134,2,22,19967
2015-02-24,16948,17,2200,132,4,20,19321
2015-02-25,16725,19,2114,143,1,22,19024
2015-02-26,17155,21,2336,151,2,21,19686
2015-02-27,19767,19,1945,149,3,21,21904
2015-02-28,21767,23,816,187,4,16,22813
2015-03-01,17229,20,647,161,2,20,18079
2015-03-02,17735,16,2655,118,2,21,20547
2015-03-03,17459,16,2356,134,5,18,19988
2015-03-04,17009,12,2323,139,4,22,19509
2015-03-05,16388,19,1715,136,1,19,18278
2015-03-06,18288,27,1742,141,1,22,20221
2015-03-07,21387,24,786,250,0,20,22467
2015-03-08,17372,18,642,199,1,19,18251
2015-03-09,17444,12,2362,147,0,21,19986
2015-03-10,17433,13,2309,130,3,20,19908
2015-03-11,17073,11,2524,147,4,25,19784
2015-03-12,18911,21,2234,159,1,21,21347
2015-03-13,20811,12,1740,152,2,20,22737
2015-03-14,24813,24,1109,261,2,18,26227
2015-03-15,19905,19,795,158,2,21,20900
2015-03-16,18010,16,2527,138,0,22,20713
2015-03-17,18069,14,2219,144,2,18,20466
2015-03-18,18356,10,2102,155,3,21,20647
2015-03-19,20491,21,2414,166,4,21,23117
2015-03-20,20352,18,1841,189,0,21,22421
2015-03-21,22528,18,806,465,0,19,23836
2015-03-22,17934,16,743,183,2,19,18897
2015-03-23,18639,15,2661,138,6,24,21483
2015-03-24,18022,21,2518,159,2,19,20741
2015-03-25,18673,20,2461,172,1,22,21349
2015-03-26,19918,15,2456,182,1,21,22593
2015-03-27,20145,19,1935,207,4,22,22332
2015-03-28,23545,18,957,296,4,17,24837
2015-03-29,18406,13,755,235,12,24,19445
2015-03-30,20904,16,2633,172,7,24,23756
2015-03-31,19734,18,2741,185,4,20,22702
2015-04-01,22030,15,2495,190,8,23,24761
2015-04-02,24900,21,2012,216,7,25,27181
2015-04-03,24362,19,1265,152,3,24,25825
2015-04-04,23200,20,480,177,0,11,23888
2015-04-05,14885,14,4816,109,1,24,19849
2015-04-06,23877,9,746,198,3,25,24858
2015-04-07,23080,21,2852,197,2,22,26174
2015-04-08,19605,18,2436,216,6,21,22302
2015-04-09,19061,22,2163,187,6,22,21461
2015-04-10,23009,18,1729,242,4,23,25025
2015-04-11,24455,16,1026,344,1,21,25863
2015-04-12,18170,18,469,241,3,23,18924
2015-04-13,17732,18,2500,199,3,22,20474
2015-04-14,19336,18,2483,198,2,22,22059
2015-04-15,19370,18,2475,197,3,21,22084
2015-04-16,20115,16,2499,221,2,23,22876
2015-04-17,22822,22,1913,275,0,24,25056
2015-04-18,24653,20,881,324,0,19,25897
2015-04-19,22049,16,765,234,2,23,23089
2015-04-20,19193,20,3172,201,7,28,22621
2015-04-21,19462,19,2693,190,2,25,22391
2015-04-22,19597,20,2652,217,1,24,22511
2015-04-23,20058,14,2595,204,4,24,22899
2015-04-24,22592,18,2538,260,1,15,25424
2015-04-25,25388,22,949,383,3,24,26769
2015-04-26,19304,9,758,249,5,26,20351
2015-04-27,19896,14,2189,255,4,30,22388
2015-04-28,20679,20,2469,193,7,29,23397
2015-04-29,20516,20,2505,248,7,29,23325
2015-04-30,27137,21,1896,305,3,27,29389
2015-05-01,20701,20,499,339,1,27,21587
2015-05-02,27497,19,619,283,1,28,28447
2015-05-03,22113,19,601,280,4,32,23049
2015-05-04,21553,23,2403,243,9,30,24261
2015-05-05,18653,23,2284,224,12,31,21227
2015-05-06,21623,22,2604,255,4,29,24537
2015-05-07,20853,23,2183,275,5,20,23359
2015-05-08,23105,20,1694,307,5,31,25162
2015-05-09,25478,21,1004,350,1,32,26886
2015-05-10,20702,14,798,214,4,31,21763
2015-05-11,21246,17,2828,283,6,30,24410
2015-05-12,20110,11,2285,270,9,31,22716
2015-05-13,20450,20,2196,217,1,28,22912
2015-05-14,22041,23,2068,287,5,28,24452
2015-05-15,25105,20,2387,304,0,29,27845
2015-05-16,28525,22,969,632,3,31,30182
2015-05-17,21628,19,689,203,2,32,22573
2015-05-18,20541,20,2452,245,6,31,23295
2015-05-19,19491,20,2675,241,3,24,22454
2015-05-20,18714,18,2293,304,2,29,21360
2015-05-21,19960,19,1793,257,3,30,22062
2015-05-22,23086,12,2343,351,2,27,25821
2015-05-23,24813,24,892,364,3,32,26128
2015-05-24,18479,22,636,321,2,32,19492
2015-05-25,24187,12,2487,293,7,30,27016
2015-05-26,20429,15,2824,259,7,29,23563
2015-05-27,19824,18,2524,312,12,28,22718
2015-05-28,20419,14,2564,328,4,30,23359
2015-05-29,21425,19,1690,281,9,30,23454
2015-05-30,23736,17,797,316,4,35,24905
2015-05-31,20101,16,718,274,6,32,21147
2015-06-01,19509,22,2717,243,13,30,22534
2015-06-02,20514,19,2209,267,6,28,23043
2015-06-03,20864,14,2120,278,6,32,23314
2015-06-04,27090,19,1227,326,3,30,28695
2015-06-05,22788,17,1780,395,5,30,25015
2015-06-06,22879,14,988,579,1,32,24493
2015-06-07,26026,10,827,270,8,32,27173
2015-06-08,20265,23,2699,295,5,31,23318
2015-06-09,19433,21,2663,301,10,31,22459
2015-06-10,21096,17,2239,260,5,32,23649
2015-06-11,20502,13,1994,1598,6,31,24144
2015-06-12,23207,23,1828,323,3,30,25414
2015-06-13,26322,18,891,386,1,41,27659
2015-06-14,25856,20,832,283,9,31,27031
2015-06-15,21587,8,2999,299,11,33,24937
2015-06-16,20834,15,2506,313,10,30,23708
2015-06-17,21074,14,2534,346,8,30,24006
2015-06-18,19724,20,2182,306,4,29,22265
2015-06-19,24482,15,2129,374,11,31,27042
2015-06-20,27623,19,1135,387,6,32,29202
2015-06-21,21770,19,857,311,8,34,22999
2015-06-22,25758,15,1846,286,10,35,27950
2015-06-23,20636,15,2404,316,1,31,23403
2015-06-24,23836,18,2600,301,5,30,26790
2015-06-25,25701,18,1332,367,6,32,27456
2015-06-26,23155,21,1947,315,7,33,25478
2015-06-27,24879,23,1049,361,6,36,26354
2015-06-28,22223,18,983,303,9,32,23568
2015-06-29,21642,19,2633,292,14,29,24629
2015-06-30,20575,23,2615,258,11,29,23511
2015-07-01,21516,20,2573,293,12,36,24450
2015-07-02,21055,21,2303,274,2,30,23685
2015-07-03,21719,17,1826,293,5,30,23890
2015-07-04,21437,21,802,260,3,34,22557
2015-07-05,22054,13,782,263,9,32,23153
2015-07-06,20980,19,2705,280,10,30,24024
2015-07-07,19901,23,2428,288,5,34,22679
2015-07-08,19521,20,2328,249,9,31,22158
2015-07-09,23848,18,2196,302,4,33,26401
2015-07-10,24752,18,2135,270,8,33,27216
2015-07-11,24833,22,870,285,6,19,26035
2015-07-12,22203,20,836,241,8,44,23352
2015-07-13,22040,21,2483,290,7,32,24873
2015-07-14,21418,21,2560,298,8,29,24334
2015-07-15,22640,16,2249,274,9,32,25220
2015-07-16,23199,18,2366,266,10,32,25891
2015-07-17,23717,19,1819,294,6,26,25881
2015-07-18,26434,18,709,280,5,32,27478
2015-07-19,22907,18,791,265,8,31,24020
2015-07-20,24168,19,2541,228,9,35,27000
2015-07-21,22099,22,2182,285,13,31,24632
2015-07-22,21737,19,2293,253,4,33,24339
2015-07-23,20121,19,1910,273,7,28,22358
2015-07-24,22885,12,1977,234,8,33,25149
2015-07-25,27555,22,853,369,10,33,28842
2015-07-26,20876,26,609,246,7,32,21796
2015-07-27,21385,16,2351,275,8,41,24076
2015-07-28,20902,24,2454,256,9,31,23676
2015-07-29,20596,20,2059,294,9,28,23006
2015-07-30,23002,24,2244,293,8,31,25602
2015-07-31,22709,16,1602,295,5,35,24662
2015-08-01,27510,21,738,286,11,32,28598
2015-08-02,22884,7,740,265,9,32,23937
2015-08-03,23587,19,2569,236,9,29,26449
2015-08-04,22312,22,2123,252,14,34,24757
2015-08-05,26254,21,1533,268,5,34,28115
2015-08-06,23411,20,1952,247,11,32,25673
2015-08-07,24607,19,1627,289,6,34,26582
2015-08-08,28012,17,989,282,13,34,29347
2015-08-09,24669,21,775,249,10,32,25756
2015-08-10,26559,20,2353,265,14,34,29245
2015-08-11,22543,20,1928,288,7,35,24821
2015-08-12,23595,12,2026,245,10,32,25920
2015-08-13,27045,26,1831,236,8,34,29180
2015-08-14,29536,23,1790,266,6,33,31654
2015-08-15,31107,26,598,341,6,33,32111
2015-08-16,24075,21,737,249,9,33,25124
2015-08-17,23648,22,2272,233,10,32,26217
2015-08-18,24246,25,2136,277,7,33,26724
2015-08-19,22043,20,1818,269,9,31,24190
2015-08-20,22431,20,1866,248,7,31,24603
2015-08-21,25146,18,1991,258,10,29,27452
2015-08-22,28859,22,756,326,12,33,30008
2015-08-23,22790,17,685,304,15,31,23842
2015-08-24,22333,20,2490,276,9,33,25161
2015-08-25,20810,20,2129,265,13,30,23267
2015-08-26,23276,25,2323,295,15,32,25966
2015-08-27,23157,21,2098,285,9,32,25602
2015-08-28,24514,16,1843,249,8,34,26664
2015-08-29,25324,25,869,279,7,31,26535
2015-08-30,26057,19,846,295,11,32,27260
2015-08-31,21850,15,2537,273,9,35,24719
2015-09-01,20288,22,2373,276,7,33,22999
2015-09-02,21151,22,2636,252,9,33,24103
2015-09-03,22391,23,2245,260,10,29,24958
2015-09-04,23794,25,1993,277,8,30,26127
2015-09-05,25032,20,885,287,3,32,26259
2015-09-06,21727,18,726,281,14,34,22800
2015-09-07,20956,21,2925,250,16,33,24201
2015-09-08,20915,24,2502,330,10,32,23813
2015-09-09,22123,21,2543,325,7,36,25055
2015-09-10,22884,23,2260,301,7,30,25505
2015-09-11,25327,24,2004,277,9,28,27669
2015-09-12,27865,21,985,323,5,29,29228
2015-09-13,23288,16,702,331,12,32,24381
2015-09-14,20812,16,2935,287,6,32,24088
2015-09-15,21852,20,2345,277,10,33,24537
2015-09-16,20469,16,2175,307,6,22,22995
2015-09-17,20410,22,2287,300,8,30,23057
2015-09-18,21387,13,2286,273,5,32,23996
2015-09-19,24401,9,917,307,7,36,25677
2015-09-20,20287,11,662,285,19,34,21298
2015-09-21,20784,9,2878,304,15,33,24023
2015-09-22,18578,7,2237,267,6,34,21129
2015-09-23,19164,10,2111,327,5,28,21645
2015-09-24,19483,10,1566,314,5,29,21407
2015-09-25,21453,13,1709,362,5,32,23574
2015-09-26,24024,11,1148,387,3,33,25606
2015-09-27,20173,14,819,329,5,31,21371
2015-09-28,20082,10,2290,313,10,32,22737
2015-09-29,19721,15,2522,287,6,30,22581
2015-09-30,19243,10,2408,295,7,31,21994
2015-10-01,20195,7,2243,254,5,26,22730
2015-10-02,21723,9,1963,297,8,33,24033
2015-10-03,23951,10,1064,376,3,30,25434
2015-10-04,20116,3,841,278,10,29,21277
2015-10-05,20242,17,2519,306,17,28,23129
2015-10-06,18919,17,2552,247,4,29,21768
2015-10-07,21605,10,2868,297,5,31,24816
2015-10-08,29967,9,1786,303,5,30,32100
2015-10-09,23109,14,2082,332,7,29,25573
2015-10-10,20934,16,827,287,14,30,22108
2015-10-11,18525,13,688,309,3,29,19567
2015-10-12,20371,13,2638,247,9,22,23300
2015-10-13,18639,19,2409,237,5,25,21334
2015-10-14,19305,18,2319,245,8,29,21924
2015-10-15,20519,17,2446,234,6,26,23248
2015-10-16,21817,13,1940,286,3,25,24084
2015-10-17,25468,15,965,328,10,26,26812
2015-10-18,19364,9,737,265,34,32,20441
2015-10-19,19424,10,2633,245,8,24,22344
2015-10-20,19104,11,2662,263,3,24,22067
2015-10-21,18950,9,2214,269,5,26,21473
2015-10-22,20246,11,3024,275,2,23,23581
2015-10-23,21117,13,1874,274,4,24,23306
2015-10-24,23710,11,1010,247,2,22,25002
2015-10-25,20432,14,800,264,2,23,21535
2015-10-26,20007,13,2781,176,5,22,23004
2015-10-27,19407,10,2668,205,12,20,22322
2015-10-28,20132,10,2669,246,6,24,23087
2015-10-29,20732,11,2132,179,5,21,23080
2015-10-30,25339,12,2188,186,1,22,27748
2015-10-31,31180,17,871,207,2,17,32294
2015-11-01,25496,15,775,140,1,21,26448
2015-11-02,21655,12,2397,149,9,19,24241
2015-11-03,19228,14,2457,180,4,20,21903
2015-11-04,17855,16,2340,171,1,21,20404
2015-11-05,19611,11,2397,175,5,24,22223
2015-11-06,21874,16,1891,226,3,23,24033
2015-11-07,24863,16,1045,196,2,18,26140
2015-11-08,19707,17,927,164,2,22,20839
2015-11-09,19167,9,2923,155,3,23,22280
2015-11-10,20106,18,2309,164,0,19,22616
2015-11-11,19979,13,2532,510,3,23,23060
2015-11-12,19113,14,2351,142,5,22,21647
2015-11-13,20428,9,1960,185,3,20,22605
2015-11-14,23886,16,861,216,3,17,24999
2015-11-15,20510,12,750,166,4,20,21462
2015-11-16,18019,15,2715,164,4,22,20939
2015-11-17,20396,15,2272,152,2,19,22856
2015-11-18,18715,14,2671,199,4,24,21627
2015-11-19,20487,14,2258,185,3,20,22967
2015-11-20,21786,15,2018,163,5,20,24007
2015-11-21,22548,18,1347,212,2,18,24145
2015-11-22,17841,15,766,195,1,19,18837
2015-11-23,19539,14,2797,143,4,23,22520
2015-11-24,17976,15,2617,124,2,19,20753
2015-11-25,18305,14,2605,157,3,24,21108
2015-11-26,18923,16,2271,169,2,21,21402
2015-11-27,20624,10,1994,161,3,21,22813
2015-11-28,20819,16,783,249,3,16,21886
2015-11-29,17832,14,1021,176,3,23,19069
2015-11-30,18715,17,2187,143,6,22,21090
2015-12-01,19418,13,3032,132,2,19,22616
2015-12-02,19434,13,2426,135,5,24,22037
2015-12-03,19534,12,2316,137,7,17,22023
2015-12-04,20998,14,1978,182,4,21,23197
2015-12-05,21980,19,1038,315,3,17,23372
2015-12-06,16445,13,802,196,2,17,17475
2015-12-07,18633,15,2317,130,1,20,21116
2015-12-08,19408,14,2148,141,4,17,21732
2015-12-09,18143,16,2319,152,7,25,20662
2015-12-10,20126,14,2195,142,4,20,22501
2015-12-11,20991,21,1885,190,5,21,23113
2015-12-12,22755,17,1006,433,4,17,24232
2015-12-13,18209,15,796,227,2,20,19269
2015-12-14,19504,16,2460,131,7,21,22139
2015-12-15,19628,30,2630,132,2,18,22440
2015-12-16,19609,19,2062,132,4,24,21850
2015-12-17,20813,20,2292,159,6,20,23310
2015-12-18,22003,17,1797,181,7,20,24025
2015-12-19,23804,16,1018,361,3,19,25221
2015-12-20,18075,18,830,174,2,18,19117
2015-12-21,22693,16,2854,136,4,18,25721
2015-12-22,23197,19,2301,154,2,18,25691
2015-12-23,23891,19,1787,151,0,21,25869
2015-12-24,19629,27,548,118,1,10,20333
2015-12-25,13162,8,202,71,1,0,13444
2015-12-26,21450,16,277,120,1,17,21881
2015-12-27,18983,12,453,159,3,16,19626
2015-12-28,20285,18,1442,134,6,19,21904
2015-12-29,20307,21,1265,144,6,19,21762
2015-12-30,26814,21,1172,202,4,21,28234
2015-12-31,19646,21,416,192,5,11,20291
2016-01-01,11027,12,124,110,2,9,11284
2016-01-02,27806,14,310,263,0,17,28410
2016-01-03,16527,16,396,190,1,24,17154
2016-01-04,16664,17,1450,110,0,22,18263
2016-01-05,17579,20,1288,127,2,16,19032
2016-01-06,17344,13,796,152,1,23,18329
2016-01-07,16076,15,1126,138,2,20,17377
2016-01-08,19265,21,1173,141,4,20,20624
2016-01-09,23580,21,627,199,3,16,24446
2016-01-10,18342,15,808,145,2,22,19334
2016-01-11,19497,20,2144,157,1,19,21838
2016-01-12,17295,19,2153,127,2,19,19615
2016-01-13,18330,24,1976,159,1,22,20512
2016-01-14,16960,18,2006,144,1,19,19148
2016-01-15,19508,19,1728,140,0,22,21417
2016-01-16,21693,14,1037,175,0,16,22935
2016-01-17,15526,12,808,131,1,22,16500
2016-01-18,16307,18,2358,124,2,19,18828
2016-01-19,17536,14,2098,136,4,17,19805
2016-01-20,17855,17,1803,144,3,22,19844
2016-01-21,18756,19,2187,168,2,18,21150
2016-01-22,18834,15,1739,138,1,19,20746
2016-01-23,21260,19,997,177,0,13,22466
2016-01-24,16099,13,874,136,2,19,17143
2016-01-25,17280,20,2387,143,3,21,19854
2016-01-26,15630,21,2106,117,0,17,17891
2016-01-27,17096,15,2239,141,1,23,19515
2016-01-28,18507,14,2364,148,5,20,21058
2016-01-29,19364,17,1913,159,4,22,21479
2016-01-30,20935,22,830,185,0,17,21989
2016-01-31,16852,12,791,132,2,18,17807
2016-02-01,18475,19,2237,134,4,19,20888
2016-02-02,17796,19,2066,133,2,16,20032
2016-02-03,16080,20,2066,145,2,21,18334
2016-02-04,18658,18,2196,152,3,19,21046
2016-02-05,20534,18,1880,156,6,20,22614
2016-02-06,22713,22,848,198,1,16,23798
2016-02-07,16947,17,842,154,2,21,17983
2016-02-08,19567,18,1906,144,0,20,21655
2016-02-09,18318,14,2357,165,0,17,20871
2016-02-10,17764,18,2346,159,0,22,20309
2016-02-11,19563,11,2158,159,2,20,21913
2016-02-12,21488,18,1933,156,1,21,23617
2016-02-13,22678,22,984,191,0,14,23889
2016-02-14,17890,16,699,136,2,20,18763
2016-02-15,19413,20,2577,140,1,20,22171
2016-02-16,18576,19,2249,125,1,19,20989
2016-02-17,18004,19,2222,160,2,20,20427
2016-02-18,19354,20,2192,146,2,20,21734
2016-02-19,21664,19,1790,157,0,26,23656
2016-02-20,23480,14,844,225,1,17,24581
2016-02-21,18743,16,967,139,4,22,19891
2016-02-22,19056,22,2656,121,2,21,21878
2016-02-23,18752,22,2401,151,2,18,21346
2016-02-24,18823,23,2510,155,5,23,21539
2016-02-25,18941,21,2380,155,4,20,21521
2016-02-26,20644,22,1831,182,3,18,22700
2016-02-27,23573,22,873,174,3,17,24662
2016-02-28,17291,12,848,131,0,21,18303
2016-02-29,18513,22,2448,143,2,19,21147
2016-03-01,18267,21,2346,142,4,19,20799
2016-03-02,19584,18,2239,153,2,23,22019
2016-03-03,19628,17,2253,206,2,21,22127
2016-03-04,20238,14,2001,168,2,20,22443
2016-03-05,23047,17,1014,248,1,18,24345
2016-03-06,17348,15,790,173,1,22,18349
2016-03-07,19713,13,2667,143,2,20,22558
2016-03-08,18962,15,2515,147,4,21,21664
2016-03-09,18660,19,2442,171,3,22,21317
2016-03-10,21479,26,2508,166,3,21,24203
2016-03-11,22056,20,2025,200,2,22,24325
2016-03-12,24855,20,1188,238,1,17,26319
2016-03-13,17942,18,926,199,1,21,19107
2016-03-14,18832,19,2411,159,2,25,21448
2016-03-15,20154,17,2750,169,5,18,23113
2016-03-16,19169,18,2573,160,0,25,21945
2016-03-17,20014,19,2386,181,5,21,22626
2016-03-18,22351,16,1752,196,3,25,24343
2016-03-19,26227,21,840,235,4,17,27344
2016-03-20,20550,9,813,222,11,22,21627
2016-03-21,20162,20,2918,166,2,22,23290
2016-03-22,22375,21,2538,142,2,18,25096
2016-03-23,21155,23,2734,183,3,19,24117
2016-03-24,24740,21,2402,151,5,20,27339
2016-03-25,22745,17,1383,171,2,22,24340
2016-03-26,23957,21,468,179,2,17,24644
2016-03-27,15440,11,417,82,5,24,15979
2016-03-28,25093,10,912,180,4,24,26223
2016-03-29,21058,16,2970,198,6,20,24268
2016-03-30,20459,19,2711,160,7,21,23377
2016-03-31,20512,20,2130,193,5,23,22883
2016-04-01,22779,19,2090,243,5,20,25156
2016-04-02,23390,18,926,261,4,19,24618
2016-04-03,21183,15,783,183,3,23,22190
2016-04-04,20165,14,2763,160,8,23,23133
2016-04-05,19256,20,2735,177,12,21,22221
2016-04-06,17878,15,2433,187,8,23,20544
2016-04-07,20139,21,2379,205,5,23,22772
2016-04-08,23022,18,1722,219,5,23,25009
2016-04-09,25341,25,1116,249,5,18,26754
2016-04-10,18360,17,786,216,5,24,19408
2016-04-11,21748,15,2826,218,4,24,24835
2016-04-12,19754,19,2596,200,5,24,22598
2016-04-13,19431,21,2928,189,7,22,22598
2016-04-14,21397,25,2580,241,5,24,24272
2016-04-15,24460,22,2187,241,5,24,26939
2016-04-16,25997,18,989,277,4,21,27306
2016-04-17,21557,9,772,191,16,24,22569
2016-04-18,20715,25,3047,218,4,26,24035
2016-04-19,2943,0,342,4,2,0,3291
2016-04-20,15769,10,2044,146,6,5,17980
2016-04-21,18395,18,2141,189,8,35,20786
2016-04-22,21810,23,2279,237,4,26,24379
2016-04-23,22355,23,927,259,2,6,23572
2016-04-24,19301,14,759,207,11,23,20315
2016-04-25,22361,18,2883,239,5,25,25531
2016-04-26,20011,18,2926,245,3,26,23229
2016-04-27,20673,18,2126,260,5,19,23101
2016-04-28,22308,14,2773,273,9,27,25404
2016-04-29,23743,22,2064,274,4,32,26139
2016-04-30,25138,20,926,304,6,27,26421
2016-05-01,18896,16,701,199,6,28,19846
2016-05-02,20084,18,1693,207,11,33,22046
2016-05-03,21624,26,2639,230,9,27,24555
2016-05-04,20797,26,2353,284,8,29,23497
2016-05-05,23781,22,2522,257,4,25,26611
2016-05-06,24956,18,2337,324,2,30,27667
2016-05-07,26277,19,1154,319,4,30,27803
2016-05-08,21707,20,795,280,6,28,22836
2016-05-09,21480,18,3126,216,9,30,24879
2016-05-10,22608,19,2414,224,5,28,25298
2016-05-11,22271,22,2169,241,2,29,24734
2016-05-12,21703,26,2217,275,6,27,24254
2016-05-13,23924,25,1862,339,1,27,26178
2016-05-14,26931,15,991,614,2,30,28583
2016-05-15,21734,13,698,339,3,27,22814
2016-05-16,23163,32,2657,263,10,30,26155
2016-05-17,21274,29,2618,299,5,28,24253
2016-05-18,21601,22,2733,283,5,30,24674
2016-05-19,22913,29,2504,309,2,32,25789
2016-05-20,24047,24,2100,342,3,32,26548
2016-05-21,25440,22,936,369,3,31,26801
2016-05-22,21794,18,762,245,5,32,22856
2016-05-23,22040,21,2883,262,9,28,25243
2016-05-24,21097,23,2513,271,6,32,23942
2016-05-25,22292,23,2201,327,7,32,24882
2016-05-26,28419,15,1288,352,4,30,30108
2016-05-27,23320,23,2079,259,4,34,25719
2016-05-28,25076,23,1149,380,5,49,26682
2016-05-29,22396,18,728,328,8,32,23510
2016-05-30,21296,17,2779,220,8,31,24351
2016-05-31,20030,25,2719,276,7,30,23087
2016-06-01,20715,24,2433,232,4,30,23438
2016-06-02,21787,26,2248,284,7,36,24388
2016-06-03,24543,15,2078,315,3,33,26987
2016-06-04,26679,19,887,342,4,30,27961
2016-06-05,21190,17,962,268,8,32,22477
2016-06-06,21609,19,2865,236,12,31,24772
2016-06-07,20464,27,2962,275,11,11,23750
2016-06-08,20520,21,2861,251,11,29,23693
2016-06-09,21991,26,2778,240,2,29,25066
2016-06-10,25636,22,2230,301,7,25,28221
2016-06-11,26406,18,988,355,2,32,27801
2016-06-12,19987,16,747,237,8,30,21025
2016-06-13,22260,26,3158,237,7,12,25700
2016-06-14,20384,22,2415,265,13,31,23130
2016-06-15,22746,19,2566,271,7,33,25642
2016-06-16,22620,21,2419,273,2,34,25369
2016-06-17,21651,24,2070,313,6,34,24098
2016-06-18,26654,20,961,353,8,34,28030
2016-06-19,22142,20,864,276,12,33,23347
2016-06-20,22484,20,2991,286,18,32,25831
2016-06-21,20681,22,2358,300,6,36,23403
2016-06-22,27095,17,1797,257,9,34,29209
2016-06-23,22817,26,2201,295,4,36,25379
2016-06-24,25144,25,2186,337,11,30,27733
2016-06-25,25257,21,718,372,9,37,26414
2016-06-26,20780,17,662,226,15,34,21734
2016-06-27,22597,21,2716,252,8,34,25628
2016-06-28,21719,25,2534,276,15,28,24597
2016-06-29,20483,23,2608,240,7,32,23393
2016-06-30,22265,26,2247,288,9,31,24866
2016-07-01,24101,24,1835,300,9,34,26303
2016-07-02,25780,21,954,305,8,30,27098
2016-07-03,22151,23,869,264,16,31,23354
2016-07-04,23097,24,3028,265,6,37,26457
2016-07-05,21561,21,2232,303,11,35,24163
2016-07-06,20832,23,2297,266,12,29,23459
2016-07-07,22839,22,2385,264,10,31,25551
2016-07-08,24540,26,2081,296,18,30,26991
2016-07-09,26184,19,779,294,6,32,27314
2016-07-10,21983,19,828,229,11,25,23095
2016-07-11,23603,19,2966,205,4,34,26831
2016-07-12,22364,29,2492,253,12,36,25186
2016-07-13,21409,21,2082,237,13,31,23793
2016-07-14,24277,24,2591,261,2,35,27190
2016-07-15,26239,29,1993,266,4,34,28565
2016-07-16,26665,22,1033,269,8,37,28034
2016-07-17,22580,19,890,244,11,31,23775
2016-07-18,23608,16,2943,233,11,22,26833
2016-07-19,22911,24,2229,233,10,36,25443
2016-07-20,23964,18,2316,249,11,26,26584
2016-07-21,24833,21,2619,263,10,31,27777
2016-07-22,25154,24,2185,257,9,32,27661
2016-07-23,25492,25,726,258,12,35,26548
2016-07-24,22713,24,803,253,11,35,23839
2016-07-25,24018,22,2786,252,8,37,27123
2016-07-26,22167,25,2526,245,11,32,25006
2016-07-27,21505,26,2395,222,10,33,24191
2016-07-28,24053,20,2174,262,12,31,26552
2016-07-29,23529,29,1535,272,13,35,25413
2016-07-30,26009,27,780,297,11,30,27154
2016-07-31,22928,23,737,279,10,36,24013
2016-08-01,25616,26,2010,262,10,31,27955
2016-08-02,22743,27,2447,236,12,29,25494
2016-08-03,22802,27,2217,229,12,35,25322
2016-08-04,25869,30,1930,279,16,34,28158
2016-08-05,29612,18,1161,320,11,35,31157
2016-08-06,26721,24,676,278,11,33,27743
2016-08-07,25414,15,922,237,9,36,26633
2016-08-08,24175,24,2747,254,23,32,27255
2016-08-09,24283,26,2157,267,10,38,26781
2016-08-10,24542,26,2179,266,7,33,27053
2016-08-11,29517,30,2130,287,15,30,32009
2016-08-12,28619,25,2131,275,15,36,31101
2016-08-13,33009,27,778,307,8,39,34168
2016-08-14,29624,23,585,236,9,36,30513
2016-08-15,28960,21,716,222,6,33,29958
2016-08-16,27653,25,2942,253,13,32,30918
2016-08-17,25588,22,2171,294,10,34,28119
2016-08-18,26835,28,1871,258,13,31,29036
2016-08-19,29364,23,1757,267,10,31,31452
2016-08-20,29561,20,849,449,9,36,30924
2016-08-21,24928,23,714,258,16,33,25972
2016-08-22,26704,22,2322,275,11,34,29368
2016-08-23,24870,25,2749,270,10,30,27954
2016-08-24,22357,29,2263,249,8,33,24939
2016-08-25,24172,26,1879,283,12,27,26399
2016-08-26,27592,19,1888,278,12,34,29823
2016-08-27,29684,23,836,337,12,33,30925
2016-08-28,26625,18,773,283,9,41,27749
2016-08-29,23351,25,2641,294,8,37,26356
2016-08-30,23512,27,2315,289,9,37,26189
2016-08-31,22006,23,2832,287,11,32,25191
2016-09-01,23561,21,2120,269,10,34,26015
2016-09-02,25677,27,1943,284,7,34,27972
2016-09-03,31071,24,871,325,3,35,32329
2016-09-04,22344,16,786,281,11,33,23471
2016-09-05,24307,24,2603,257,15,33,27239
2016-09-06,22241,22,2720,316,12,34,25345
2016-09-07,22579,19,2602,306,6,31,25543
2016-09-08,23558,21,2547,284,10,30,26450
2016-09-09,24196,23,1805,275,7,35,26341
2016-09-10,28039,23,1012,374,6,33,29487
2016-09-11,24487,15,824,291,9,35,25661
2016-09-12,23153,23,2570,269,10,30,26055
2016-09-13,21052,27,2253,271,7,34,23644
2016-09-14,22582,24,2602,307,8,25,25548
2016-09-15,24326,21,2469,290,8,30,27144
2016-09-16,25425,18,1992,326,6,32,27799
2016-09-17,28363,19,961,343,6,34,29726
2016-09-18,22709,16,803,325,8,29,23890
2016-09-19,24695,24,2740,267,11,33,27770
2016-09-20,22682,24,2495,285,8,34,25528
2016-09-21,22439,28,2333,278,2,17,25097
2016-09-22,23879,29,2384,275,7,31,26605
2016-09-23,23465,25,1588,282,8,33,25401
2016-09-24,28028,19,1175,359,5,35,29621
2016-09-25,21714,28,768,279,30,24,22843
2016-09-26,22606,25,2759,273,11,32,25706
2016-09-27,22000,26,2204,262,8,32,24532
2016-09-28,21679,16,3066,264,9,30,25064
2016-09-29,23551,27,2392,251,15,31,26267
2016-09-30,25083,24,2075,320,5,33,27540
2016-10-01,27010,22,869,336,14,32,28283
2016-10-02,22992,19,765,262,8,35,24081
2016-10-03,24306,22,3230,291,9,33,27891
2016-10-04,21618,19,2544,269,7,36,24493
2016-10-05,22176,20,2535,289,9,31,25060
2016-10-06,22435,17,2289,284,7,28,25060
2016-10-07,24935,26,2364,362,6,30,27723
2016-10-08,29386,16,999,417,10,32,30860
2016-10-09,21155,20,729,286,3,34,22227
2016-10-10,22119,18,3152,243,8,33,25573
2016-10-11,21737,21,2883,258,9,26,24934
2016-10-12,22718,22,2617,264,6,29,25656
2016-10-13,21753,19,2230,282,10,29,24323
2016-10-14,23789,15,2220,270,5,32,26331
2016-10-15,27217,26,1126,374,4,31,28778
2016-10-16,23046,23,1120,305,7,31,24532
2016-10-17,21032,23,3224,223,9,27,24538
2016-10-18,20499,20,2675,236,8,28,23466
2016-10-19,21153,30,2741,249,4,27,24204
2016-10-20,21641,25,2155,269,3,25,24118
2016-10-21,23377,22,1822,295,5,31,25552
2016-10-22,25814,18,797,295,4,28,26956
2016-10-23,20293,21,911,248,4,28,21505
2016-10-24,20295,24,3164,234,3,25,23745
2016-10-25,18265,22,2032,173,8,8,20508
2016-10-26,19550,25,2202,209,12,6,22004
2016-10-27,19574,25,2342,204,5,4,22154
2016-10-28,24095,21,1633,248,3,26,26026
2016-10-29,29036,25,920,279,7,13,30280
2016-10-30,24575,20,594,178,1,0,25368
2016-10-31,25764,27,979,157,5,21,26953
2016-11-01,28283,21,1032,174,2,9,29521
2016-11-02,22757,26,3044,183,3,3,26016
2016-11-03,21323,23,2227,189,4,1,23767
2016-11-04,21732,28,1658,212,7,21,23658
2016-11-05,24065,23,1029,202,4,2,25325
2016-11-06,18889,23,763,163,2,3,19843
2016-11-07,18448,21,2915,159,5,4,21552
2016-11-08,18758,26,2803,165,3,4,21759
2016-11-09,19120,23,2380,189,3,4,21719
2016-11-10,19651,22,2207,173,4,0,22057
2016-11-11,20707,22,2061,206,3,3,23002
2016-11-12,21920,21,766,202,1,20,22930
2016-11-13,18708,20,729,213,2,23,19695
2016-11-14,18964,134,2465,152,4,8,21727
2016-11-15,19070,22,2578,153,2,21,21846
2016-11-16,19236,24,2332,167,4,22,21785
2016-11-17,20089,26,2255,201,5,22,22598
2016-11-18,19950,21,1888,181,3,4,22047
2016-11-19,23216,21,875,264,3,17,24396
2016-11-20,18055,20,825,175,1,22,19098
2016-11-21,18765,26,2937,181,4,22,21935
2016-11-22,17684,37,2368,144,4,23,20260
2016-11-23,18322,20,2580,191,3,22,21138
2016-11-24,19286,21,2228,160,6,24,21725
2016-11-25,20877,22,1966,196,3,21,23085
2016-11-26,21737,28,1003,241,5,16,23030
2016-11-27,18222,20,782,174,1,21,19220
2016-11-28,20373,18,2805,154,4,22,23376
2016-11-29,18191,22,2536,156,3,21,20929
2016-11-30,17813,21,2552,163,3,23,20575
2016-12-01,19164,23,2379,163,3,18,21750
2016-12-02,20661,22,1964,188,4,21,22860
2016-12-03,22459,25,904,356,4,19,23767
2016-12-04,18660,19,808,188,2,22,19699
2016-12-05,18335,28,3134,149,2,19,21667
2016-12-06,18622,29,2507,154,2,23,21337
2016-12-07,17221,24,2134,158,2,23,19562
2016-12-08,18954,27,2137,178,4,22,21322
2016-12-09,19935,23,2130,196,4,16,22304
2016-12-10,24272,32,1234,511,8,17,26074
2016-12-11,19090,18,732,236,1,21,20098
2016-12-12,19397,22,2801,156,3,19,22398
2016-12-13,18298,20,2769,139,5,19,21250
2016-12-14,18146,25,2145,163,7,22,20508
2016-12-15,20041,22,2170,187,7,22,22449
2016-12-16,21380,17,1777,210,2,21,23407
2016-12-17,23131,25,968,428,4,36,24592
2016-12-18,17844,20,962,215,4,22,19067
2016-12-19,20132,20,2880,160,1,22,23215
2016-12-20,18762,21,2259,167,2,23,21234
2016-12-21,20635,22,2433,148,3,18,23259
2016-12-22,21200,26,2228,179,6,22,23661
2016-12-23,23441,20,1369,167,2,20,25019
2016-12-24,17909,28,488,119,0,10,18554
2016-12-25,11597,13,142,81,0,0,11833
2016-12-26,21462,14,1031,132,0,19,22658
2016-12-27,21717,22,1521,143,3,4,23410
2016-12-28,22123,22,1424,164,0,21,23754
2016-12-29,22616,17,1278,165,2,24,24102
2016-12-30,25811,26,820,251,3,22,26933
2016-12-31,19363,20,301,130,0,10,19824
2017-01-01,12481,17,239,112,1,16,12866
2017-01-02,21770,25,983,172,3,21,22974
2017-01-03,20203,27,1805,187,0,22,22244
2017-01-04,21361,28,1322,145,2,20,22878
2017-01-05,21744,28,1442,150,0,18,23382
2017-01-06,20205,17,468,172,0,15,20877
2017-01-07,24207,28,416,235,1,18,24905
2017-01-08,18848,13,630,174,1,19,19685
2017-01-09,19456,25,2048,124,0,21,21674
2017-01-10,19205,18,1954,122,0,21,21320
2017-01-11,17437,29,1780,123,5,22,19396
2017-01-12,19587,20,1883,162,1,24,21677
2017-01-13,17576,19,1306,143,0,20,19064
2017-01-14,17535,19,821,188,3,18,18584
2017-01-15,15624,23,719,128,1,19,16514
2017-01-16,17094,21,2634,145,0,22,19916
2017-01-17,12853,24,1534,136,0,23,14570
2017-01-18,13551,21,1870,121,0,23,15586
2017-01-19,16134,26,2023,156,1,22,18362
2017-01-20,18136,29,1665,163,0,24,20017
2017-01-21,19884,24,673,180,0,18,20779
2017-01-22,15862,23,682,147,2,21,16737
2017-01-23,17184,20,2639,145,2,23,20013
2017-01-24,15675,22,2164,137,4,23,18025
2017-01-25,16849,31,2060,142,2,22,19106
2017-01-26,17649,24,2044,140,0,23,19880
2017-01-27,19214,32,1783,164,3,20,21216
2017-01-28,20386,22,782,199,0,18,21407
2017-01-29,15225,22,795,162,1,21,16226
2017-01-30,17115,22,2705,121,1,23,19987
2017-01-31,17054,25,2344,157,0,22,19602
2017-02-01,15970,25,2138,135,3,22,18293
2017-02-02,17620,25,1946,146,2,21,19760
2017-02-03,19645,24,1776,145,0,22,21612
2017-02-04,21821,28,880,168,0,17,22914
2017-02-05,15655,22,710,154,1,21,16563
2017-02-06,18540,24,2524,127,1,21,21237
2017-02-07,16663,24,2260,128,1,21,19097
2017-02-08,17913,31,1799,132,1,23,19899
2017-02-09,18968,25,2552,161,0,20,21726
2017-02-10,20814,26,1610,169,2,21,22642
2017-02-11,22875,29,972,190,2,17,24085
2017-02-12,18509,27,599,158,2,20,19315
2017-02-13,19709,25,2929,157,2,23,22845
2017-02-14,18304,26,2385,137,3,21,20876
2017-02-15,18513,21,2297,144,3,20,20998
2017-02-16,19979,24,1974,161,0,23,22161
2017-02-17,20921,18,1680,188,0,20,22827
2017-02-18,23034,26,848,197,0,16,24121
2017-02-19,18636,26,833,145,3,21,19664
2017-02-20,19875,28,2957,132,3,21,23016
2017-02-21,18072,25,2543,143,3,24,20810
2017-02-22,18530,25,2385,139,5,20,21104
2017-02-23,18677,25,2451,151,3,22,21329
2017-02-24,21102,25,1814,161,2,22,23126
2017-02-25,22372,22,868,257,2,16,23537
2017-02-26,18409,27,1038,177,1,22,19674
2017-02-27,18278,27,2771,133,5,19,21233
2017-02-28,17875,25,2612,138,1,22,20673
2017-03-01,19742,27,2608,157,2,23,22559
2017-03-02,19436,29,2377,159,2,22,22025
2017-03-03,21091,25,1804,178,5,20,23123
2017-03-04,24323,21,1021,225,2,15,25607
2017-03-05,19789,13,875,213,5,20,20915
2017-03-06,19653,22,2658,138,4,22,22497
2017-03-07,18511,23,2385,152,2,21,21094
2017-03-08,19049,21,2429,183,4,21,21707
2017-03-09,19324,20,2575,174,4,21,22118
2017-03-10,21627,24,1707,189,3,23,23573
2017-03-11,24957,16,971,221,3,20,26188
2017-03-12,19176,16,794,198,1,22,20207
2017-03-13,19307,25,3122,158,3,21,22636
2017-03-14,17831,27,2764,151,5,23,20801
2017-03-15,19857,25,2449,151,9,21,22512
2017-03-16,20924,30,2744,176,2,23,23899
2017-03-17,22705,22,2139,191,5,22,25084
2017-03-18,23523,27,833,218,3,18,24622
2017-03-19,20789,23,804,171,4,22,21813
2017-03-20,19654,26,2944,175,3,22,22824
2017-03-21,19645,22,3103,156,3,20,22949
2017-03-22,18951,24,2567,166,3,23,21734
2017-03-23,20125,26,2669,172,4,22,23018
2017-03-24,20033,24,1987,205,3,23,22275
2017-03-25,24899,16,1061,207,4,18,26205
2017-03-26,18683,22,726,183,1,5,19620
2017-03-27,19684,28,3266,142,2,41,23163
2017-03-28,18016,20,2861,182,3,18,21100
2017-03-29,19649,27,3085,192,6,6,22965
2017-03-30,20124,24,2756,205,3,2,23114
2017-03-31,22086,29,2224,208,5,6,24558
2017-04-01,24788,23,1141,288,3,22,26265
2017-04-02,20620,19,1136,182,4,3,21964
2017-04-03,20639,22,3479,177,4,4,24325
2017-04-04,19397,24,2864,161,7,5,22458
2017-04-05,20077,22,2569,222,7,20,22917
2017-04-06,20681,27,2654,214,6,24,23606
2017-04-07,22980,28,2430,280,11,21,25750
2017-04-08,24134,25,1241,327,4,18,25749
2017-04-09,20486,17,905,306,10,20,21744
2017-04-10,21291,19,3445,245,8,26,25034
2017-04-11,21798,23,3083,247,17,20,25188
2017-04-12,23993,25,3040,260,9,25,27352
2017-04-13,25369,32,2237,250,4,25,27917
2017-04-14,24307,15,1269,285,3,25,25904
2017-04-15,24478,30,610,243,0,15,25376
2017-04-16,17135,19,232,181,2,8,17577
2017-04-17,25540,21,979,300,2,7,26849
2017-04-18,28043,15,3207,302,5,23,31595
2017-04-19,24621,16,2941,268,8,25,27879
2017-04-20,24277,28,2868,231,4,5,27413
2017-04-21,26324,25,2621,356,7,6,29339
2017-04-22,26514,21,1281,427,5,20,28268
2017-04-23,21651,24,979,381,5,6,23046
2017-04-24,23449,24,3452,296,11,25,27257
2017-04-25,22354,30,3349,355,4,22,26114
2017-04-26,20834,25,3333,340,4,24,24560
2017-04-27,21185,24,2289,343,5,25,23871
2017-04-28,24417,22,2282,387,2,22,27132
2017-04-29,26085,20,1092,444,4,25,27670
2017-04-30,22356,29,466,362,14,27,23254
2017-05-01,19925,9,975,371,13,29,21322
2017-05-02,20851,23,2513,269,8,6,23670
2017-05-03,22706,30,3714,325,7,29,26811
2017-05-04,21819,24,2601,315,5,5,24769
2017-05-05,25063,28,2478,366,3,6,27944
2017-05-06,27261,25,1125,370,2,16,28799
2017-05-07,20512,17,774,347,2,13,21665
2017-05-08,22336,25,3650,293,11,6,26321
2017-05-09,21630,25,2994,301,6,6,24962
2017-05-10,21983,24,3001,277,7,13,25305
2017-05-11,22076,25,3016,357,5,12,25491
2017-05-12,21858,26,2368,365,2,6,24625
2017-05-13,24003,25,929,473,4,14,25448
2017-05-14,22296,20,839,297,16,12,23480
2017-05-15,22504,23,3138,345,13,14,26037
2017-05-16,20204,27,2991,333,4,6,23565
2017-05-17,21590,30,3046,327,3,7,25003
2017-05-18,22172,26,2502,321,9,31,25061
2017-05-19,23791,30,2448,410,8,32,26719
2017-05-20,25416,19,1282,479,2,19,27217
2017-05-21,21906,27,945,315,9,5,23207
2017-05-22,22086,22,3073,301,15,12,25509
2017-05-23,21635,25,3141,363,9,10,25183
2017-05-24,21452,23,2634,351,8,9,24477
2017-05-25,24403,25,2650,379,3,5,27465
2017-05-26,24258,24,2175,363,5,13,26838
2017-05-27,27926,26,1205,484,6,18,29665
2017-05-28,23137,23,1056,395,7,10,24628
2017-05-29,23139,27,3713,298,13,9,27199
2017-05-30,21360,30,3044,345,5,6,24790
2017-05-31,21135,23,2976,308,9,13,24464
2017-06-01,22033,34,2584,368,4,3,25026
2017-06-02,23622,30,1817,345,4,11,25829
2017-06-03,25334,12,934,422,5,16,26723
2017-06-04,23859,15,769,360,14,13,25030
2017-06-05,25850,28,3328,400,11,13,29630
2017-06-06,21209,29,3132,302,8,13,24693
2017-06-07,22833,29,2977,303,7,12,26161
2017-06-08,22594,21,2588,333,9,8,25553
2017-06-09,24857,24,2520,385,6,28,27820
2017-06-10,26554,28,1037,406,9,18,28052
2017-06-11,22184,25,902,330,14,7,23462
2017-06-12,23292,23,3573,330,24,13,27255
2017-06-13,21736,27,2946,347,14,6,25076
2017-06-14,23700,24,2731,346,10,12,26823
2017-06-15,30656,22,1658,406,5,11,32758
2017-06-16,25117,26,1865,451,4,8,27471
2017-06-17,27328,20,933,411,5,4,28701
2017-06-18,25395,22,1020,351,17,16,26821
2017-06-19,24613,31,2897,338,14,13,27906
2017-06-20,21988,23,2995,358,12,9,25385
2017-06-21,24569,26,2777,371,15,12,27770
2017-06-22,29540,21,1703,409,7,11,31691
2017-06-23,25096,27,1817,366,8,8,27322
2017-06-24,26495,27,979,465,11,18,27995
2017-06-25,21817,27,773,360,11,12,23000
2017-06-26,21659,28,3155,334,17,11,25204
2017-06-27,21561,31,2709,311,4,12,24628
2017-06-28,21944,27,2703,324,8,8,25014
2017-06-29,23344,28,2823,323,2,9,26529
2017-06-30,23876,28,2072,322,15,13,26326
2017-07-01,26487,20,934,367,10,16,27834
2017-07-02,22596,26,883,308,15,6,23834
2017-07-03,23489,26,3291,331,11,12,27160
2017-07-04,22489,21,2998,294,11,11,25824
2017-07-05,22851,25,2602,331,5,7,25821
2017-07-06,24347,18,2538,310,10,5,27228
2017-07-07,25755,27,2405,322,10,10,28529
2017-07-08,26606,21,964,387,7,20,28005
2017-07-09,24475,21,898,290,5,4,25693
2017-07-10,23859,28,3440,336,21,13,27697
2017-07-11,23228,21,2681,266,10,10,26216
2017-07-12,23914,22,2548,299,11,13,26807
2017-07-13,24417,26,2344,297,12,6,27102
2017-07-14,25949,31,2185,323,9,16,28513
2017-07-15,26590,24,849,314,8,6,27791
2017-07-16,23377,16,894,279,13,13,24592
2017-07-17,24341,26,3153,282,13,13,27828
2017-07-18,23428,26,2714,249,14,9,26440
2017-07-19,24029,26,2525,261,8,14,26863
2017-07-20,26395,28,2652,397,12,8,29492
2017-07-21,25595,23,2066,281,20,10,27995
2017-07-22,28479,27,1089,308,9,19,29931
2017-07-23,24905,15,735,257,13,17,25942
2017-07-24,23023,27,2961,275,15,37,26338
2017-07-25,22606,23,2372,226,19,8,25254
2017-07-26,23607,23,2558,264,8,15,26475
2017-07-27,23791,27,2219,271,8,11,26327
2017-07-28,24066,28,1885,241,10,16,26246
2017-07-29,26105,26,900,278,16,15,27340
2017-07-30,25121,18,768,283,11,14,26215
2017-07-31,24726,22,2618,203,20,17,27606
2017-08-01,25548,22,2392,250,12,13,28237
2017-08-02,24226,25,2212,234,9,15,26721
2017-08-03,25778,30,2289,263,10,7,28377
2017-08-04,27584,27,1742,274,11,10,29648
2017-08-05,29906,21,752,310,24,17,31030
2017-08-06,23520,19,626,241,12,6,24424
2017-08-07,25477,31,2655,266,16,12,28457
2017-08-08,24129,27,2515,261,19,10,26961
2017-08-09,25825,23,2201,245,10,9,28313
2017-08-10,25620,30,2039,245,14,5,27953
2017-08-11,27246,35,1671,272,4,11,29239
2017-08-12,30675,25,853,320,10,22,31905
2017-08-13,28932,19,504,313,12,13,29793
2017-08-14,29692,31,1845,249,14,12,31843
2017-08-15,31161,25,1070,314,9,10,32589
2017-08-16,27270,26,2670,262,10,13,30251
2017-08-17,28134,31,1965,240,9,12,30391
2017-08-18,26982,29,1590,259,12,8,28880
2017-08-19,31367,30,1015,290,10,20,32732
2017-08-20,27109,18,677,231,23,12,28070
2017-08-21,27987,31,2742,227,18,14,31019
2017-08-22,23729,27,2451,256,10,6,26479
2017-08-23,27046,27,2468,246,12,14,29813
2017-08-24,25043,26,2530,265,11,13,27888
2017-08-25,29533,29,1742,253,6,14,31577
2017-08-26,29995,29,847,307,12,17,31207
2017-08-27,24848,25,845,276,18,13,26025
2017-08-28,24986,28,3288,242,11,13,28568
2017-08-29,25955,24,2511,261,7,10,28768
2017-08-30,24514,29,2579,284,11,16,27433
2017-08-31,25685,26,2712,274,10,10,28717
2017-09-01,27145,28,1937,268,7,31,29416
2017-09-02,27428,32,887,257,9,19,28632
2017-09-03,23681,23,792,232,10,12,24750
2017-09-04,24827,31,3161,254,25,15,28313
2017-09-05,23823,29,2644,281,14,7,26798
2017-09-06,23206,32,2461,243,11,14,25967
2017-09-07,25691,31,2639,309,9,10,28689
2017-09-08,27574,32,2054,324,16,11,30011
2017-09-09,31014,29,945,288,10,14,32300
2017-09-10,24474,22,844,249,6,13,25608
2017-09-11,23759,29,3245,258,8,13,27312
2017-09-12,24230,29,3040,255,9,10,27573
2017-09-13,22793,26,2695,271,21,8,25814
2017-09-14,23925,27,2398,288,4,12,26654
2017-09-15,27828,24,2085,302,10,13,30262
2017-09-16,28783,28,1270,411,10,18,30520
2017-09-17,25794,22,975,298,9,5,27103
2017-09-18,23670,30,3594,249,41,14,27598
2017-09-19,24183,23,2566,265,8,11,27056
2017-09-20,24115,27,2605,342,9,14,27112
2017-09-21,25356,21,2511,400,11,12,28311
2017-09-22,25427,27,2175,271,11,12,27923
2017-09-23,29529,20,933,348,8,15,30853
2017-09-24,23723,23,1058,301,18,12,25135
2017-09-25,24096,32,2845,276,15,11,27275
2017-09-26,22626,24,2795,228,14,6,25693
2017-09-27,23339,28,2575,274,14,13,26243
2017-09-28,24778,26,2534,352,20,8,27718
2017-09-29,25775,27,1943,333,7,11,28096
2017-09-30,28909,28,1017,375,8,15,30352
2017-10-01,24227,28,868,294,23,12,25452
2017-10-02,23177,25,3331,274,11,10,26828
2017-10-03,22718,23,2688,249,6,9,25693
2017-10-04,22300,26,2627,268,17,8,25246
2017-10-05,23590,28,2235,295,13,4,26165
2017-10-06,25669,27,2225,363,12,10,28306
2017-10-07,28546,25,948,393,13,13,29938
2017-10-08,24450,31,809,288,9,5,25592
2017-10-09,21727,29,3050,286,11,8,25111
2017-10-10,22466,30,2610,322,7,7,25442
2017-10-11,22934,28,2239,287,6,12,25506
2017-10-12,22878,26,2594,272,10,3,25783
2017-10-13,24418,26,1865,313,6,10,26638
2017-10-14,27819,27,912,410,6,13,29187
2017-10-15,24573,20,822,290,9,10,25724
2017-10-16,21550,26,3054,268,11,7,24916
2017-10-17,21360,26,2633,237,11,5,24272
2017-10-18,21698,28,2661,268,5,10,24670
2017-10-19,22336,30,2495,284,7,6,25158
2017-10-20,25551,28,2139,296,7,9,28030
2017-10-21,26631,26,968,344,4,13,27986
2017-10-22,22024,22,782,293,2,9,23132
2017-10-23,22628,28,2976,261,14,7,25914
2017-10-24,20954,29,2852,227,9,3,24074
2017-10-25,20888,24,2648,213,9,6,23788
2017-10-26,22580,22,2589,290,9,6,25496
2017-10-27,24307,29,2351,292,3,7,26989
2017-10-28,26861,26,1127,338,8,7,28367
2017-10-29,24926,20,784,233,6,4,25973
2017-10-30,23304,24,2880,213,5,3,26429
2017-10-31,28224,24,1659,218,11,4,30140
2017-11-01,29715,22,1148,155,3,3,31046
2017-11-02,24841,25,2883,213,3,5,27970
2017-11-03,26092,25,2281,238,4,3,28643
2017-11-04,27071,24,1084,281,4,3,28467
2017-11-05,22708,29,806,200,3,4,23750
2017-11-06,20996,26,2943,180,3,4,24152
2017-11-07,21092,27,3061,203,2,5,24390
2017-11-08,22149,25,2669,169,8,4,25024
2017-11-09,21069,22,2394,164,7,3,23659
2017-11-10,23837,27,2154,225,5,3,26251
2017-11-11,27533,18,1189,221,5,2,28968
2017-11-12,21003,14,789,186,7,5,22004
2017-11-13,20903,27,3282,174,3,3,24392
2017-11-14,21350,26,2635,178,2,5,24196
2017-11-15,21937,24,2982,198,3,4,25148
2017-11-16,23081,30,2529,221,2,4,25867
2017-11-17,23043,25,2012,242,4,3,25329
2017-11-18,24427,25,1020,244,2,2,25720
2017-11-19,21465,26,1051,222,9,4,22777
2017-11-20,21441,25,3208,164,7,3,24848
2017-11-21,20462,29,2809,165,2,3,23470
2017-11-22,21062,24,2757,173,4,4,24024
2017-11-23,22419,25,2848,184,1,5,25482
2017-11-24,24414,33,2170,229,3,4,26853
2017-11-25,23034,26,941,259,2,3,24265
2017-11-26,19201,20,794,177,2,4,20198
2017-11-27,21813,29,3908,170,7,3,25930
2017-11-28,20970,27,2794,152,5,4,23952
2017-11-29,19528,23,2857,173,3,3,22587
2017-11-30,20790,28,2461,192,2,5,23478
2017-12-01,23398,26,2254,234,4,3,25919
2017-12-02,23015,21,928,321,3,2,24290
2017-12-03,17566,21,811,207,3,4,18612
2017-12-04,20739,24,2738,154,5,4,23664
2017-12-05,20214,23,3029,137,4,5,23412
2017-12-06,19475,26,2426,140,5,4,22076
2017-12-07,20735,20,2311,188,5,4,23263
2017-12-08,23082,23,1965,212,1,4,25287
2017-12-09,21213,23,1122,454,4,2,22818
2017-12-10,19731,14,754,264,4,4,20771
2017-12-11,20983,23,3576,147,5,3,24737
2017-12-12,21630,30,2715,146,3,4,24528
2017-12-13,22111,32,2802,187,9,3,25144
2017-12-14,21415,24,2509,186,3,4,24141
2017-12-15,23236,24,2219,234,4,3,25720
2017-12-16,25105,20,884,500,5,2,26516
2017-12-17,19437,16,807,212,6,4,20482
2017-12-18,22245,22,3368,182,2,6,25825
2017-12-19,23040,30,2809,153,4,4,26040
2017-12-20,22907,25,2477,190,5,3,25607
2017-12-21,23763,30,2241,212,8,4,26258
2017-12-22,23696,24,1751,194,3,4,25672
2017-12-23,24592,26,730,206,2,2,25558
2017-12-24,15973,20,241,103,1,2,16340
2017-12-25,13896,22,209,70,2,0,14199
2017-12-26,23368,15,594,173,3,4,24157
2017-12-27,24391,20,1833,171,0,3,26418
2017-12-28,24251,25,1352,161,6,4,25799
2017-12-29,26110,27,1349,197,5,3,27691
2017-12-30,26180,27,567,263,3,3,27043
2017-12-31,16473,19,239,108,2,3,16844
2018-01-01,13214,21,255,109,1,4,13604
2018-01-02,21832,22,1234,189,0,4,23281
2018-01-03,24406,25,1892,161,3,4,26491
2018-01-04,24441,24,1622,155,2,4,26248
2018-01-05,26745,25,1544,161,1,4,28480
2018-01-06,29372,25,552,262,1,2,30214
2018-01-07,22368,23,602,193,1,4,23191
2018-01-08,22913,30,3183,139,0,3,26268
2018-01-09,20146,28,2301,104,0,5,22584
2018-01-10,21662,34,2260,139,3,4,24102
2018-01-11,22343,23,2193,156,2,4,24721
2018-01-12,22500,24,1834,133,0,3,24494
2018-01-13,24324,32,758,175,0,3,25292
2018-01-14,17692,23,714,153,2,3,18587
2018-01-15,16773,21,2278,123,3,3,19201
2018-01-16,17946,26,2304,128,2,3,20409
2018-01-17,18827,28,2419,147,1,4,21426
2018-01-18,18619,32,2265,174,3,4,21097
2018-01-19,21956,33,1962,175,1,3,24130
2018-01-20,23321,26,693,225,1,2,24268
2018-01-21,17450,29,722,165,2,4,18372
2018-01-22,20879,30,3309,142,2,7,24369
2018-01-23,16861,34,2119,134,1,5,19154
2018-01-24,17838,23,2449,141,3,4,20458
2018-01-25,19023,31,2041,153,0,2,21250
2018-01-26,20896,28,1862,203,1,4,22994
2018-01-27,22158,26,891,207,3,4,23289
2018-01-28,17105,25,725,154,1,5,18015
2018-01-29,18776,33,3090,135,0,4,22038
2018-01-30,18677,33,2830,127,2,4,21673
2018-01-31,18305,27,2487,143,3,5,20970
2018-02-01,19861,28,2484,163,1,4,22541
2018-02-02,20731,28,2046,180,0,4,22989
2018-02-03,16781,27,803,249,0,2,17862
2018-02-04,15591,21,610,187,3,5,16417
2018-02-05,18623,29,2850,149,4,3,21658
2018-02-06,17492,30,2432,137,0,4,20095
2018-02-07,15680,27,2006,142,1,3,17859
2018-02-08,17528,28,1553,154,4,4,19271
2018-02-09,21238,34,1990,195,2,3,23462
2018-02-10,22924,28,769,269,2,2,23994
2018-02-11,16889,25,964,232,1,4,18115
2018-02-12,18236,26,2923,149,3,4,21341
2018-02-13,15820,25,2157,163,0,5,18170
2018-02-14,18812,25,2519,158,4,3,21521
2018-02-15,19858,28,2086,179,3,6,22160
2018-02-16,22128,27,1759,196,1,3,24114
2018-02-17,25426,29,846,251,2,2,26556
2018-02-18,15993,22,661,171,1,4,16852
2018-02-19,19067,23,3163,177,1,5,22436
2018-02-20,18608,28,3043,162,2,4,21847
2018-02-21,18592,30,2024,148,1,3,20798
2018-02-22,15339,29,1864,176,2,4,17414
2018-02-23,18461,27,1812,190,0,5,20495
2018-02-24,20608,25,852,221,0,2,21708
2018-02-25,13918,17,793,143,0,5,14876
2018-02-26,13981,23,2382,147,0,4,16537
2018-02-27,11404,18,1570,133,0,4,13129
2018-02-28,14547,21,2148,161,3,5,16885
2018-03-01,14630,22,1993,151,1,4,16801
2018-03-02,16341,22,1375,189,1,3,17931
2018-03-03,18832,25,924,228,0,3,20012
2018-03-04,15780,24,683,208,3,5,16703
2018-03-05,18628,26,3685,158,2,3,22502
2018-03-06,17342,26,2398,157,4,6,19933
2018-03-07,19013,27,1921,146,2,3,21112
2018-03-08,20254,26,2199,200,7,3,22689
2018-03-09,22522,26,2022,223,2,3,24798
2018-03-10,25293,24,1020,258,2,2,26599
2018-03-11,18757,25,852,213,1,5,19853
2018-03-12,20012,24,2974,171,1,3,23185
2018-03-13,18648,24,2636,153,4,4,21469
2018-03-14,19050,25,2548,145,3,5,21776
2018-03-15,21070,28,2182,218,2,3,23503
2018-03-16,23101,27,1914,211,3,4,25260
2018-03-17,24250,30,968,316,3,2,25569
2018-03-18,17792,23,653,177,1,5,18651
2018-03-19,18768,20,2934,204,0,4,21930
2018-03-20,18586,28,2811,159,4,4,21592
2018-03-21,18030,32,2803,176,1,4,21046
2018-03-22,18929,17,2243,217,0,4,21410
2018-03-23,20224,26,1932,242,1,3,22428
2018-03-24,24654,26,1162,235,3,3,26083
2018-03-25,18801,24,925,209,1,6,19966
2018-03-26,20857,24,3024,165,2,5,24077
2018-03-27,20289,27,3175,218,4,5,23718
2018-03-28,21211,25,2953,249,6,9,24453
2018-03-29,25378,29,2819,214,3,13,28456
2018-03-30,24296,30,1427,205,0,5,25963
2018-03-31,22515,27,615,236,1,6,23400
2018-04-01,17100,15,263,145,2,7,17532
2018-04-02,27993,15,892,219,5,6,29130
2018-04-03,23628,20,3685,228,6,6,27573
2018-04-04,23393,23,3148,228,4,9,26805
2018-04-05,24451,19,2886,205,11,4,27576
2018-04-06,24368,24,2182,256,4,5,26839
2018-04-07,27230,26,928,294,1,8,28487
2018-04-08,23369,24,743,274,3,3,24416
2018-04-09,21232,24,3294,238,4,5,24797
2018-04-10,21583,23,3022,228,17,5,24878
2018-04-11,20260,30,3095,223,8,6,23622
2018-04-12,22539,30,2643,291,3,2,25508
2018-04-13,23577,29,2517,256,4,5,26388
2018-04-14,26140,25,1149,318,1,6,27639
2018-04-15,23164,26,823,212,7,5,24237
2018-04-16,23336,27,3114,272,5,4,26758
2018-04-17,21254,26,2718,263,2,5,24268
2018-04-18,21908,27,2844,228,5,5,25017
2018-04-19,21472,28,2590,278,4,4,24376
2018-04-20,24344,27,2278,432,4,4,27089
2018-04-21,27380,28,1183,372,1,7,28971
2018-04-22,23892,21,869,282,4,6,25074
2018-04-23,21946,19,3498,286,6,6,25761
2018-04-24,21489,29,3080,289,3,4,24894
2018-04-25,23073,27,3099,295,3,6,26503
2018-04-26,22687,25,2861,297,3,6,25879
2018-04-27,24483,28,1974,345,3,6,26839
2018-04-28,27071,31,1061,463,6,9,28641
2018-04-29,25078,24,821,273,18,8,26222
2018-04-30,28710,28,2358,260,24,8,31388
2018-05-01,23072,24,856,275,8,3,24238
2018-05-02,21597,30,2124,344,4,6,24105
2018-05-03,25107,27,3065,369,4,9,28581
2018-05-04,25966,25,2634,329,6,11,28971
2018-05-05,29529,24,1226,331,1,16,31127
2018-05-06,23376,25,696,299,6,12,24414
2018-05-07,23343,27,3510,299,11,11,27201
2018-05-08,22257,29,2975,282,7,11,25561
2018-05-09,21858,28,2780,255,4,7,24932
2018-05-10,26267,29,2759,320,10,10,29395
2018-05-11,25842,31,2401,327,6,9,28616
2018-05-12,30001,27,1096,463,4,17,31608
2018-05-13,25508,24,881,304,9,6,26732
2018-05-14,23011,31,3523,254,8,12,26839
2018-05-15,23047,28,3013,219,10,9,26326
2018-05-16,22706,26,3275,296,9,11,26323
2018-05-17,23336,27,2846,314,6,4,26533
2018-05-18,24286,34,2088,343,6,240,26997
2018-05-19,27299,29,1228,397,1,18,28972
2018-05-20,21607,22,675,287,10,13,22614
2018-05-21,25054,28,2734,346,13,10,28185
2018-05-22,22763,23,3422,383,4,5,26600
2018-05-23,21802,24,2768,293,5,13,24905
2018-05-24,23919,21,2864,273,3,12,27092
2018-05-25,24590,25,2194,356,8,11,27184
2018-05-26,24923,29,980,395,3,19,26349
2018-05-27,23343,20,875,316,11,16,24581
2018-05-28,23245,27,3438,281,15,16,27022
2018-05-29,21535,22,2864,263,17,10,24711
2018-05-30,24549,29,2693,327,4,9,27611
2018-05-31,28987,21,1559,357,4,12,30940
2018-06-01,25582,27,2137,334,6,11,28097
2018-06-02,30005,24,910,348,1,16,31304
2018-06-03,21669,26,687,336,15,4,22737
2018-06-04,24010,25,2916,309,12,11,27283
2018-06-05,21506,22,3128,282,10,8,24956
2018-06-06,22865,22,2302,248,4,12,25453
2018-06-07,23368,28,2617,328,4,6,26351
2018-06-08,25167,27,2110,332,6,15,27657
2018-06-09,26732,25,1211,323,10,19,28320
2018-06-10,23986,22,699,313,12,14,25046
2018-06-11,23976,29,3639,303,15,13,27975
2018-06-12,22015,27,3094,292,8,11,25447
2018-06-13,23750,25,2681,264,8,6,26734
2018-06-14,24656,28,2359,340,9,9,27401
2018-06-15,26691,27,2387,349,9,12,29475
2018-06-16,25978,20,927,382,7,22,27336
2018-06-17,24515,17,770,261,14,14,25591
2018-06-18,24917,26,2922,296,14,9,28184
2018-06-19,23255,31,2872,337,9,15,26519
2018-06-20,23354,29,2583,277,11,15,26269
2018-06-21,26542,28,2614,290,12,11,29497
2018-06-22,31641,25,1631,399,8,10,33714
2018-06-23,29953,35,1206,341,4,16,31555
2018-06-24,24748,20,740,339,10,7,25864
2018-06-25,28201,26,1380,267,13,15,29902
2018-06-26,24482,28,3327,262,10,11,28120
2018-06-27,23023,30,3079,276,4,10,26422
2018-06-28,23540,30,2619,305,8,4,26506
2018-06-29,26510,26,2370,323,13,17,29259
2018-06-30,28764,28,970,297,10,21,30090
2018-07-01,25275,26,878,340,11,12,26542
2018-07-02,23331,24,3480,243,13,9,27100
2018-07-03,22542,30,2963,248,11,11,25805
2018-07-04,22629,38,2346,266,7,8,25294
2018-07-05,24127,32,2394,265,8,13,26839
2018-07-06,23654,27,1955,276,10,15,25937
2018-07-07,25978,29,883,260,10,22,27182
2018-07-08,22653,22,748,293,6,14,23736
2018-07-09,25085,29,3054,245,13,13,28439
2018-07-10,23533,30,2721,236,10,10,26540
2018-07-11,22355,30,2631,260,7,18,25301
2018-07-12,23793,26,2428,248,7,10,26512
2018-07-13,25073,27,1982,285,14,16,27397
2018-07-14,28510,27,848,302,9,22,29718
2018-07-15,21806,23,491,214,10,14,22558
2018-07-16,22642,28,2365,215,16,13,25279
2018-07-17,23906,24,2664,267,10,9,26880
2018-07-18,23848,26,2830,264,9,8,26985
2018-07-19,23865,28,2573,253,16,12,26747
2018-07-20,27392,28,2068,281,9,12,29790
2018-07-21,29139,25,950,333,8,23,30478
2018-07-22,24579,26,736,265,10,9,25625
2018-07-23,26070,26,2934,240,17,11,29298
2018-07-24,24904,30,2673,251,9,11,27878
2018-07-25,22947,31,2262,291,9,16,25556
2018-07-26,24753,30,2308,294,13,4,27402
2018-07-27,26026,31,1929,234,9,38,28267
2018-07-28,26076,27,860,246,8,19,27236
2018-07-29,23814,30,790,291,11,10,24946
2018-07-30,27018,29,3329,306,10,2,30694
2018-07-31,24778,27,2597,281,10,8,27701
2018-08-01,24222,26,2288,254,8,14,26812
2018-08-02,25858,26,2060,274,7,5,28230
2018-08-03,20622,27,1192,183,3,13,22040
2018-08-04,26271,25,790,309,12,21,27428
2018-08-05,23680,22,717,250,15,12,24696
2018-08-06,25115,32,2985,267,18,15,28432
2018-08-07,26161,29,2208,284,12,7,28701
2018-08-08,22534,26,2350,199,15,11,25135
2018-08-09,24367,24,2066,300,10,11,26778
2018-08-10,25481,32,1942,270,9,11,27745
2018-08-11,27048,22,731,278,10,21,28110
2018-08-12,22593,21,696,246,19,11,23586
2018-08-13,26244,26,2836,231,15,15,29367
2018-08-14,27641,35,2080,262,10,12,30040
2018-08-15,30853,24,1046,299,9,8,32239
2018-08-16,27241,26,2149,264,10,5,29695
2018-08-17,25141,23,1718,254,11,14,27161
2018-08-18,28580,27,932,337,20,23,29919
2018-08-19,37041,21,749,357,25,7,38200
2018-08-20,25798,27,2519,229,20,9,28602
2018-08-21,24716,26,2723,243,7,9,27724
2018-08-22,26044,32,2546,250,13,16,28901
2018-08-23,27653,21,2292,286,8,9,30269
2018-08-24,28542,28,1897,283,19,9,30778
2018-08-25,28852,28,951,308,10,18,30167
2018-08-26,27092,29,677,365,4,13,28180
2018-08-27,27453,29,3260,263,15,12,31032
2018-08-28,24052,29,2871,243,14,12,27221
2018-08-29,23398,28,2309,232,15,12,25994
2018-08-30,24198,33,2633,282,7,4,27157
2018-08-31,29403,30,1980,304,7,14,31738
2018-09-01,28756,20,1168,314,5,16,30279
2018-09-02,23799,19,854,313,8,14,25007
2018-09-03,24321,32,3409,269,13,9,28053
2018-09-04,24718,28,2778,275,10,8,27817
2018-09-05,24072,30,2705,230,8,9,27054
2018-09-06,25432,30,2357,309,10,10,28148
2018-09-07,25623,32,2378,331,4,12,28380
2018-09-08,33019,27,1009,350,8,18,34431
2018-09-09,25200,25,776,270,16,4,26291
2018-09-10,22914,31,3374,290,21,12,26642
2018-09-11,22451,31,2983,297,11,10,25783
2018-09-12,22629,24,3027,251,9,13,25953
2018-09-13,24630,29,2667,267,8,4,27605
2018-09-14,25767,22,1997,324,14,13,28137
2018-09-15,29737,28,1149,386,5,19,31324
2018-09-16,27918,23,750,304,22,14,29031
2018-09-17,24582,26,3336,262,20,9,28235
2018-09-18,22668,28,2882,274,8,11,25871
2018-09-19,23813,19,2871,277,5,13,26998
2018-09-20,26488,31,2787,332,7,7,29652
2018-09-21,31237,27,2379,281,10,7,33941
2018-09-22,29711,15,1111,448,12,20,31317
2018-09-23,24504,18,846,336,47,12,25763
2018-09-24,36606,69,4622,501,4,91,41893
2018-09-25,23022,27,3095,269,9,7,26429
2018-09-26,22374,27,2189,253,5,15,24863
2018-09-27,23821,29,2435,347,8,12,26652
2018-09-28,25897,29,2072,497,5,11,28511
2018-09-29,26819,28,1031,373,4,16,28271
2018-09-30,24128,22,823,306,13,13,25305
2018-10-01,23722,34,3497,306,15,12,27586
2018-10-02,21829,27,2562,269,1,10,24698
2018-10-03,22769,26,2896,275,10,12,25988
2018-10-04,23678,28,3039,317,9,10,27081
2018-10-05,28155,28,2502,458,6,11,31160
2018-10-06,29241,29,921,437,3,15,30646
2018-10-07,25298,20,776,265,7,13,26379
2018-10-08,31205,22,2248,286,10,11,33782
2018-10-09,20394,27,3063,239,9,8,23740
2018-10-10,22753,29,2749,290,4,11,25836
2018-10-11,22653,30,2704,282,14,9,25692
2018-10-12,24778,29,2354,325,25,10,27521
2018-10-13,26436,27,1015,355,16,14,27863
2018-10-14,24674,30,841,303,35,14,25897
2018-10-15,22240,24,3406,227,4,7,25908
2018-10-16,19236,26,2066,202,5,5,21540
2018-10-17,21222,28,2759,266,6,8,24289
2018-10-18,22961,31,2730,297,4,6,26029
2018-10-19,23491,32,2138,332,5,15,26013
2018-10-20,25980,18,899,420,1,14,27332
2018-10-21,22351,16,838,286,4,5,23500
2018-10-22,21259,20,3418,272,7,6,24982
2018-10-23,20305,31,2670,231,4,5,23246
2018-10-24,20310,27,2666,214,4,7,23228
2018-10-25,21220,30,2716,317,6,6,24295
2018-10-26,23813,27,2222,396,3,4,26465
2018-10-27,24318,26,913,356,0,13,25626
2018-10-28,20207,19,798,234,1,7,21266
2018-10-29,20090,31,3675,242,1,3,24042
2018-10-30,21671,29,2626,225,1,5,24557
2018-10-31,27127,32,1463,250,6,7,28885
2018-11-01,27727,25,792,198,1,4,28747
2018-11-02,27576,27,2245,242,1,3,30094
2018-11-03,25854,21,894,270,5,3,27047
2018-11-04,23043,23,717,231,4,7,24025
2018-11-05,21289,29,3415,190,2,3,24928
2018-11-06,19501,29,2947,216,4,4,22701
2018-11-07,19253,28,2791,191,7,3,22273
2018-11-08,20029,27,2379,223,5,5,22668
2018-11-09,22554,24,1654,202,1,4,24439
2018-11-10,25723,29,1057,357,3,4,27173
2018-11-11,20895,20,772,215,4,6,21912
2018-11-12,20248,25,3266,182,2,3,23726
2018-11-13,20244,26,2787,181,4,6,23248
2018-11-14,21233,26,2740,200,4,4,24207
2018-11-15,21216,24,2439,235,5,5,23924
2018-11-16,23009,27,2220,266,2,5,25529
2018-11-17,24359,23,996,285,0,4,25667
2018-11-18,19910,11,934,207,2,5,21069
2018-11-19,21330,29,3125,196,0,4,24684
2018-11-20,17970,20,2467,161,2,4,20624
2018-11-21,18669,28,1766,164,3,5,20635
2018-11-22,21251,27,2750,216,1,4,24249
2018-11-23,22814,25,2312,240,1,3,25395
2018-11-24,22941,22,1083,289,0,3,24338
2018-11-25,17044,20,745,233,4,6,18052
2018-11-26,19941,24,3456,163,1,3,23588
2018-11-27,18977,23,2555,156,0,4,21715
2018-11-28,18077,28,2618,175,1,3,20902
2018-11-29,17971,26,2336,181,1,5,20520
2018-11-30,21458,25,2253,221,3,3,23963
2018-12-01,21976,24,850,250,3,3,23106
2018-12-02,17837,24,792,184,3,5,18845
2018-12-03,18737,22,3052,142,2,3,21958
2018-12-04,19812,22,3124,162,3,3,23126
2018-12-05,19374,25,2608,154,3,4,22168
2018-12-06,19603,25,2694,170,4,6,22502
2018-12-07,21413,25,2032,222,3,3,23698
2018-12-08,23074,24,1061,359,0,4,24522
2018-12-09,17797,18,926,210,2,4,18957
2018-12-10,20329,30,3571,173,5,3,24111
2018-12-11,20323,26,2850,133,5,4,23341
2018-12-12,20250,26,2657,186,4,3,23126
2018-12-13,21391,22,2778,185,0,5,24381
2018-12-14,18991,21,2154,212,2,3,21383
2018-12-15,17830,18,670,356,1,3,18878
2018-12-16,16947,18,826,208,5,5,18009
2018-12-17,20445,27,3071,132,1,3,23679
2018-12-18,21039,21,2799,164,4,6,24033
2018-12-19,20995,25,2553,158,4,0,23735
2018-12-20,21145,28,2559,219,3,4,23958
2018-12-21,22966,27,1614,209,1,4,24821
2018-12-22,21945,20,699,305,1,4,22974
2018-12-23,18230,18,341,166,1,6,18762
2018-12-24,18375,23,695,113,0,2,19208
2018-12-25,11780,15,212,64,1,0,12072
2018-12-26,20777,16,433,161,5,3,21395
2018-12-27,25140,19,1305,179,3,5,26651
2018-12-28,24224,27,1309,189,2,3,25754
2018-12-29,26825,21,703,240,2,3,27794
2018-12-30,21932,22,322,277,1,4,22558
2018-12-31,19210,23,383,128,1,2,19747
2019-01-01,9218,12,227,128,1,0,9586
2019-01-02,23020,21,931,212,1,4,24189
2019-01-03,23514,23,1473,167,0,6,25183
2019-01-04,25165,23,1385,170,1,3,26747
2019-01-05,30406,26,724,250,1,4,31411
2019-01-06,22773,23,599,183,1,6,23585
2019-01-07,18300,26,2723,142,3,3,21197
2019-01-08,18538,23,2122,124,1,3,20811
2019-01-09,17083,25,2298,129,2,3,19540
2019-01-10,20624,23,2194,190,0,4,23035
2019-01-11,20619,25,1614,171,2,3,22434
2019-01-12,24134,26,815,174,1,3,25153
2019-01-13,17091,16,697,151,5,6,17966
2019-01-14,17458,26,3041,143,2,3,20673
2019-01-15,18581,24,2476,119,3,5,21208
2019-01-16,17990,27,2273,138,2,3,20433
2019-01-17,19891,26,2640,180,0,6,22743
2019-01-18,20309,27,1761,151,2,3,22253
2019-01-19,21749,14,909,208,1,3,22884
2019-01-20,16773,21,622,165,2,5,17588
2019-01-21,18608,29,3329,134,0,3,22103
2019-01-22,17978,17,2282,130,6,5,20418
2019-01-23,14891,29,2407,155,6,4,17492
2019-01-24,15323,17,2065,156,0,4,17565
2019-01-25,18150,27,1930,176,0,3,20286
2019-01-26,20511,26,964,214,2,3,21720
2019-01-27,15792,20,774,193,3,7,16789
2019-01-28,17396,25,3353,145,1,4,20924
2019-01-29,17580,30,2823,144,0,3,20580
2019-01-30,18114,26,2891,144,2,3,21180
2019-01-31,19335,27,2366,187,2,5,21922
2019-02-01,20880,25,2138,192,3,3,23241
2019-02-02,22909,26,937,205,0,4,24081
2019-02-03,16286,22,705,179,2,3,17197
2019-02-04,19304,30,3519,154,0,3,23010
2019-02-05,18233,27,2510,141,5,3,20919
2019-02-06,18427,31,2842,159,2,4,21465
2019-02-07,19380,26,2362,178,5,4,21955
2019-02-08,21214,27,1583,184,3,4,23015
2019-02-09,25107,25,988,250,3,3,26376
2019-02-10,19235,24,732,209,3,5,20208
2019-02-11,19930,26,2984,165,1,3,23109
2019-02-12,18353,28,2689,142,7,5,21224
2019-02-13,19116,27,2915,168,2,3,22231
2019-02-14,21874,28,2581,197,2,5,24687
2019-02-15,22925,20,2274,200,1,3,25423
2019-02-16,24396,21,1028,281,2,3,25731
2019-02-17,18957,24,817,214,2,5,20019
2019-02-18,21067,28,3842,151,5,4,25097
2019-02-19,18708,25,2792,132,3,3,21663
2019-02-20,19226,31,3219,163,5,3,22647
2019-02-21,19715,28,2653,168,1,5,22570
2019-02-22,17561,23,1827,142,1,3,19557
2019-02-23,22203,26,1080,227,0,2,23538
2019-02-24,18564,25,757,169,3,5,19523
2019-02-25,19737,31,3775,176,1,3,23723
2019-02-26,18462,27,2858,154,2,4,21507
2019-02-27,18941,25,2819,171,5,3,21964
2019-02-28,21158,23,2823,190,15,5,24214
2019-03-01,23032,27,2162,192,5,3,25421
2019-03-02,25144,27,1178,275,3,4,26631
2019-03-03,19803,24,816,172,1,5,20821
2019-03-04,20293,21,3640,161,3,3,24121
2019-03-05,20394,31,3073,178,4,4,23684
2019-03-06,19714,23,3035,172,2,3,22949
2019-03-07,21326,30,2937,194,1,5,24493
2019-03-08,24484,27,2360,227,1,3,27102
2019-03-09,26287,27,1177,287,3,3,27784
2019-03-10,21005,23,875,205,3,5,22116
2019-03-11,21508,30,3526,171,2,4,25241
2019-03-12,20421,28,3454,181,2,3,24089
2019-03-13,19911,28,2989,195,3,6,23132
2019-03-14,21009,23,3020,206,3,7,24268
2019-03-15,23536,25,2500,223,4,4,26292
2019-03-16,26275,30,1245,271,2,4,27827
2019-03-17,21063,28,729,251,2,4,22077
2019-03-18,20681,28,3822,189,1,3,24724
2019-03-19,19967,27,2961,162,2,4,23123
2019-03-20,19688,24,3099,215,2,6,23034
2019-03-21,20410,30,2965,267,1,2,23675
2019-03-22,23311,24,2713,281,5,3,26337
2019-03-23,25080,24,1289,278,3,3,26677
2019-03-24,21818,23,752,236,2,6,22837
2019-03-25,20911,26,3721,229,2,3,24892
2019-03-26,18962,29,3307,195,3,5,22501
2019-03-27,19853,26,3083,182,3,4,23151
2019-03-28,20123,30,2821,280,4,4,23262
2019-03-29,22331,22,2676,292,3,3,25327
2019-03-30,24076,16,1404,272,1,3,25772
2019-03-31,21053,21,774,242,7,5,22102
2019-04-01,20656,26,4000,191,7,9,24889
2019-04-02,19392,31,3177,185,12,6,22803
2019-04-03,20715,30,3342,228,5,5,24325
2019-04-04,21249,27,2714,207,1,5,24203
2019-04-05,22897,26,2349,283,3,3,25561
2019-04-06,24914,26,1220,411,2,6,26579
2019-04-07,20836,27,942,257,5,5,22072
2019-04-08,21675,28,3478,181,4,5,25371
2019-04-09,20026,26,2938,223,7,3,23223
2019-04-10,22124,28,2949,218,6,6,25331
2019-04-11,22973,25,2514,246,5,7,25770
2019-04-12,23004,21,2466,350,2,5,25848
2019-04-13,24247,18,1164,398,4,4,25835
2019-04-14,21038,25,880,343,17,6,22309
2019-04-15,23499,30,3583,278,12,6,27408
2019-04-16,22860,28,3171,262,12,7,26340
2019-04-17,23102,29,2908,322,5,6,26372
2019-04-18,27387,30,2882,311,5,4,30619
2019-04-19,25844,26,1699,296,5,6,27876
2019-04-20,24896,28,633,273,3,10,25843
2019-04-21,18481,19,340,238,5,13,19096
2019-04-22,32218,19,997,325,2,7,33568
2019-04-23,26393,23,3807,281,3,8,30515
2019-04-24,23488,22,3050,323,5,10,26898
2019-04-25,25232,25,2725,327,5,10,28324
2019-04-26,26062,25,2313,261,3,10,28674
2019-04-27,28870,17,1209,370,1,16,30483
2019-04-28,23262,23,705,341,19,14,24364
2019-04-29,21936,22,3264,285,22,12,25541
2019-04-30,25826,28,2528,322,10,9,28723
2019-05-01,18139,21,791,377,2,10,19340
2019-05-02,22332,19,1839,318,6,12,24526
2019-05-03,26991,29,2343,341,8,10,29722
2019-05-04,28558,15,1182,395,7,16,30173
2019-05-05,22373,23,798,350,2,11,23557
2019-05-06,24589,28,3009,278,8,12,27924
2019-05-07,21860,19,2917,281,11,12,25100
2019-05-08,22051,27,2896,310,5,6,25295
2019-05-09,23166,25,3156,341,6,29,26723
2019-05-10,26528,25,2406,308,9,11,29287
2019-05-11,26635,16,1154,403,9,17,28234
2019-05-12,21802,24,854,567,5,3,23255
2019-05-13,22769,25,3883,283,7,12,26979
2019-05-14,20732,23,2644,301,11,8,23719
2019-05-15,23056,27,3110,291,13,7,26504
2019-05-16,22328,24,3010,352,10,5,25729
2019-05-17,24733,27,2439,335,6,11,27551
2019-05-18,26140,24,1007,491,3,18,27683
2019-05-19,21717,20,769,406,7,13,22932
2019-05-20,23187,23,3428,324,15,13,26990
2019-05-21,22248,24,3052,275,10,10,25619
2019-05-22,22052,23,2546,427,8,14,25070
2019-05-23,22941,17,2782,377,10,5,26132
2019-05-24,25204,19,2426,386,7,7,28049
2019-05-25,26253,26,1183,355,8,18,27843
2019-05-26,20033,19,672,385,14,13,21136
2019-05-27,23472,28,3671,355,6,9,27541
2019-05-28,22052,17,2836,317,10,4,25236
2019-05-29,21146,22,2687,303,5,13,24176
2019-05-30,23025,27,2859,312,6,10,26239
2019-05-31,25211,26,2482,376,9,11,28115
2019-06-01,27535,17,1210,379,8,18,29167
2019-06-02,23693,22,901,362,11,14,25003
2019-06-03,23192,27,3146,844,11,14,27234
2019-06-04,22780,28,2910,332,13,11,26074
2019-06-05,22962,26,3166,319,9,13,26495
2019-06-06,23653,26,2615,398,12,11,26715
2019-06-07,25257,19,2441,396,13,11,28137
2019-06-08,26597,24,1078,434,6,21,28160
2019-06-09,22592,22,625,394,18,13,23664
2019-06-10,24547,22,2557,329,12,14,27481
2019-06-11,24984,28,3198,370,10,3,28593
2019-06-12,23578,24,2814,296,8,12,26732
2019-06-13,24455,17,2749,339,9,10,27579
2019-06-14,25125,23,2309,331,14,12,27814
2019-06-15,28331,27,1213,436,14,19,30040
2019-06-16,22974,24,756,399,14,14,24181
2019-06-17,24826,25,3389,326,14,15,28595
2019-06-18,23890,29,2741,275,15,8,26958
2019-06-19,26292,24,3138,370,9,13,29846
2019-06-20,31464,27,1841,444,8,15,33799
2019-06-21,27072,28,2203,375,10,8,29696
2019-06-22,31272,23,1252,423,7,19,32996
2019-06-23,28832,24,832,343,21,15,30067
2019-06-24,27226,31,3160,336,30,13,30796
2019-06-25,26418,20,1578,322,12,10,28360
2019-06-26,23377,28,2818,279,10,7,26519
2019-06-27,23633,27,2676,365,11,4,26716
2019-06-28,26021,28,2396,371,7,13,28836
2019-06-29,30335,27,1249,366,11,23,32011
2019-06-30,22323,25,816,328,6,9,23507
2019-07-01,26571,29,2877,326,13,9,29825
2019-07-02,22526,28,2708,325,11,13,25611
2019-07-03,23016,25,2707,318,11,15,26092
2019-07-04,24152,19,2689,273,10,12,27155
2019-07-05,28050,25,2399,355,13,12,30854
2019-07-06,28303,25,1043,331,10,18,29730
2019-07-07,22298,28,662,350,22,16,23376
2019-07-08,23610,31,3673,307,17,16,27654
2019-07-09,25675,28,2793,304,11,5,28816
2019-07-10,24163,27,2924,282,7,12,27415
2019-07-11,23576,29,2176,312,16,9,26118
2019-07-12,25035,32,2062,279,7,15,27430
2019-07-13,28280,30,1077,329,11,16,29743
2019-07-14,23686,21,686,325,14,15,24747
2019-07-15,25044,38,3315,250,21,16,28684
2019-07-16,23728,19,2751,295,14,10,26817
2019-07-17,26762,40,2661,293,9,7,29772
2019-07-18,24678,29,2449,314,10,13,27493
2019-07-19,25470,25,2175,298,12,12,27992
2019-07-20,29462,23,1086,340,14,19,30944
2019-07-21,30047,26,829,308,11,13,31234
2019-07-22,25746,25,3361,289,15,15,29451
2019-07-23,23505,27,2740,293,7,8,26580
2019-07-24,23571,26,2748,284,8,15,26652
2019-07-25,27386,26,2534,312,7,12,30277
2019-07-26,26345,28,2086,299,10,13,28781
2019-07-27,27021,16,881,260,9,20,28207
2019-07-28,23094,19,739,334,6,13,24205
2019-07-29,29660,32,3227,325,10,15,33269
2019-07-30,26241,31,2435,311,12,14,29044
2019-07-31,24796,31,2595,292,13,18,27745
2019-08-01,25433,27,2182,337,7,11,27997
2019-08-02,30625,28,1839,295,9,12,32808
2019-08-03,37280,27,1011,338,8,38,38702
2019-08-04,30299,29,753,307,12,14,31414
2019-08-05,30330,29,2191,268,15,15,32848
2019-08-06,22526,27,2150,265,6,9,24983
2019-08-07,26520,41,2185,364,8,17,29135
2019-08-08,28335,29,1897,288,10,10,30569
2019-08-09,28334,29,1693,285,12,12,30365
2019-08-10,36083,29,815,384,15,20,37346
2019-08-11,28724,23,593,300,18,10,29668
2019-08-12,32111,23,2695,293,23,11,35156
2019-08-13,28123,31,2118,288,12,12,30584
2019-08-14,35649,31,1995,294,7,12,37988
2019-08-15,31381,20,878,358,11,6,32654
2019-08-16,32911,29,1748,307,10,10,35015
2019-08-17,34756,30,952,284,13,18,36053
2019-08-18,34163,22,731,301,14,14,35245
2019-08-19,27955,28,2643,301,22,14,30963
2019-08-20,26246,29,2144,274,10,2,28705
2019-08-21,27123,29,2385,278,7,13,29835
2019-08-22,30013,22,2367,287,11,12,32712
2019-08-23,29500,23,1763,302,11,12,31611
2019-08-24,30868,27,871,314,12,17,32109
2019-08-25,26587,29,676,338,19,6,27655
2019-08-26,26476,32,2907,307,14,13,29749
2019-08-27,26050,26,2766,306,13,15,29176
2019-08-28,27293,30,2652,286,18,9,30288
2019-08-29,26959,30,2352,271,12,9,29633
2019-08-30,29544,30,2197,349,10,8,32138
2019-08-31,29439,25,950,374,11,22,30821
2019-09-01,27612,20,749,264,7,17,28669
2019-09-02,25180,30,3328,257,19,13,28827
2019-09-03,25810,21,2856,314,5,9,29015
2019-09-04,23310,27,2846,315,10,7,26515
2019-09-05,25636,29,2512,287,9,11,28484
2019-09-06,28545,33,2167,329,4,15,31093
2019-09-07,31630,26,1018,350,7,20,33051
2019-09-08,24653,24,831,397,9,5,25919
2019-09-09,23271,30,3245,287,17,12,26862
2019-09-10,23393,30,2750,300,14,9,26496
2019-09-11,22901,31,2971,303,8,11,26225
2019-09-12,24003,28,2535,359,15,12,26952
2019-09-13,27003,27,2232,353,7,12,29634
2019-09-14,28714,29,1047,385,5,18,30198
2019-09-15,26193,23,825,336,14,14,27405
2019-09-16,23921,24,3357,358,25,10,27695
2019-09-17,23320,25,2780,289,7,8,26429
2019-09-18,24392,29,2725,286,6,13,27451
2019-09-19,24944,28,2425,372,4,10,27783
2019-09-20,27261,30,2137,426,7,9,29870
2019-09-21,30231,25,1198,448,7,20,31929
2019-09-22,24448,15,761,376,25,13,25638
2019-09-23,22190,23,2567,334,7,13,25134
2019-09-24,23023,28,2816,347,16,11,26241
2019-09-25,23705,28,2775,294,5,7,26814
2019-09-26,25250,20,2697,374,5,11,28357
2019-09-27,26737,13,1999,370,3,11,29133
2019-09-28,28037,15,1129,463,8,18,29670
2019-09-29,24417,25,813,374,35,13,25677
2019-09-30,22980,28,3662,311,14,12,27007
2019-10-01,23622,26,2721,341,9,9,26728
2019-10-02,22163,15,2428,347,4,7,24964
2019-10-03,24669,22,2658,333,5,11,27698
2019-10-04,27085,26,2279,371,5,12,29778
2019-10-05,30202,20,1190,518,6,15,31951
2019-10-06,25932,21,873,422,11,13,27272
2019-10-07,25488,23,3133,339,12,11,29006
2019-10-08,30754,25,1759,421,14,8,32981
2019-10-09,20449,25,2632,382,9,6,23503
2019-10-10,23795,28,2587,376,15,4,26805
2019-10-11,25482,25,2190,377,27,9,28110
2019-10-12,27133,26,884,442,8,17,28510
2019-10-13,25035,21,816,442,6,12,26332
2019-10-14,22834,27,3393,340,10,8,26612
2019-10-15,22494,28,2985,309,6,7,25829
2019-10-16,22572,27,2590,312,0,11,25512
2019-10-17,22935,27,2654,373,8,4,26001
2019-10-18,24685,27,2258,407,10,11,27398
2019-10-19,27757,20,1137,404,4,15,29337
2019-10-20,24371,22,818,310,12,9,25542
2019-10-21,22766,28,3571,290,9,7,26671
2019-10-22,21088,25,2725,328,12,3,24181
2019-10-23,21013,29,2409,275,5,7,23738
2019-10-24,22469,27,2312,339,7,7,25161
2019-10-25,25970,25,2341,358,3,6,28703
2019-10-26,26150,26,947,420,6,9,27558
2019-10-27,22927,24,704,291,6,4,23956
2019-10-28,23576,24,3325,461,8,3,27397
2019-10-29,22961,29,2892,261,5,4,26152
2019-10-30,24642,27,2814,264,0,4,27751
2019-10-31,31115,26,1690,254,5,4,33094
2019-11-01,33112,18,650,262,3,3,34048
2019-11-02,30020,26,975,274,3,3,31301
2019-11-03,26012,24,765,284,1,5,27091
2019-11-04,24507,26,3731,208,3,3,28478
2019-11-05,21689,25,2718,214,0,6,24652
2019-11-06,21475,26,2647,211,6,3,24368
2019-11-07,22296,26,2431,251,4,4,25012
2019-11-08,24285,30,2219,239,2,3,26778
2019-11-09,25883,22,979,322,4,2,27212
2019-11-10,20824,23,759,281,4,6,21897
2019-11-11,22445,30,2977,180,5,4,25641
2019-11-12,20422,27,2625,172,2,4,23252
2019-11-13,20529,26,2730,213,2,3,23503
2019-11-14,22183,27,2354,223,4,5,24796
2019-11-15,24340,20,1963,277,2,3,26605
2019-11-16,25260,23,938,267,2,3,26493
2019-11-17,20429,21,733,261,2,5,21451
2019-11-18,21127,31,3213,199,2,3,24575
2019-11-19,21340,27,2637,172,8,3,24187
2019-11-20,21834,25,2601,168,9,4,24641
2019-11-21,21641,23,2671,195,6,5,24541
2019-11-22,24320,28,2317,254,1,3,26923
2019-11-23,24933,22,1081,260,5,3,26304
2019-11-24,21232,11,821,233,2,7,22306
2019-11-25,20990,20,3226,173,9,3,24421
2019-11-26,20816,17,2675,171,6,6,23691
2019-11-27,19819,21,2876,167,6,3,22892
2019-11-28,21262,18,2614,191,10,5,24100
2019-11-29,23605,22,2060,203,6,4,25900
2019-11-30,23390,26,973,303,1,3,24696
2019-12-01,19005,16,743,212,2,5,19983
2019-12-02,21155,27,3375,136,2,3,24698
2019-12-03,20108,29,2656,183,2,5,22983
2019-12-04,21024,23,2611,190,5,3,23856
2019-12-05,20973,28,2661,232,3,4,23901
2019-12-06,22170,22,2493,228,4,4,24921
2019-12-07,24733,26,929,396,5,3,26092
2019-12-08,19331,21,820,244,2,4,20422
2019-12-09,21352,28,3441,170,1,3,24995
2019-12-10,19315,31,2775,159,0,5,22285
2019-12-11,21072,24,2880,175,4,3,24158
2019-12-12,21854,25,2661,190,1,4,24735
2019-12-13,22568,26,2070,264,0,3,24931
2019-12-14,25375,14,1187,456,2,3,27037
2019-12-15,20123,24,913,258,2,6,21326
2019-12-16,22501,19,3512,145,3,3,26183
2019-12-17,22641,27,3016,175,1,4,25864
2019-12-18,21686,22,3135,159,3,3,25008
2019-12-19,23592,30,2644,192,1,5,26464
2019-12-20,24628,23,1958,238,4,3,26854
2019-12-21,23419,29,890,360,0,4,24702
2019-12-22,19046,23,1094,193,1,5,20362
2019-12-23,25772,25,1497,134,5,3,27436
2019-12-24,20034,26,733,126,2,3,20924
2019-12-25,12743,19,199,98,0,0,13059
2019-12-26,22020,23,465,156,4,3,22671
2019-12-27,26426,19,888,185,0,3,27521
2019-12-28,26212,27,696,201,7,4,27147
2019-12-29,20997,24,451,259,2,4,21737
2019-12-30,26997,24,1121,281,5,3,28431
2019-12-31,18973,25,433,132,2,3,19568
2020-01-01,11617,8,262,113,2,19,12021
2020-01-02,23189,25,897,250,1,7,24369
2020-01-03,28517,31,1156,199,1,3,29907
2020-01-04,34470,24,575,248,3,3,35323
2020-01-05,25265,22,458,173,1,5,25924
2020-01-06,21951,23,992,152,3,4,23125
2020-01-07,17064,25,2407,136,3,4,19639
2020-01-08,19805,23,2365,143,3,3,22342
2020-01-09,19785,32,2130,234,1,4,22186
2020-01-10,23219,27,1860,174,0,3,25283
2020-01-11,24628,24,1030,163,1,3,25849
2020-01-12,18440,27,675,166,3,5,19316
2020-01-13,19644,24,2924,143,2,3,22740
2020-01-14,17646,26,2588,152,2,2,20416
2020-01-15,19007,24,2511,143,3,3,21691
2020-01-16,20633,26,2384,161,3,6,23213
2020-01-17,22557,29,2074,178,1,4,24843
2020-01-18,23949,30,967,187,0,3,25136
2020-01-19,17437,23,714,155,1,3,18333
2020-01-20,20280,20,3435,144,1,3,23883
2020-01-21,19102,25,2717,129,1,4,21978
2020-01-22,19007,25,2635,139,4,4,21814
2020-01-23,20089,22,2579,156,1,4,22851
2020-01-24,21956,23,2139,169,1,4,24292
2020-01-25,24329,23,1032,189,3,3,25579
2020-01-26,16513,25,659,166,1,6,17370
2020-01-27,18831,25,3176,128,0,3,22163
2020-01-28,19100,28,3072,146,0,4,22350
2020-01-29,18646,27,2667,144,6,3,21493
2020-01-30,19694,28,2632,177,3,5,22539
2020-01-31,21439,24,2348,173,1,3,23988
2020-02-01,23896,22,916,202,3,3,25042
2020-02-02,17844,20,855,155,4,4,18882
2020-02-03,20642,30,3430,126,3,3,24234
2020-02-04,18070,20,2906,116,1,3,21116
2020-02-05,18864,29,2590,134,1,3,21621
2020-02-06,19306,26,2444,153,3,5,21937
2020-02-07,20740,29,2022,183,3,3,22980
2020-02-08,24778,24,929,186,1,4,25922
2020-02-09,18948,27,758,198,2,7,19940
2020-02-10,20512,28,3079,129,0,2,23750
2020-02-11,19996,31,2823,140,2,3,22995
2020-02-12,19399,24,2966,159,3,2,22553
2020-02-13,20277,30,2587,179,2,7,23082
2020-02-14,24008,30,2242,187,2,3,26472
2020-02-15,25650,29,1028,285,0,3,26995
2020-02-16,20692,22,673,169,3,4,21563
2020-02-17,21334,28,3308,156,4,3,24833
2020-02-18,19954,34,2811,146,3,4,22952
2020-02-19,21285,30,2956,178,3,3,24455
2020-02-20,21846,23,2626,189,5,1,24690
2020-02-21,23376,30,2390,203,3,3,26005
2020-02-22,24743,28,970,222,1,3,25967
2020-02-23,21593,29,921,204,2,5,22754
2020-02-24,20170,27,3415,148,2,3,23765
2020-02-25,18877,24,2859,146,2,4,21912
2020-02-26,18178,29,2465,157,2,3,20834
2020-02-27,19716,29,2641,184,0,4,22574
2020-02-28,21644,28,2237,189,0,4,24102
2020-02-29,23286,29,988,203,0,5,24511
2020-03-01,16657,21,778,144,1,5,17606
2020-03-02,18626,32,3320,155,2,3,22138
2020-03-03,18655,26,2707,136,1,2,21527
2020-03-04,20139,28,2847,136,4,6,23160
2020-03-05,19839,29,2569,144,3,6,22590
2020-03-06,21697,30,2217,286,0,3,24233
2020-03-07,23445,26,979,217,1,3,24671
2020-03-08,20416,11,726,185,3,7,21348
2020-03-09,18753,22,3549,140,2,3,22469
2020-03-10,18593,30,2908,135,3,3,21672
2020-03-11,18442,26,2585,147,2,3,21205
2020-03-12,18993,27,2269,140,3,5,21437
2020-03-13,18324,12,1800,93,3,2,20234
2020-03-14,14300,30,725,74,2,2,15133
2020-03-15,4644,17,338,39,1,5,5044
2020-03-16,4843,18,1351,20,2,1,6235
2020-03-17,3425,16,1489,16,1,0,4947
2020-03-18,2689,15,1476,10,3,0,4193
2020-03-19,1961,17,1172,7,1,0,3158
2020-03-20,1825,4,1078,10,1,1,2919
2020-03-21,991,17,528,4,1,0,1541
2020-03-22,919,17,310,1,0,0,1247
2020-03-23,1478,20,1309,3,0,1,2811
2020-03-24,1346,20,1077,3,0,0,2446
2020-03-25,1121,15,1163,2,0,0,2301
2020-03-26,1296,12,1395,3,0,0,2706
2020-03-27,1098,16,1094,1,0,0,2209
2020-03-28,703,19,403,0,2,0,1127
2020-03-29,496,18,291,2,2,1,810
2020-03-30,1512,19,1967,1,0,1,3500
2020-03-31,1268,12,1419,3,0,0,2702
2020-04-01,1466,16,1644,2,2,1,3131
2020-04-02,1270,14,1389,1,2,0,2676
2020-04-03,1441,19,1332,4,0,1,2797
2020-04-04,653,16,427,2,1,0,1099
2020-04-05,549,17,351,5,0,1,923
2020-04-06,1532,16,2180,0,3,0,3731
2020-04-07,1586,17,1868,2,1,0,3474
2020-04-08,1420,17,1652,0,1,0,3090
2020-04-09,1679,15,1569,3,0,0,3266
2020-04-10,1344,20,949,0,0,1,2314
2020-04-11,431,18,225,0,0,0,674
2020-04-12,140,16,60,0,0,0,216
2020-04-13,823,12,650,0,2,0,1487
2020-04-14,2061,14,2186,0,0,0,4261
2020-04-15,1893,15,1939,0,0,1,3848
2020-04-16,1658,18,1736,0,0,0,3412
2020-04-17,1667,15,1554,0,2,1,3239
2020-04-18,778,19,445,1,1,0,1244
2020-04-19,1141,25,500,1,0,0,1667
2020-04-20,2568,21,2403,0,0,0,4992
2020-04-21,1881,16,2054,0,0,0,3951
2020-04-22,1869,18,2509,0,1,0,4397
2020-04-23,2173,21,2030,0,0,0,4224
2020-04-24,2270,18,1644,0,1,0,3933
2020-04-25,1152,17,592,0,1,0,1762
2020-04-26,1175,16,673,0,2,0,1866
2020-04-27,1908,16,2635,3,2,0,4564
2020-04-28,2291,22,2179,2,2,0,4496
2020-04-29,2330,16,2017,5,3,0,4371
2020-04-30,2273,22,1737,2,0,0,4034
2020-05-01,807,22,282,0,0,0,1111
2020-05-02,1065,23,502,0,1,0,1591
2020-05-03,3083,1,632,0,2,0,3718
2020-05-04,2904,11,2881,6,2,3,5807
2020-05-05,2991,19,2568,2,2,0,5582
2020-05-06,2599,21,2470,3,5,0,5098
2020-05-07,2935,16,2167,5,0,2,5125
2020-05-08,3127,22,1792,6,1,0,4948
2020-05-09,1953,22,677,0,0,0,2652
2020-05-10,2799,15,565,0,1,0,3380
2020-05-11,4132,7,3087,3,0,2,7231
2020-05-12,3873,14,2672,8,0,0,6567
2020-05-13,4533,19,2829,8,2,2,7393
2020-05-14,4408,15,2330,13,0,1,6767
2020-05-15,5074,19,1909,8,1,0,7011
2020-05-16,3770,21,700,3,0,1,4495
2020-05-17,5455,21,577,3,4,0,6060
2020-05-18,7307,16,3331,10,2,0,10666
2020-05-19,6700,18,2933,8,1,0,9660
2020-05-20,7009,19,2415,10,1,0,9454
2020-05-21,7979,27,2398,15,3,0,10422
2020-05-22,9300,14,2431,5,3,0,11753
2020-05-23,8103,25,898,7,1,0,9034
2020-05-24,9048,20,670,2,1,0,9741
2020-05-25,10458,23,3491,12,3,0,13987
2020-05-26,9001,19,2965,55,4,2,12046
2020-05-27,9329,18,2862,26,3,1,12239
2020-05-28,9341,19,2266,14,2,1,11643
2020-05-29,12676,22,2358,21,4,1,15082
2020-05-30,13720,22,646,6,6,0,14400
2020-05-31,12356,20,613,10,3,0,13002
2020-06-01,20358,18,2570,13,7,0,22966
2020-06-02,18262,21,3045,12,4,2,21346
2020-06-03,17560,16,2602,11,8,2,20199
2020-06-04,16602,20,2856,11,3,0,19492
2020-06-05,19949,14,2211,13,2,0,22189
2020-06-06,22421,22,1099,11,4,0,23557
2020-06-07,15580,25,751,9,2,0,16367
2020-06-08,19100,22,3874,10,6,0,23012
2020-06-09,19703,20,2661,10,4,0,22398
2020-06-10,23266,23,2922,10,11,1,26233
2020-06-11,25240,21,1520,11,2,0,26794
2020-06-12,22726,18,2361,12,5,0,25122
2020-06-13,22928,22,1099,19,7,0,24075
2020-06-14,19389,19,788,15,3,0,20214
2020-06-15,20561,15,3251,15,7,2,23851
2020-06-16,18650,19,2837,14,5,1,21526
2020-06-17,20103,22,2447,38,5,0,22615
2020-06-18,20562,18,2722,46,4,3,23355
2020-06-19,22313,15,2510,50,4,1,24893
2020-06-20,20182,25,943,48,4,0,21202
2020-06-21,14592,22,689,43,1,1,15348
2020-06-22,21306,21,2432,44,2,4,23809
2020-06-23,16608,22,2830,47,7,0,19514
2020-06-24,19334,20,2585,52,6,3,22000
2020-06-25,7930,23,2021,58,5,1,10038
2020-06-26,9688,23,1978,53,6,3,11751
2020-06-27,8427,24,819,58,7,6,9341
2020-06-28,9811,23,522,58,5,1,10420
2020-06-29,10122,17,3166,34,5,3,13347
2020-06-30,10549,23,2978,58,9,2,13619
2020-07-01,14852,31,2372,57,5,3,17320
2020-07-02,18636,32,2440,52,1,2,21163
2020-07-03,20455,32,2310,68,4,5,22874
2020-07-04,17525,33,939,57,5,7,18566
2020-07-05,16507,27,966,103,5,4,17612
2020-07-06,16218,25,3112,45,5,4,19409
2020-07-07,15326,31,2894,48,4,1,18304
2020-07-08,15865,31,2775,70,5,5,18751
2020-07-09,15541,26,2373,78,5,3,18026
2020-07-10,16487,25,2142,68,9,4,18735
2020-07-11,14762,23,957,70,5,12,15829
2020-07-12,14557,23,661,67,2,6,15316
2020-07-13,13368,24,2789,54,12,6,16253
2020-07-14,12001,24,2499,69,3,5,14601
2020-07-15,13881,30,2603,64,3,5,16586
2020-07-16,13326,28,2256,77,5,5,15697
2020-07-17,15663,31,1966,76,3,6,17745
2020-07-18,14968,26,805,51,5,15,15870
2020-07-19,13404,27,749,78,5,4,14267
2020-07-20,15486,31,3370,62,12,7,18968
2020-07-21,13761,31,2441,63,9,5,16310
2020-07-22,14298,25,2313,60,7,5,16708
2020-07-23,15739,29,2669,84,6,5,18532
2020-07-24,17078,26,2414,78,5,7,19608
2020-07-25,16992,30,951,82,4,14,18073
2020-07-26,15431,13,744,83,4,8,16283
2020-07-27,16481,20,2815,73,8,3,19400
2020-07-28,15155,23,2643,75,7,5,17908
2020-07-29,15985,29,2548,62,9,7,18640
2020-07-30,17449,18,2098,66,11,9,19651
2020-07-31,18692,27,2015,55,11,5,20805
2020-08-01,19672,19,765,67,10,18,20551
2020-08-02,16719,29,500,94,8,4,17354
2020-08-03,17360,14,2426,50,9,7,19866
2020-08-04,18909,27,2488,81,5,5,21515
2020-08-05,20745,25,1642,82,5,8,22507
2020-08-06,18066,27,2018,81,5,7,20204
2020-08-07,19219,26,1828,75,7,11,21166
2020-08-08,21120,21,898,87,5,19,22150
2020-08-09,18582,31,701,72,4,10,19400
2020-08-10,19731,23,2568,79,6,7,22414
2020-08-11,18716,23,1846,57,8,4,20654
2020-08-12,18705,24,2035,62,6,8,20840
2020-08-13,20504,33,2085,71,11,10,22714
2020-08-14,23709,28,1781,86,12,12,25628
2020-08-15,20313,19,437,77,10,14,20870
2020-08-16,19035,22,553,69,10,10,19699
2020-08-17,17167,33,2509,117,11,10,19847
2020-08-18,16021,25,1998,57,8,6,18115
2020-08-19,16911,24,2322,53,6,7,19323
2020-08-20,17300,25,1924,80,9,7,19345
2020-08-21,17604,28,1922,89,10,9,19662
2020-08-22,16723,29,910,80,8,14,17764
2020-08-23,18014,26,740,76,5,8,18869
2020-08-24,15208,26,2749,183,2,7,18175
2020-08-25,14666,28,2476,66,3,4,17243
2020-08-26,14786,22,2355,74,3,7,17247
2020-08-27,15579,22,1845,85,6,6,17543
2020-08-28,16468,29,2488,72,4,6,19067
2020-08-29,15961,30,918,93,2,15,17019
2020-08-30,14465,23,570,69,1,12,15140
2020-08-31,15416,25,2289,54,4,5,17793
2020-09-01,14819,26,2769,59,6,4,17683
2020-09-02,14717,25,2617,64,2,6,17431
2020-09-03,14332,30,2402,73,5,7,16849
2020-09-04,15267,25,1683,67,3,7,17052
2020-09-05,16254,19,799,57,3,13,17145
2020-09-06,14079,14,614,67,4,9,14787
2020-09-07,14396,18,2869,74,3,4,17364
2020-09-08,14226,34,2016,56,6,3,16341
2020-09-09,13993,25,2509,61,1,4,16593
2020-09-10,15192,26,2358,89,4,10,17679
2020-09-11,16063,33,1837,72,6,7,18018
2020-09-12,16012,28,980,55,1,14,17090
2020-09-13,13298,22,654,61,5,4,14044
2020-09-14,15283,30,2902,64,11,5,18295
2020-09-15,14033,30,2442,82,2,4,16593
2020-09-16,14617,31,2317,50,1,7,17023
2020-09-17,15172,29,2393,66,5,4,17669
2020-09-18,16445,27,2229,91,1,3,18796
2020-09-19,15623,24,927,61,5,11,16651
2020-09-20,13682,26,862,58,3,9,14640
2020-09-21,15123,18,3102,56,6,3,18308
2020-09-22,13882,29,2877,65,1,4,16858
2020-09-23,13634,28,2298,56,5,5,16026
2020-09-24,15262,29,2198,70,5,7,17571
2020-09-25,16340,27,2383,78,0,2,18830
2020-09-26,15845,31,914,68,1,8,16867
2020-09-27,13569,25,691,66,2,6,14359
2020-09-28,15087,29,2679,63,4,4,17866
2020-09-29,14801,32,2564,53,10,2,17462
2020-09-30,16251,21,2805,74,1,4,19156
2020-10-01,16579,24,2587,70,3,4,19267
2020-10-02,18612,29,2161,68,0,3,20873
2020-10-03,18470,30,948,51,0,1,19500
2020-10-04,14769,24,690,70,2,5,15560
2020-10-05,17572,24,3228,59,7,3,20893
2020-10-06,16099,21,2719,58,2,2,18901
2020-10-07,15717,24,2496,54,3,2,18296
2020-10-08,16470,28,2584,75,9,3,19169
2020-10-09,17673,24,2080,70,7,3,19857
2020-10-10,19649,26,1052,69,4,3,20803
2020-10-11,14101,15,707,59,3,2,14887
2020-10-12,17854,25,3408,67,5,3,21362
2020-10-13,16621,24,2594,53,5,1,19298
2020-10-14,16690,27,2807,54,3,3,19584
2020-10-15,15478,30,2403,71,3,1,17986
2020-10-16,17803,29,1846,76,6,1,19761
2020-10-17,17009,29,940,74,4,3,18059
2020-10-18,14640,31,598,67,2,3,15341
2020-10-19,15399,28,3203,54,7,2,18693
2020-10-20,15408,18,2797,55,6,0,18284
2020-10-21,14432,29,2938,63,3,2,17467
2020-10-22,15424,27,2617,60,4,0,18132
2020-10-23,16341,33,2069,67,2,3,18515
2020-10-24,16127,26,1316,71,2,2,17544
2020-10-25,12604,23,662,64,2,1,13356
2020-10-26,16226,26,2872,55,1,2,19182
2020-10-27,13647,31,2814,51,2,0,16545
2020-10-28,13476,30,2840,60,11,2,16419
2020-10-29,14662,27,2601,60,3,0,17353
2020-10-30,18591,18,2120,75,4,2,20810
2020-10-31,18915,31,989,44,8,4,19991
2020-11-01,14687,31,768,49,2,2,15539
2020-11-02,15818,26,3153,46,3,3,19049
2020-11-03,13692,29,2571,39,1,0,16332
2020-11-04,13173,33,3005,35,3,0,16249
2020-11-05,13120,28,2753,47,0,2,15950
2020-11-06,15240,26,2441,46,8,1,17762
2020-11-07,14480,11,1067,54,2,2,15616
2020-11-08,11726,28,780,33,4,1,12572
2020-11-09,13750,24,3694,50,6,3,17527
2020-11-10,13005,25,2990,41,3,1,16065
2020-11-11,13245,26,2790,52,5,0,16118
2020-11-12,13662,26,2626,41,4,1,16360
2020-11-13,15734,27,2372,66,4,1,18204
2020-11-14,14244,30,1028,43,8,1,15354
2020-11-15,11733,29,722,34,3,0,12521
2020-11-16,13567,25,3624,40,4,2,17262
2020-11-17,12898,22,3048,53,2,1,16024
2020-11-18,13619,24,1831,32,4,0,15510
2020-11-19,12562,25,2464,40,5,1,15097
2020-11-20,14337,24,2379,50,1,1,16792
2020-11-21,12207,21,1123,33,3,1,13388
2020-11-22,9892,25,797,39,5,2,10760
2020-11-23,13320,25,3475,45,3,1,16869
2020-11-24,12801,29,2927,40,6,0,15803
2020-11-25,13033,24,2992,53,9,1,16112
2020-11-26,12806,26,2567,42,3,1,15445
2020-11-27,15247,25,2400,47,3,1,17723
2020-11-28,13335,26,1030,28,7,2,14428
2020-11-29,11298,23,795,30,3,1,12150
2020-11-30,15438,12,3637,38,6,2,19133
2020-12-01,7534,27,3015,38,2,1,10617
2020-12-02,5863,24,2734,42,3,1,8667
2020-12-03,5519,22,2361,49,3,2,7956
2020-12-04,6061,20,2045,39,1,1,8167
2020-12-05,4245,26,824,27,2,1,5125
2020-12-06,3321,23,596,18,3,1,3962
2020-12-07,6243,26,3282,36,3,2,9592
2020-12-08,5869,26,2357,42,2,0,8296
2020-12-09,6360,26,2828,37,3,0,9254
2020-12-10,5884,26,2452,38,5,3,8408
2020-12-11,6222,20,2217,47,8,2,8516
2020-12-12,4360,26,909,25,3,1,5324
2020-12-13,4309,28,738,31,4,1,5111
2020-12-14,6115,26,3415,19,5,2,9582
2020-12-15,6840,23,2926,27,6,0,9822
2020-12-16,6771,27,2784,21,7,2,9612
2020-12-17,7169,20,2622,42,10,1,9864
2020-12-18,7853,26,2440,42,3,3,10367
2020-12-19,5952,29,924,45,6,2,6958
2020-12-20,4362,24,776,60,4,2,5228
2020-12-21,7847,29,3153,42,3,0,11074
2020-12-22,8041,20,1772,53,6,1,9893
2020-12-23,5727,18,1589,23,6,5,7368
2020-12-24,4212,19,691,19,2,0,4943
2020-12-25,1629,19,191,7,0,0,1846
2020-12-26,2396,20,214,7,0,1,2638
2020-12-27,2990,20,423,10,6,1,3450
2020-12-28,4745,19,1460,9,2,3,6238
2020-12-29,4931,21,1248,11,1,0,6212
2020-12-30,5970,26,1016,5,4,0,7021
2020-12-31,4373,20,475,14,2,1,4885
2021-01-01,2613,20,116,4,0,0,2753
2021-01-02,3881,19,307,7,0,1,4215
2021-01-03,4944,22,530,20,2,2,5520
2021-01-04,6722,15,1544,13,3,2,8299
2021-01-05,6947,19,1510,11,0,0,8487
2021-01-06,5666,21,959,19,2,0,6667
2021-01-07,7419,25,1770,22,1,1,9238
2021-01-08,7570,19,1374,22,2,1,8988
2021-01-09,7256,30,812,25,0,1,8124
2021-01-10,6717,20,686,41,1,1,7466
2021-01-11,8098,21,2844,21,1,2,10987
2021-01-12,6591,21,2137,19,1,0,8769
2021-01-13,6503,20,2353,34,8,0,8918
2021-01-14,6522,19,2290,23,2,1,8857
2021-01-15,7789,29,2352,22,4,1,10197
2021-01-16,5829,27,787,25,2,2,6672
2021-01-17,5270,24,626,35,0,1,5956
2021-01-18,7698,11,3358,26,5,2,11100
2021-01-19,7419,25,2917,19,1,3,10384
2021-01-20,7614,20,2693,32,2,2,10363
2021-01-21,7438,21,2307,36,1,0,9803
2021-01-22,7920,27,2458,37,0,2,10444
2021-01-23,5977,24,844,22,0,1,6868
2021-01-24,5416,23,558,33,5,1,6036
2021-01-25,7887,20,3247,26,0,2,11182
2021-01-26,7312,22,3047,19,6,0,10406
2021-01-27,7869,20,3189,30,4,1,11113
2021-01-28,8803,19,2526,34,1,1,11384
2021-01-29,8204,20,2215,33,2,2,10476
2021-01-30,6020,30,941,19,2,3,7015
2021-01-31,6112,26,778,45,7,1,6969
2021-02-01,8645,23,3474,30,3,2,12177
2021-02-02,8046,22,2795,29,0,0,10892
2021-02-03,7572,24,2976,31,2,0,10605
2021-02-04,8210,20,2856,41,2,1,11130
2021-02-05,8724,19,2180,35,2,1,10961
2021-02-06,6149,24,1011,31,1,1,7217
2021-02-07,6954,24,760,34,1,0,7773
2021-02-08,8335,23,2585,25,1,2,10971
2021-02-09,8585,20,3238,37,0,0,11880
2021-02-10,7894,23,3069,25,1,1,11013
2021-02-11,8251,18,2997,39,2,1,11308
2021-02-12,8918,25,2284,44,0,1,11272
2021-02-13,6354,20,852,20,0,1,7247
2021-02-14,6394,23,727,39,2,2,7187
2021-02-15,9145,20,3651,36,3,1,12856
2021-02-16,8133,24,2719,37,3,1,10917
2021-02-17,8655,22,2934,36,5,2,11654
2021-02-18,8214,23,2687,38,2,1,10965
2021-02-19,9604,22,2548,41,1,2,12218
2021-02-20,7065,24,1425,23,0,1,8538
2021-02-21,7572,22,791,38,3,1,8427
2021-02-22,9742,18,3843,38,1,0,13642
2021-02-23,9113,22,3184,35,3,0,12357
2021-02-24,8677,24,3147,40,6,0,11894
2021-02-25,9007,25,3042,41,2,4,12121
2021-02-26,9450,23,2549,45,1,2,12070
2021-02-27,7178,29,1020,24,0,2,8253
2021-02-28,8185,24,783,45,2,1,9040
2021-03-01,9550,20,3919,42,4,3,13538
2021-03-02,8684,23,3078,43,2,0,11830
2021-03-03,8626,19,3311,42,2,0,12000
2021-03-04,9289,23,2949,50,1,4,12316
2021-03-05,9695,25,2318,45,3,1,12087
2021-03-06,6952,22,1018,34,1,1,8028
2021-03-07,7315,24,632,33,6,1,8011
2021-03-08,10660,22,4022,48,2,4,14758
2021-03-09,8082,20,3202,34,0,1,11339
2021-03-10,8554,18,2792,49,4,0,11417
2021-03-11,8224,19,3006,54,2,3,11308
2021-03-12,9261,20,2346,47,1,1,11676
2021-03-13,5874,24,756,19,2,1,6676
2021-03-14,5337,24,650,21,3,3,6038
2021-03-15,9614,22,3388,44,4,1,13073
2021-03-16,8133,23,3321,36,2,1,11516
2021-03-17,8523,21,2995,44,2,1,11586
2021-03-18,8582,27,2762,52,4,3,11430
2021-03-19,9129,24,2560,47,4,1,11765
2021-03-20,6647,29,1071,32,0,1,7780
2021-03-21,7918,27,871,36,1,1,8854
2021-03-22,9289,20,3751,39,0,3,13102
2021-03-23,8524,22,3321,34,1,0,11902
2021-03-24,8862,20,3209,48,7,1,12147
2021-03-25,8681,19,2798,50,3,3,11554
2021-03-26,8815,21,2573,43,9,1,11462
2021-03-27,6900,24,988,30,2,2,7946
2021-03-28,7146,20,895,41,1,1,8104
2021-03-29,9518,20,3998,40,0,2,13578
2021-03-30,8409,20,3273,35,5,0,11742
2021-03-31,9479,17,3096,42,5,1,12640
2021-04-01,10860,14,2643,57,4,3,13581
2021-04-02,9721,16,1402,32,4,2,11177
2021-04-03,6745,27,611,33,1,2,7419
2021-04-04,5360,24,267,26,1,0,5678
2021-04-05,14207,18,992,32,1,2,15252
2021-04-06,13479,20,3289,35,2,1,16826
2021-04-07,9511,28,3168,43,10,0,12760
2021-04-08,10458,20,2987,38,5,1,13509
2021-04-09,10915,18,2547,29,5,3,13517
2021-04-10,11571,22,858,36,5,2,12494
2021-04-11,9539,24,856,54,3,2,10478
2021-04-12,10390,20,3760,35,2,4,14211
2021-04-13,9100,14,2827,32,2,8,11983
2021-04-14,9304,18,3388,27,9,4,12750
2021-04-15,9370,16,2809,45,8,8,12256
2021-04-16,10582,25,2502,31,5,3,13148
2021-04-17,8093,17,1043,27,3,1,9184
2021-04-18,7715,18,580,40,10,2,8365
2021-04-19,10253,19,4115,29,5,2,14423
2021-04-20,9326,22,2959,30,6,0,12343
2021-04-21,9504,20,2939,31,3,0,12497
2021-04-22,9315,20,2630,30,2,1,11998
2021-04-23,10432,23,2684,35,5,4,13183
2021-04-24,8707,22,1121,26,2,4,9882
2021-04-25,9570,23,1124,41,3,2,10763
2021-04-26,11139,19,3759,25,2,2,14946
2021-04-27,8430,23,2435,31,3,0,10922
2021-04-28,10016,18,3427,25,5,0,13491
2021-04-29,10403,20,2944,40,2,3,13412
2021-04-30,11856,21,2237,30,1,3,14148
2021-05-01,6928,26,487,35,1,3,7480
2021-05-02,9402,25,744,43,2,3,10219
2021-05-03,11025,23,3759,31,2,2,14842
2021-05-04,11354,20,3014,46,2,0,14436
2021-05-05,10781,21,3139,37,1,1,13980
2021-05-06,10588,27,2882,48,5,1,13551
2021-05-07,12492,19,2776,33,2,2,15324
2021-05-08,9884,22,1014,38,5,3,10966
2021-05-09,10654,24,751,43,3,2,11477
2021-05-10,11389,23,3712,41,1,5,15171
2021-05-11,10742,15,3356,146,5,0,14264
2021-05-12,11562,25,2930,44,4,1,14566
2021-05-13,10808,24,2707,58,4,4,13605
2021-05-14,11856,19,2252,49,4,3,14183
2021-05-15,10597,26,1061,27,1,2,11714
2021-05-16,15234,22,704,42,3,4,16009
2021-05-17,12170,22,4117,37,3,2,16351
2021-05-18,10916,14,3285,46,6,2,14269
2021-05-19,11026,21,3131,52,3,3,14236
2021-05-20,11248,20,2503,68,6,3,13848
2021-05-21,12406,19,2565,55,3,3,15051
2021-05-22,10695,20,896,37,0,4,11652
2021-05-23,9793,24,995,50,4,3,10869
2021-05-24,16556,20,3022,47,3,3,19651
2021-05-25,12209,23,3539,39,2,0,15812
2021-05-26,11108,25,3153,56,8,1,14351
2021-05-27,11819,22,2757,68,5,2,14673
2021-05-28,13631,23,2454,72,6,5,16191
2021-05-29,11448,23,1114,48,4,4,12641
2021-05-30,11367,17,836,50,5,5,12280
2021-05-31,12940,19,3953,54,6,2,16974
2021-06-01,12420,22,2984,56,4,2,15488
2021-06-02,15029,22,3161,71,16,3,18302
2021-06-03,14905,19,1657,60,5,7,16653
2021-06-04,13986,16,1972,61,9,6,16050
2021-06-05,13818,18,801,64,8,5,14714
2021-06-06,20917,22,789,68,4,6,21806
2021-06-07,15845,14,4082,56,10,4,20011
2021-06-08,13132,16,2833,69,9,1,16060
2021-06-09,12946,20,2780,74,11,5,15836
2021-06-10,13713,16,2945,82,6,2,16764
2021-06-11,16600,19,2567,99,10,7,19302
2021-06-12,13742,21,1275,53,6,6,15103
2021-06-13,14307,23,718,65,9,5,15127
2021-06-14,15795,5,3765,72,12,5,19654
2021-06-15,14607,20,3099,68,5,3,17802
2021-06-16,14754,21,3022,77,9,4,17887
2021-06-17,14277,19,2957,99,8,8,17368
2021-06-18,16229,25,2510,101,6,6,18877
2021-06-19,17112,22,1084,92,7,11,18328
2021-06-20,16862,17,1077,77,3,5,18041
2021-06-21,16844,17,3774,63,9,5,20712
2021-06-22,16182,22,2350,83,6,5,18648
2021-06-23,15199,25,2666,70,8,7,17975
2021-06-24,16117,20,2424,89,10,6,18666
2021-06-25,15701,16,1847,128,6,8,17706
2021-06-26,15418,23,1223,119,5,12,16800
2021-06-27,16259,21,1044,99,3,10,17436
2021-06-28,16029,15,3737,51,8,4,19844
2021-06-29,14884,22,3132,70,6,3,18117
2021-06-30,15695,25,4614,68,7,7,20416
2021-07-01,15895,26,3069,114,7,7,19118
2021-07-02,18251,22,2485,107,7,7,20879
2021-07-03,17195,28,1117,133,6,20,18499
2021-07-04,16935,21,859,114,6,11,17946
2021-07-05,16691,17,3822,70,8,9,20617
2021-07-06,15677,24,2914,86,15,5,18721
2021-07-07,14899,18,2830,101,7,9,17864
2021-07-08,16089,19,2896,105,10,8,19127
2021-07-09,19433,19,2494,98,9,9,22062
2021-07-10,17904,22,896,102,9,16,18949
2021-07-11,16985,21,1117,117,10,13,18263
2021-07-12,17320,15,3743,72,15,14,21179
2021-07-13,16270,30,3001,61,8,11,19381
2021-07-14,16884,19,2552,94,5,7,19561
2021-07-15,18632,22,2610,131,15,7,21417
2021-07-16,20390,19,2487,110,11,10,23027
2021-07-17,17582,21,1051,158,5,21,18838
2021-07-18,18192,18,960,107,5,12,19294
2021-07-19,19761,21,3158,90,13,9,23052
2021-07-20,17225,25,2726,82,10,7,20075
2021-07-21,18066,20,2709,89,7,9,20900
2021-07-22,18777,21,2384,122,8,6,21318
2021-07-23,19697,20,2329,127,8,13,22194
2021-07-24,19826,19,1022,130,6,18,21021
2021-07-25,17845,26,925,113,12,12,18933
2021-07-26,19206,21,3376,84,8,7,22702
2021-07-27,17079,25,2698,83,15,8,19908
2021-07-28,17606,26,2458,98,8,7,20203
2021-07-29,19618,24,2459,114,9,8,22232
2021-07-30,20911,24,1981,126,12,9,23063
2021-07-31,20900,23,841,163,12,17,21956
2021-08-01,19740,26,735,132,5,11,20649
2021-08-02,22090,23,3186,101,10,7,25417
2021-08-03,19226,20,2721,72,9,3,22051
2021-08-04,21588,27,2560,103,6,10,24294
2021-08-05,23309,21,1870,117,7,7,25331
2021-08-06,21094,29,1766,107,15,11,23022
2021-08-07,21647,26,1116,108,6,16,22919
2021-08-08,22828,27,734,121,9,14,23733
2021-08-09,21665,26,3210,73,11,8,24993
2021-08-10,20729,23,2520,82,11,10,23375
2021-08-11,20820,17,2693,95,14,13,23652
2021-08-12,22230,13,2342,128,9,8,24730
2021-08-13,23728,10,1908,118,13,9,25786
2021-08-14,24654,15,900,118,14,19,25720
2021-08-15,21943,25,727,105,7,13,22820
2021-08-16,22372,23,3105,91,10,9,25610
2021-08-17,18304,17,2385,81,11,4,20802
2021-08-18,20177,22,2475,110,10,8,22802
2021-08-19,20096,17,2235,106,14,8,22476
2021-08-20,24088,19,1783,117,13,12,26032
2021-08-21,24029,26,991,131,13,17,25207
2021-08-22,21880,25,761,118,17,11,22812
2021-08-23,20491,23,3284,92,8,6,23904
2021-08-24,19432,26,2424,105,11,7,22005
2021-08-25,20174,28,2615,102,12,2,22933
2021-08-26,20927,20,2572,116,13,11,23659
2021-08-27,23849,21,2178,156,7,5,26216
2021-08-28,24011,23,841,161,4,17,25057
2021-08-29,20299,28,729,120,10,15,21201
2021-08-30,21635,27,3641,87,9,8,25407
2021-08-31,19347,23,2673,116,6,9,22174
2021-09-01,19102,23,2306,115,4,8,21558
2021-09-02,20938,20,2499,128,8,6,23599
2021-09-03,22733,25,2204,111,12,11,25096
2021-09-04,22249,23,1187,112,3,17,23591
2021-09-05,19345,32,805,139,9,13,20343
2021-09-06,19895,22,3826,108,8,8,23867
2021-09-07,18468,25,3006,101,7,8,21615
2021-09-08,19498,20,3162,113,2,8,22803
2021-09-09,19618,30,2386,128,11,7,22180
2021-09-10,21689,20,2300,151,8,12,24180
2021-09-11,22569,24,806,137,7,18,23561
2021-09-12,19944,23,865,134,7,6,20979
2021-09-13,19268,25,3488,118,16,9,22924
2021-09-14,18699,16,2584,108,6,8,21421
2021-09-15,18541,21,2683,117,5,8,21375
2021-09-16,20016,24,2585,117,9,4,22755
2021-09-17,21240,21,2133,148,4,9,23555
2021-09-18,21544,26,1090,135,7,16,22818
2021-09-19,18757,27,1091,130,8,10,20023
2021-09-20,20583,9,3221,96,5,8,23922
2021-09-21,17526,25,2846,124,6,7,20534
2021-09-22,18109,24,2966,115,6,7,21227
2021-09-23,19133,23,2671,136,10,7,21980
2021-09-24,20739,21,2261,135,16,9,23181
2021-09-25,21818,22,995,145,4,16,23000
2021-09-26,19631,25,862,116,17,11,20662
2021-09-27,17787,22,3054,99,8,5,20975
2021-09-28,16623,21,3283,104,11,7,20049
2021-09-29,16509,26,2760,131,3,7,19436
2021-09-30,17508,20,3090,140,3,4,20765
2021-10-01,19520,15,2211,143,5,10,21904
2021-10-02,18953,23,1319,127,3,15,20440
2021-10-03,18250,23,810,119,9,10,19221
2021-10-04,17316,22,3476,105,7,7,20933
2021-10-05,16307,23,3051,100,2,7,19490
2021-10-06,16863,23,2807,92,4,7,19796
2021-10-07,16584,19,2432,127,3,7,19172
2021-10-08,20668,19,2706,138,11,8,23550
2021-10-09,21268,20,1220,113,10,17,22648
2021-10-10,17123,20,842,104,2,13,18104
2021-10-11,17682,17,3702,94,5,7,21507
2021-10-12,17659,24,3044,101,8,6,20842
2021-10-13,72813,17,99273,3415,5,6,175529
2021-10-14,77054,20,107498,3740,1,4,188317
2021-10-15,20238,23,2372,131,4,9,22777
2021-10-16,20834,23,1117,132,3,11,22120
2021-10-17,19274,25,722,97,9,9,20136
2021-10-18,17658,20,3909,86,7,8,21688
2021-10-19,17352,20,2977,104,8,9,20470
2021-10-20,16510,25,3222,83,8,7,19855
2021-10-21,17102,21,2726,114,3,7,19973
2021-10-22,19336,20,2234,109,7,5,21711
2021-10-23,19205,26,951,121,2,12,20317
2021-10-24,16683,28,953,98,18,10,17790
2021-10-25,18337,17,3830,79,16,4,22283
2021-10-26,17486,18,2774,85,9,9,20381
2021-10-27,17506,23,2727,89,7,6,20358
2021-10-28,18230,21,2832,100,5,8,21196
2021-10-29,23532,21,2611,107,4,6,26281
2021-10-30,26813,19,1025,111,1,4,27973
2021-10-31,20622,25,542,111,5,3,21308
2021-11-01,22820,21,1216,52,1,4,24114
2021-11-02,21789,22,3951,59,3,14,25838
2021-11-03,17551,22,2778,55,4,3,20413
2021-11-04,16112,25,2410,74,3,4,18628
2021-11-05,18246,23,2451,78,5,3,20806
2021-11-06,17978,20,1087,93,2,3,19183
2021-11-07,16330,21,919,72,6,4,17352
2021-11-08,16018,25,3147,62,3,3,19258
2021-11-09,14506,18,2893,66,3,3,17489
2021-11-10,15937,24,3027,69,9,4,19070
2021-11-11,15686,22,2779,82,8,4,18581
2021-11-12,17413,22,2353,101,5,4,19898
2021-11-13,17606,24,1211,91,2,3,18937
2021-11-14,14743,24,777,72,2,3,15621
2021-11-15,16015,18,3603,65,2,4,19707
2021-11-16,14606,20,2755,66,2,3,17452
2021-11-17,18450,18,3079,74,3,5,21629
2021-11-18,21281,27,1824,81,3,4,23220
2021-11-19,16784,22,2316,75,6,4,19207
2021-11-20,15904,23,870,79,4,0,16880
2021-11-21,16530,20,775,85,2,4,17416
2021-11-22,16023,24,3437,62,6,6,19558
2021-11-23,14803,24,2733,60,4,3,17627
2021-11-24,15323,19,2807,72,6,4,18231
2021-11-25,15346,24,2807,91,2,3,18273
2021-11-26,16614,18,2311,80,2,4,19029
2021-11-27,15409,23,1107,70,1,3,16613
2021-11-28,13533,22,783,81,2,4,14425
2021-11-29,15189,19,3406,70,5,4,18693
2021-11-30,15247,22,2903,55,4,3,18234
2021-12-01,15119,19,2572,59,3,4,17776
2021-12-02,15515,14,2631,76,3,4,18243
2021-12-03,17653,17,2212,89,4,5,19980
2021-12-04,16775,21,1071,79,9,3,17958
2021-12-05,13134,18,1027,81,9,3,14272
2021-12-06,15213,16,3559,66,5,6,18865
2021-12-07,14979,21,2603,63,8,4,17678
2021-12-08,15889,22,2891,64,3,4,18873
2021-12-09,14869,21,2282,87,8,3,17270
2021-12-10,17834,21,2401,87,4,4,20351
2021-12-11,16967,20,1046,96,1,3,18133
2021-12-12,13365,24,774,81,6,5,14255
2021-12-13,15959,11,3536,58,7,4,19575
2021-12-14,15880,18,2751,62,4,4,18719
2021-12-15,16698,24,2950,62,7,2,19743
2021-12-16,17271,23,2833,75,5,3,20210
2021-12-17,18493,20,2659,89,4,6,21271
2021-12-18,19945,21,999,108,5,4,21082
2021-12-19,15159,22,1011,81,4,3,16280
2021-12-20,17180,26,3702,71,1,5,20985
2021-12-21,16687,18,2876,90,5,3,19679
2021-12-22,18740,18,2272,75,5,3,21113
2021-12-23,20440,20,1800,88,3,3,22354
2021-12-24,15262,27,936,52,2,4,16283
2021-12-25,9117,16,213,23,1,0,9370
2021-12-26,16012,20,598,80,1,4,16715
2021-12-27,17530,19,1784,63,2,4,19402
2021-12-28,18394,25,1665,65,4,3,20156
2021-12-29,18004,19,1389,71,3,5,19491
2021-12-30,19818,17,1167,91,2,5,21100
2021-12-31,15333,20,543,63,1,3,15963
2022-01-01,10090,22,201,25,1,3,10342
2022-01-02,21876,20,678,121,2,3,22700
2022-01-03,18121,15,1847,62,3,4,20052
2022-01-04,17566,12,1812,62,2,3,19457
2022-01-05,19435,19,1610,65,1,3,21133
2022-01-06,17861,21,846,74,0,3,18805
2022-01-07,18265,18,1210,87,5,4,19589
2022-01-08,19187,21,658,81,2,3,19952
2022-01-09,23490,22,907,87,1,4,24511
2022-01-10,17026,21,3468,60,0,4,20579
2022-01-11,14318,21,2420,61,0,4,16824
2022-01-12,14656,21,2374,51,1,3,17106
2022-01-13,15194,20,2200,126,7,2,17549
2022-01-14,16818,22,2338,72,6,5,19261
2022-01-15,17590,21,890,85,0,5,18591
2022-01-16,14945,22,819,68,2,3,15859
2022-01-17,15614,27,3534,56,3,4,19238
2022-01-18,15170,23,3048,50,4,3,18298
2022-01-19,15194,25,2135,64,4,6,17428
2022-01-20,14894,21,2849,68,1,3,17836
2022-01-21,17448,24,2083,80,0,4,19639
2022-01-22,18214,17,983,72,2,4,19292
2022-01-23,14370,27,859,67,2,4,15329
2022-01-24,14339,26,3664,54,1,3,18087
2022-01-25,13697,26,2942,58,7,5,16735
2022-01-26,14644,18,2837,54,2,5,17560
2022-01-27,15364,26,2086,75,5,3,17559
2022-01-28,16496,22,2631,74,1,3,19227
2022-01-29,17219,25,983,79,6,3,18315
2022-01-30,14649,19,868,64,2,3,15605
2022-01-31,15964,20,3657,56,1,3,19701
2022-02-01,14828,22,3087,54,2,3,17996
2022-02-02,14858,26,2760,58,4,3,17709
2022-02-03,16458,21,2498,68,4,4,19053
2022-02-04,18056,24,2084,72,4,3,20243
2022-02-05,19110,23,1321,81,1,3,20539
2022-02-06,14822,27,1093,86,2,4,16034
2022-02-07,16483,26,4038,64,1,3,20615
2022-02-08,14505,15,1813,61,7,3,16404
2022-02-09,16652,24,3345,69,3,3,20096
2022-02-10,16688,20,2872,81,3,1,19665
2022-02-11,18974,21,2513,79,2,3,21592
2022-02-12,20712,17,1223,121,2,2,22077
2022-02-13,17390,25,934,82,5,4,18440
2022-02-14,16953,23,3788,61,1,4,20830
2022-02-15,16012,25,3048,51,1,3,19140
2022-02-16,16437,25,3044,60,7,3,19576
2022-02-17,17883,16,2914,75,5,2,20895
2022-02-18,20075,20,2202,82,3,4,22386
2022-02-19,22232,23,1173,105,2,5,23540
2022-02-20,19134,27,1249,102,3,3,20518
2022-02-21,19753,23,4189,52,3,4,24024
2022-02-22,17506,24,2902,257,6,4,20699
2022-02-23,19576,17,3522,69,7,5,23196
2022-02-24,19320,17,2679,107,4,4,22131
2022-02-25,20637,28,2687,77,5,4,23438
2022-02-26,19479,17,1220,106,2,3,20827
2022-02-27,17410,14,1000,100,1,3,18528
2022-02-28,18456,16,3879,85,2,3,22441
2022-03-01,15873,28,2809,57,5,0,18772
2022-03-02,15640,24,2466,67,5,3,18205
2022-03-03,17127,25,3007,94,7,4,20264
2022-03-04,20122,22,2365,97,4,3,22613
2022-03-05,20770,24,1178,126,3,3,22104
2022-03-06,16872,24,998,97,2,3,17996
2022-03-07,18833,22,4006,78,4,3,22946
2022-03-08,16233,19,2841,77,8,4,19182
2022-03-09,15540,11,3082,80,4,3,18720
2022-03-10,17165,21,2850,116,3,3,20158
2022-03-11,19410,21,2767,111,3,3,22315
2022-03-12,19856,9,951,127,8,4,20955
2022-03-13,17655,11,997,90,1,3,18757
2022-03-14,18118,13,3750,73,5,3,21962
2022-03-15,16897,23,3015,78,6,3,20022
2022-03-16,16575,21,3318,75,6,3,19998
2022-03-17,16860,17,2924,83,3,3,19890
2022-03-18,18864,18,2667,112,4,4,21669
2022-03-19,21734,18,1002,111,4,3,22872
2022-03-20,17254,19,894,130,3,3,18303
2022-03-21,16798,25,3424,70,6,3,20326
2022-03-22,15580,17,3053,81,8,4,18743
2022-03-23,15355,24,3596,96,5,3,19079
2022-03-24,16744,20,3144,114,6,3,20031
2022-03-25,19546,23,2593,120,7,3,22292
2022-03-26,20030,26,1196,128,2,3,21385
2022-03-27,18763,20,922,102,2,3,19812
2022-03-28,16309,19,3393,76,4,6,19807
2022-03-29,15389,23,2915,63,5,5,18400
2022-03-30,16263,24,3139,69,5,3,19503
2022-03-31,17198,21,3206,81,6,4,20516
2022-04-01,18937,20,2279,137,5,5,21383
2022-04-02,19001,19,1091,147,2,3,20263
2022-04-03,16488,29,905,98,9,3,17532
2022-04-04,17457,23,4277,102,7,5,21871
2022-04-05,15936,18,3042,77,7,4,19084
2022-04-06,16408,10,3147,82,3,4,19654
2022-04-07,18119,22,2969,102,12,4,21228
2022-04-08,18831,19,2597,146,3,4,21600
2022-04-09,21825,15,1187,163,2,5,23197
2022-04-10,16582,24,1039,125,8,7,17785
2022-04-11,18809,26,3927,77,4,4,22847
2022-04-12,18094,21,3259,116,5,5,21500
2022-04-13,19452,22,2976,123,4,4,22581
2022-04-14,23230,25,3393,92,5,5,26750
2022-04-15,22664,20,1629,96,5,4,24418
2022-04-16,21135,23,819,110,4,7,22098
2022-04-17,15362,28,314,76,2,4,15786
2022-04-18,30726,28,1040,123,3,5,31925
2022-04-19,23098,17,3984,92,8,6,27205
2022-04-20,20855,22,3082,90,6,3,24058
2022-04-21,21104,27,2998,119,6,4,24258
2022-04-22,22244,21,2504,120,3,3,24895
2022-04-23,23901,14,1266,170,6,8,25365
2022-04-24,21252,22,908,134,4,4,22324
2022-04-25,21076,22,3790,113,9,4,25014
2022-04-26,17567,23,3392,124,10,8,21124
2022-04-27,17953,22,2280,131,5,4,20395
2022-04-28,19141,19,3136,140,5,3,22444
2022-04-29,24043,26,2429,155,5,3,26661
2022-04-30,26351,21,1555,134,2,8,28071
2022-05-01,19444,25,839,138,9,4,20459
2022-05-02,18675,17,2065,117,11,8,20893
2022-05-03,17951,21,3020,120,5,3,21120
2022-05-04,18655,21,2572,110,7,5,21370
2022-05-05,19896,24,2829,143,7,5,22904
2022-05-06,23006,23,2184,165,2,6,25386
2022-05-07,23934,24,1163,174,6,8,25309
2022-05-08,20928,22,961,131,5,5,22052
2022-05-09,19446,18,3861,122,7,6,23460
2022-05-10,19737,23,3120,117,5,8,23010
2022-05-11,20547,13,2847,135,5,5,23552
2022-05-12,20794,13,2658,151,4,4,23624
2022-05-13,22340,21,2708,158,5,6,25238
2022-05-14,24789,17,1180,189,3,10,26188
2022-05-15,23241,19,785,157,4,6,24212
2022-05-16,21890,17,3916,134,10,10,25977
2022-05-17,18966,18,2925,140,5,6,22060
2022-05-18,19833,18,2898,187,2,7,22945
2022-05-19,20134,20,2763,170,9,5,23101
2022-05-20,21923,23,2674,175,5,7,24807
2022-05-21,23938,21,1118,231,3,8,25319
2022-05-22,22153,25,965,164,10,8,23325
2022-05-23,21347,18,3909,143,10,8,25435
2022-05-24,19853,22,2953,134,13,5,22980
2022-05-25,19070,17,2931,158,6,9,22191
2022-05-26,23532,23,3011,157,13,6,26742
2022-05-27,24366,28,2395,181,8,9,26987
2022-05-28,25010,17,1147,214,2,14,26404
2022-05-29,23772,16,890,147,5,8,24838
2022-05-30,26322,18,2677,134,8,6,29165
2022-05-31,18079,21,3332,138,14,7,21591
2022-06-01,18719,17,2870,129,5,10,21750
2022-06-02,19412,15,2709,163,10,8,22317
2022-06-03,20122,17,2127,170,5,12,22453
2022-06-04,23116,21,1022,189,4,18,24370
2022-06-05,21133,30,867,189,11,5,22235
2022-06-06,28696,19,2978,154,11,9,31867
2022-06-07,20689,24,3331,140,10,8,24202
2022-06-08,18738,19,2761,135,7,9,21669
2022-06-09,20441,29,2628,172,2,4,23276
2022-06-10,23135,18,2220,190,4,15,25582
2022-06-11,23438,20,1074,203,7,22,24764
2022-06-12,21754,29,971,142,8,18,22922
2022-06-13,21777,16,3822,163,14,3,25795
2022-06-14,18712,26,3023,148,5,11,21925
2022-06-15,22581,18,3022,170,5,13,25809
2022-06-16,26910,28,1563,220,6,14,28741
2022-06-17,23815,22,2205,209,5,15,26271
2022-06-18,23392,11,1062,197,5,19,24686
2022-06-19,25737,10,887,155,15,14,26818
2022-06-20,21284,6,3654,155,13,13,25125
2022-06-21,20548,28,2864,172,9,12,23633
2022-06-22,24958,20,2105,216,7,8,27314
2022-06-23,19869,20,2628,180,7,4,22708
2022-06-24,23039,19,2287,213,4,14,25576
2022-06-25,22055,19,1324,234,3,22,23657
2022-06-26,25460,23,866,179,9,13,26550
2022-06-27,21325,22,4010,143,9,16,25525
2022-06-28,18031,10,2829,155,7,11,21043
2022-06-29,19375,15,2627,137,2,14,22170
2022-06-30,19152,21,2653,176,10,6,22018
2022-07-01,22361,17,2264,172,11,14,24839
2022-07-02,22524,17,1003,160,13,18,23735
2022-07-03,21526,31,901,181,11,17,22667
2022-07-04,20976,18,3358,142,7,12,24513
2022-07-05,18568,19,2526,117,11,14,21255
2022-07-06,23299,20,2812,125,5,15,26276
2022-07-07,21956,25,2244,152,9,13,24399
2022-07-08,26361,20,2164,153,5,14,28717
2022-07-09,24917,18,861,190,7,23,26016
2022-07-10,21440,20,659,163,9,18,22309
2022-07-11,21877,20,3141,430,15,14,25497
2022-07-12,22520,22,2779,165,8,10,25504
2022-07-13,21575,20,2500,133,10,11,24249
2022-07-14,22862,13,2726,180,6,11,25798
2022-07-15,24856,26,2120,166,11,15,27194
2022-07-16,26525,17,1146,193,5,23,27909
2022-07-17,22596,30,866,162,7,18,23679
2022-07-18,20712,16,2832,133,12,14,23719
2022-07-19,20130,22,2740,139,11,14,23056
2022-07-20,23384,17,2663,147,9,16,26236
2022-07-21,20555,14,2529,156,11,13,23278
2022-07-22,22243,18,1996,174,9,15,24455
2022-07-23,25340,18,850,195,9,21,26433
2022-07-24,21235,18,785,169,10,18,22235
2022-07-25,22786,17,3526,131,16,10,26486
2022-07-26,21042,19,2598,130,10,12,23811
2022-07-27,19904,21,2790,137,6,10,22868
2022-07-28,20621,18,2772,126,12,14,23563
2022-07-29,29670,15,2077,132,10,15,31919
2022-07-30,24699,21,809,164,9,23,25725
2022-07-31,23950,25,821,164,12,19,24991
2022-08-01,23829,24,3249,121,12,15,27250
2022-08-02,22465,13,2445,121,6,12,25062
2022-08-03,21651,18,2328,135,7,12,24151
2022-08-04,24106,21,2298,138,12,27,26602
2022-08-05,29379,19,1360,157,8,14,30937
2022-08-06,24018,13,758,177,7,23,24996
2022-08-07,23339,16,573,148,12,19,24107
2022-08-08,22171,18,2981,132,9,20,25331
2022-08-09,22595,18,2391,127,7,9,25147
2022-08-10,23943,12,2290,146,3,13,26407
2022-08-11,23609,30,2032,134,7,18,25830
2022-08-12,27131,14,2011,141,6,28,29331
2022-08-13,26558,17,976,185,11,30,27777
2022-08-14,26402,16,495,140,17,16,27086
2022-08-15,25227,12,921,126,8,15,26309
2022-08-16,22662,14,2979,112,7,8,25782
2022-08-17,22298,21,1995,135,12,27,24488
2022-08-18,22314,22,1968,129,11,16,24460
2022-08-19,25011,18,1610,143,6,10,26798
2022-08-20,27654,20,887,163,11,20,28755
2022-08-21,26086,21,768,136,7,37,27055
2022-08-22,24558,24,2879,136,16,16,27629
2022-08-23,19907,26,2212,117,14,13,22289
2022-08-24,20334,21,2495,125,5,13,22993
2022-08-25,22561,22,1817,131,9,33,24573
2022-08-26,25010,28,2095,153,12,28,27326
2022-08-27,25362,21,626,187,10,19,26225
2022-08-28,23446,20,670,163,10,12,24321
2022-08-29,21728,24,2757,108,10,25,24652
2022-08-30,21150,22,2556,121,13,12,23874
2022-08-31,17978,17,2282,130,6,5,20418
2022-09-01,21892,20,2294,124,4,16,24350
2022-09-02,23540,26,2107,147,12,32,25864
2022-09-03,26613,21,956,184,4,21,27799
2022-09-04,20384,18,688,153,12,18,21273
2022-09-05,20352,24,3409,131,14,14,23944
2022-09-06,19284,17,2434,131,10,34,21910
2022-09-07,19571,17,2694,149,6,25,22462
2022-09-08,22827,23,2175,162,5,30,25222
2022-09-09,23317,19,2026,156,8,15,25541
2022-09-10,24111,12,1145,162,11,21,25462
2022-09-11,21877,21,627,172,12,17,22726
2022-09-12,20073,15,2979,155,13,14,23249
2022-09-13,17829,24,2509,155,11,28,20556
2022-09-14,17108,16,2295,169,3,12,19603
2022-09-15,21884,24,2548,162,3,15,24636
2022-09-16,21413,16,1838,168,4,12,23451
2022-09-17,24688,27,1114,183,0,24,26036
2022-09-18,19205,19,827,163,20,15,20249
2022-09-19,20199,20,3800,138,13,15,24185
2022-09-20,18801,16,2652,152,8,13,21642
2022-09-21,18992,25,2563,137,1,26,21744
2022-09-22,19076,19,2231,168,8,14,21516
2022-09-23,22320,24,1993,183,5,16,24541
2022-09-24,25670,17,1021,237,5,5,26955
2022-09-25,20602,20,856,178,2,13,21671
2022-09-26,19322,13,3141,339,9,32,22856
2022-09-27,17712,25,2653,141,2,9,20542
2022-09-28,18279,26,2635,152,6,7,21105
2022-09-29,19061,22,2434,167,1,23,21708
2022-09-30,23144,15,1996,198,6,10,25369
2022-10-01,22511,24,937,214,1,17,23704
2022-10-02,20962,14,563,153,17,9,21718
2022-10-03,21290,25,3353,119,6,5,24798
2022-10-04,18312,22,2523,122,9,30,21018
2022-10-05,17190,24,2568,148,6,9,19945
2022-10-06,17840,17,2346,153,9,9,20374
2022-10-07,22093,21,2409,211,19,30,24783
2022-10-08,23843,24,1083,252,7,14,25223
2022-10-09,19208,25,758,157,4,9,20161
2022-10-10,17854,18,3194,125,12,12,21215
2022-10-11,17486,15,2680,117,7,26,20331
2022-10-12,17783,23,2603,140,4,8,20561
2022-10-13,18609,15,2490,141,10,7,21272
2022-10-14,20821,23,2300,206,11,8,23369
2022-10-15,24876,17,1121,211,3,36,26264
2022-10-16,20005,24,781,163,10,7,20990
2022-10-17,18542,21,3206,105,10,6,21890
2022-10-18,17857,20,2780,111,6,7,20781
2022-10-19,17690,20,2901,120,5,6,20742
2022-10-20,17978,17,2282,130,6,5,20418
2022-10-21,20131,24,2192,168,2,7,22524
2022-10-22,22291,11,1032,263,1,13,23611
2022-10-23,19362,16,1019,134,6,26,20563
2022-10-24,18307,16,3652,100,4,9,22088
2022-10-25,16892,24,2599,86,6,26,19633
2022-10-26,16718,18,2363,106,6,5,19216
2022-10-27,19182,22,2464,127,4,21,21820
2022-10-28,24887,20,2178,149,3,11,27248
2022-10-29,28225,24,1090,194,6,11,29550
2022-10-30,23499,16,865,110,6,4,24500
2022-10-31,25139,14,1625,85,1,19,26883
2022-11-01,25944,23,944,86,4,4,27005
2022-11-02,20208,27,3494,89,4,5,23827
2022-11-03,18846,17,2339,117,4,6,21329
2022-11-04,19699,32,2003,118,0,6,21858
