,osobni automobili,vlakovi,teretna vozila,autobusi,plovila,zrakoplovi,UKUPNO
2013-01-01,11213,7,134,161,0,13,11528
2013-01-02,17812,12,522,159,2,22,18529
2013-01-03,16870,14,866,146,4,19,17919
2013-01-04,16687,10,1034,112,1,27,17871
2013-01-05,19599,11,576,135,2,18,20341
2013-01-06,15608,9,263,160,2,23,16065
2013-01-07,15376,10,947,126,0,23,16482
2013-01-08,15203,10,1439,109,3,16,16780
2013-01-09,15936,9,1365,110,2,21,17443
2013-01-10,18439,11,1570,109,5,18,20152
2013-01-11,18902,12,1717,119,1,24,20775
2013-01-12,25237,13,936,204,1,17,26408
2013-01-13,14610,11,266,179,3,23,15092
2013-01-14,12398,7,814,110,0,20,13349
2013-01-15,13339,12,1554,98,2,17,15022
2013-01-16,14676,11,1611,103,0,22,16423
2013-01-17,13631,13,1668,97,1,20,15430
2013-01-18,14419,13,1512,106,0,22,16072
2013-01-19,17221,13,1097,155,4,17,18507
2013-01-20,14128,7,334,103,2,20,14594
2013-01-21,14592,10,1306,96,0,23,16027
2013-01-22,14641,11,1627,110,1,16,16406
2013-01-23,14663,16,1605,100,5,22,16411
2013-01-24,14823,15,1755,103,3,19,16718
2013-01-25,15420,11,1528,111,0,22,17092
2013-01-26,16442,10,1194,136,1,20,17803
2013-01-27,14341,14,419,133,3,22,14932
2013-01-28,14587,10,1397,96,1,25,16116
2013-01-29,13484,12,1578,79,1,17,15171
2013-01-30,15093,13,1896,90,4,23,17119
2013-01-31,16735,16,1838,110,2,20,18721
2013-02-01,17848,18,1907,117,3,28,19921
2013-02-02,18702,11,1097,154,1,16,19981
2013-02-03,15924,12,254,124,1,21,16336
2013-02-04,16179,11,1426,107,5,23,17751
2013-02-05,15145,11,1608,99,5,20,16888
2013-02-06,13971,13,1613,93,2,22,15714
2013-02-07,16238,13,2004,108,2,23,18388
2013-02-08,16787,12,1429,120,1,23,18372
2013-02-09,18355,15,1247,172,2,18,19809
2013-02-10,14046,14,297,182,1,22,14562
2013-02-11,16664,14,1646,130,1,23,18478
2013-02-12,13604,14,1382,106,2,19,15127
2013-02-13,13279,13,1500,115,3,21,14931
2013-02-14,14628,12,1629,116,1,20,16406
2013-02-15,16326,14,1916,116,5,25,18402
2013-02-16,19429,11,1263,171,2,16,20892
2013-02-17,15305,14,376,169,1,28,15893
2013-02-18,15964,9,1840,116,3,24,17956
2013-02-19,15853,15,1801,102,3,20,17794
2013-02-20,14437,10,1945,106,5,22,16525
2013-02-21,15219,12,1979,121,0,21,17352
2013-02-22,15672,14,1691,105,2,25,17509
2013-02-23,16022,12,1228,145,5,18,17430
2013-02-24,14698,12,354,154,0,24,15242
2013-02-25,15068,10,1601,102,1,23,16805
2013-02-26,15030,9,1663,94,4,21,16821
2013-02-27,15566,13,1790,95,4,22,17490
2013-02-28,16708,9,1942,111,2,21,18793
2013-03-01,18062,11,1850,110,5,25,20063
2013-03-02,18069,13,993,204,2,15,19296
2013-03-03,17319,12,412,195,1,25,17964
2013-03-04,16602,10,1475,114,5,23,18229
2013-03-05,16082,12,1845,102,7,19,18067
2013-03-06,16015,12,1943,119,1,21,18111
2013-03-07,16741,12,2100,120,0,21,18994
2013-03-08,18502,10,2038,123,1,25,20699
2013-03-09,20897,17,1095,181,3,17,22210
2013-03-10,15531,14,299,191,5,24,16064
2013-03-11,17568,13,1711,123,1,22,19438
2013-03-12,16070,15,1866,112,5,15,18083
2013-03-13,15937,12,1941,109,3,20,18022
2013-03-14,14586,15,1565,173,1,21,16361
2013-03-15,16889,9,1734,118,2,25,18777
2013-03-16,20640,9,1242,264,4,17,22176
2013-03-17,16319,12,341,204,5,24,16905
2013-03-18,15473,12,1576,137,0,23,17221
2013-03-19,17594,16,1739,130,4,3,19486
2013-03-20,16397,11,1783,122,3,22,18338
2013-03-21,18369,15,1976,126,3,2,20491
2013-03-22,17567,10,2022,140,2,25,19766
2013-03-23,20859,13,1320,203,5,19,22419
2013-03-24,16750,14,389,253,2,23,17431
2013-03-25,15635,9,1287,125,3,24,17083
2013-03-26,15143,12,1565,144,15,18,16897
2013-03-27,19250,13,1887,146,4,23,21323
2013-03-28,20412,16,2031,187,7,20,22673
2013-03-29,20806,12,1910,162,7,27,22924
2013-03-30,18835,15,789,136,6,19,19800
2013-03-31,12976,5,140,105,2,23,13251
2013-04-01,23548,7,326,185,1,24,24091
2013-04-02,17482,11,1493,159,2,22,19169
2013-04-03,15685,9,1622,147,3,23,17489
2013-04-04,17589,10,1868,149,7,23,19646
2013-04-05,18425,17,1977,158,2,23,20602
2013-04-06,19222,10,1149,207,3,21,20612
2013-04-07,17062,11,349,262,1,21,17706
2013-04-08,16091,7,1787,133,1,26,18045
2013-04-09,16531,11,1905,140,4,21,18612
2013-04-10,16829,13,2028,155,3,24,19052
2013-04-11,17383,13,2101,170,4,23,19694
2013-04-12,18991,12,1852,162,7,5,21029
2013-04-13,21759,11,1225,240,6,21,23262
2013-04-14,17355,11,380,249,4,24,18023
2013-04-15,17686,8,1642,143,6,24,19509
2013-04-16,17002,13,1749,150,6,23,18943
2013-04-17,18214,11,2097,156,7,27,20512
2013-04-18,18924,12,2072,182,7,27,21224
2013-04-19,21251,11,2291,187,10,26,23776
2013-04-20,22161,15,1311,273,7,22,23789
2013-04-21,19101,7,378,325,15,22,19848
2013-04-22,17800,12,1932,223,8,20,19995
2013-04-23,17991,14,2078,189,6,22,20300
2013-04-24,18440,9,2415,220,8,26,21118
2013-04-25,20356,13,2125,197,10,28,22729
2013-04-26,20296,12,2551,249,12,29,23149
2013-04-27,21993,15,977,235,8,22,23250
2013-04-28,19178,15,494,276,5,27,19995
2013-04-29,20529,13,2046,190,2,29,22809
2013-04-30,22767,13,2572,263,5,28,25648
2013-05-01,18251,13,644,243,14,26,19191
2013-05-02,19127,13,1320,218,15,26,20719
2013-05-03,19739,10,2147,231,15,32,22174
2013-05-04,22178,15,1214,270,9,31,23717
2013-05-05,20172,17,314,289,3,30,20825
2013-05-06,19686,16,1780,238,4,31,21755
2013-05-07,19750,12,2308,215,12,30,22327
2013-05-08,18255,14,2481,220,26,31,21027
2013-05-09,20752,13,2321,251,8,30,23375
2013-05-10,20425,11,2203,216,9,32,22896
2013-05-11,23207,13,1258,335,8,31,24852
2013-05-12,20228,14,376,342,4,32,20996
2013-05-13,18342,15,1686,206,5,29,20283
2013-05-14,18516,13,1974,190,12,22,20727
2013-05-15,19728,13,2555,266,9,24,22595
2013-05-16,20692,12,2775,235,9,21,23744
2013-05-17,21565,11,2241,229,11,23,24080
2013-05-18,22785,15,1483,289,8,22,24602
2013-05-19,21195,16,418,346,5,18,21998
2013-05-20,20118,12,1885,238,15,17,22285
2013-05-21,18487,11,2070,204,8,17,20797
2013-05-22,19885,11,2015,245,15,27,22198
2013-05-23,20614,12,2383,240,8,28,23285
2013-05-24,21213,14,2550,275,7,29,24088
2013-05-25,22682,12,1332,297,5,33,24361
2013-05-26,19240,15,349,331,35,29,19999
2013-05-27,18738,14,1806,234,7,30,20829
2013-05-28,18660,12,2483,283,8,29,21475
2013-05-29,20097,9,2116,295,13,29,22559
2013-05-30,24339,12,1419,240,17,32,26059
2013-05-31,22883,11,2077,329,18,30,25348
2013-06-01,22412,14,1445,335,4,33,24243
2013-06-02,19587,15,447,340,8,28,20425
2013-06-03,19044,11,1791,279,6,34,21165
2013-06-04,18144,14,2215,255,4,30,20662
2013-06-05,18726,14,2383,250,5,29,21407
2013-06-06,19135,11,2228,236,8,9,21627
2013-06-07,20618,16,2388,294,8,31,23355
2013-06-08,23587,12,1424,363,3,36,25425
2013-06-09,20678,16,436,334,6,30,21500
2013-06-10,19568,10,1833,273,6,28,21718
2013-06-11,18608,10,2303,240,5,29,21195
2013-06-12,19280,11,2415,266,7,29,22008
2013-06-13,21137,13,2602,297,8,31,24088
2013-06-14,23981,12,2713,358,6,30,27100
2013-06-15,24482,13,1434,336,5,38,26308
2013-06-16,20449,15,432,353,5,31,21285
2013-06-17,20195,14,1948,289,7,34,22487
2013-06-18,19898,12,2225,207,10,29,22381
2013-06-19,19175,10,2368,260,30,28,21871
2013-06-20,20438,12,2474,296,16,33,23269
2013-06-21,22334,12,2670,313,10,34,25373
2013-06-22,26516,13,1281,456,9,35,28310
2013-06-23,21262,15,416,360,2,28,22083
2013-06-24,24262,11,1734,374,6,36,26423
2013-06-25,25891,15,1407,360,9,32,27714
2013-06-26,20595,14,2371,287,10,30,23307
2013-06-27,20570,11,2197,247,13,31,23069
2013-06-28,22446,17,2456,308,12,33,25272
2013-06-29,24178,16,1459,373,7,34,26067
2013-06-30,22515,14,498,347,6,32,23412
2013-07-01,18773,11,1468,325,4,31,20612
2013-07-02,17056,13,1832,274,8,32,19215
2013-07-03,17596,12,1956,285,9,30,19888
2013-07-04,18782,12,1981,267,11,33,21086
2013-07-05,20675,12,1970,261,12,33,22963
2013-07-06,23175,12,1022,322,6,33,24570
2013-07-07,20314,12,432,312,6,33,21109
2013-07-08,21011,9,1885,281,13,31,23230
2013-07-09,18824,10,2118,245,9,32,21238
2013-07-10,18859,16,2051,250,7,30,21213
2013-07-11,22739,12,2407,289,12,30,25489
2013-07-12,22241,12,2297,287,10,29,24876
2013-07-13,23157,10,1166,296,9,35,24673
2013-07-14,22164,15,381,283,3,33,22879
2013-07-15,21149,9,2007,273,6,37,23481
2013-07-16,19007,11,1874,285,7,28,21212
2013-07-17,19637,11,2110,245,9,29,22041
2013-07-18,20730,13,2041,249,10,33,23076
2013-07-19,22090,11,2164,267,12,33,24577
2013-07-20,23921,13,1244,279,9,33,25499
2013-07-21,21815,10,378,288,8,32,22531
2013-07-22,21048,11,1906,271,3,34,23273
2013-07-23,19543,16,1935,267,5,29,21795
2013-07-24,18590,12,1952,252,10,31,20847
2013-07-25,20335,11,2072,243,7,34,22702
2013-07-26,22545,12,2252,259,79,32,25179
2013-07-27,21822,11,1183,310,11,36,23373
2013-07-28,21925,12,352,264,10,31,22594
2013-07-29,21306,11,1708,261,8,33,23327
2013-07-30,21090,16,2475,258,9,28,23876
2013-07-31,19736,11,2285,275,9,30,22346
2013-08-01,22774,13,2261,269,11,31,25359
2013-08-02,21963,15,2068,277,8,33,24364
2013-08-03,24767,12,1024,289,14,51,26157
2013-08-04,22355,14,386,448,7,32,23242
2013-08-05,27282,11,1117,269,5,35,28719
2013-08-06,19855,14,1722,263,6,30,21890
2013-08-07,19719,8,2068,252,14,11,22072
2013-08-08,21200,15,1962,272,16,37,23502
2013-08-09,21625,11,2309,250,10,37,24242
2013-08-10,24412,14,1149,312,8,36,25931
2013-08-11,21723,13,448,299,5,32,22520
2013-08-12,21761,9,1588,246,7,36,23647
2013-08-13,21351,12,2133,247,12,30,23785
2013-08-14,23578,15,2013,305,9,32,25952
2013-08-15,23435,14,815,286,11,47,24608
2013-08-16,25229,15,1699,259,11,37,27250
2013-08-17,26508,15,1100,331,12,38,28004
2013-08-18,25382,11,328,258,9,31,26019
2013-08-19,21294,11,1554,277,6,35,23177
2013-08-20,22278,12,1555,250,7,33,24135
2013-08-21,21454,30,2213,275,10,32,24014
2013-08-22,20970,10,1972,244,25,34,23255
2013-08-23,21090,15,2050,268,11,32,23466
2013-08-24,22182,11,895,256,9,35,23388
2013-08-25,20299,13,341,316,5,30,21004
2013-08-26,20992,10,1797,266,5,34,23104
2013-08-27,19101,14,1930,283,4,27,21359
2013-08-28,19589,11,2053,238,15,34,21940
2013-08-29,20590,13,2043,257,12,34,22949
2013-08-30,21508,12,2085,239,16,35,23895
2013-08-31,22204,14,1149,321,8,52,23748
2013-09-01,19956,11,383,267,9,29,20655
2013-09-02,20443,9,1660,231,7,35,22385
2013-09-03,18728,10,1789,218,8,32,20785
2013-09-04,17833,24,1980,245,12,30,20124
2013-09-05,20281,9,2088,237,13,31,22659
2013-09-06,20340,10,2131,235,9,34,22759
2013-09-07,23932,12,1166,281,7,37,25435
2013-09-08,20042,12,353,312,6,31,20756
2013-09-09,19066,11,1746,243,6,32,21104
2013-09-10,17892,12,2146,249,9,33,20341
2013-09-11,18816,7,2157,265,12,31,21288
2013-09-12,19984,12,2356,274,10,30,22666
2013-09-13,20840,9,2134,304,6,32,23325
2013-09-14,23997,10,1091,330,9,33,25470
2013-09-15,21506,13,395,305,6,30,22255
2013-09-16,18500,12,1736,281,6,31,20566
2013-09-17,18935,14,2267,305,4,28,21553
2013-09-18,18473,13,2074,250,12,30,20852
2013-09-19,21283,11,2067,230,17,33,23641
2013-09-20,21422,13,2285,289,8,35,24052
2013-09-21,22944,12,1362,361,12,31,24722
2013-09-22,20861,14,380,372,5,29,21661
2013-09-23,19577,10,1771,255,6,32,21651
2013-09-24,16420,23,2091,256,8,30,18828
2013-09-25,16989,15,2255,280,12,30,19581
2013-09-26,20284,12,2333,351,13,31,23024
2013-09-27,21288,13,2136,277,14,33,23761
2013-09-28,21694,12,1161,296,12,32,23207
2013-09-29,19643,16,467,337,4,30,20497
2013-09-30,17853,12,1439,213,4,29,19550
2013-10-01,18047,13,2146,276,4,26,20512
2013-10-02,18742,10,2340,229,7,8,21336
2013-10-03,18830,9,2452,261,7,55,21614
2013-10-04,20408,11,2281,255,11,30,22996
2013-10-05,21768,16,1184,338,6,32,23344
2013-10-06,18850,12,350,377,2,29,19620
2013-10-07,20132,13,1865,326,4,27,22367
2013-10-08,28268,15,1667,320,1,27,30298
2013-10-09,18232,13,2007,251,11,28,20542
2013-10-10,18593,11,2168,247,10,27,21056
2013-10-11,24310,12,2772,289,7,28,27418
2013-10-12,22458,13,1376,328,5,27,24207
2013-10-13,19150,12,366,378,8,30,19944
2013-10-14,18348,13,1753,238,8,25,20385
2013-10-15,17627,13,2254,242,4,25,20165
2013-10-16,18678,10,1942,240,7,26,20903
2013-10-17,19168,13,2047,258,9,27,21522
2013-10-18,20165,13,2260,219,6,26,22689
2013-10-19,21286,12,1343,286,4,27,22958
2013-10-20,18880,13,367,353,1,27,19641
2013-10-21,17964,14,1762,213,3,22,19978
2013-10-22,17124,15,2397,194,5,24,19759
2013-10-23,16281,13,2172,195,5,25,18691
2013-10-24,18331,11,2383,211,9,24,20969
2013-10-25,20848,14,2434,205,4,26,23531
2013-10-26,21582,12,1237,235,2,25,23093
2013-10-27,19735,17,348,279,2,21,20402
2013-10-28,17767,11,2127,199,6,23,20133
2013-10-29,18236,16,2169,183,4,16,20624
2013-10-30,21032,13,2331,150,6,22,23554
2013-10-31,23086,12,1956,176,7,21,25258
2013-11-01,26669,15,771,205,8,21,27689
2013-11-02,25536,17,928,165,11,15,26672
2013-11-03,24978,12,335,175,1,21,25522
2013-11-04,18504,12,1961,161,1,22,20661
2013-11-05,17308,13,2012,148,3,15,19499
2013-11-06,17180,11,2375,149,2,23,19740
2013-11-07,17919,16,2428,145,2,23,20533
2013-11-08,19665,11,2703,186,2,23,22590
2013-11-09,20162,13,1477,193,4,15,21864
2013-11-10,17712,13,313,190,1,21,18250
2013-11-11,16821,11,1615,127,1,21,18596
2013-11-12,17413,13,2142,140,4,15,19727
2013-11-13,16909,11,2031,126,5,21,19103
2013-11-14,18210,15,2173,131,7,16,20552
2013-11-15,20334,11,2165,137,3,22,22672
2013-11-16,21227,13,1347,214,6,18,22825
2013-11-17,17270,12,317,204,4,21,17828
2013-11-18,17001,12,2095,140,8,19,19275
2013-11-19,17757,15,2587,137,4,17,20517
2013-11-20,16579,10,2225,128,5,3,18950
2013-11-21,17652,11,2326,128,3,19,20139
2013-11-22,19956,11,2587,141,5,14,22714
2013-11-23,20533,14,1240,181,6,16,21990
2013-11-24,17642,15,331,211,12,19,18230
2013-11-25,17377,13,1855,150,4,23,19422
2013-11-26,16989,14,2298,118,6,15,19440
2013-11-27,15439,15,2133,118,5,21,17731
2013-11-28,17432,11,2232,137,6,21,19839
2013-11-29,19679,11,2510,123,9,23,22355
2013-11-30,19714,16,1266,201,5,14,21216
2013-12-01,15736,13,299,195,0,20,16263
2013-12-02,17021,15,1843,133,1,23,19036
2013-12-03,16827,17,2108,127,7,17,19103
2013-12-04,16255,11,2115,107,1,22,18511
2013-12-05,18218,16,2155,114,5,20,20528
2013-12-06,18719,13,2574,137,5,21,21469
2013-12-07,18544,12,989,254,2,15,19816
2013-12-08,16055,16,318,246,2,20,16657
2013-12-09,16793,11,1730,122,2,23,18681
2013-12-10,16854,13,2246,115,4,15,19247
2013-12-11,17916,19,2600,131,5,21,20692
2013-12-12,18129,11,2154,139,8,21,20462
2013-12-13,18420,14,2266,154,2,20,20876
2013-12-14,21365,13,1207,353,1,15,22954
2013-12-15,17177,16,336,271,2,20,17822
2013-12-16,16844,16,1764,132,2,21,18779
2013-12-17,16907,18,2250,95,3,2,19275
2013-12-18,18230,10,2362,92,1,20,20715
2013-12-19,20450,15,2166,145,5,18,22799
2013-12-20,21531,16,2407,176,3,19,24152
2013-12-21,24579,17,1407,305,3,15,26326
2013-12-22,18068,13,376,215,0,19,18691
2013-12-23,21029,19,1556,150,2,21,22777
2013-12-24,18212,17,899,106,2,9,19245
2013-12-25,11043,12,140,41,2,0,11238
2013-12-26,18228,12,242,90,0,14,18586
2013-12-27,20552,12,962,132,1,23,21682
2013-12-28,19456,13,676,139,5,17,20306
2013-12-29,15846,12,272,137,2,19,16288
2013-12-30,21508,16,999,217,0,22,22762
2013-12-31,15587,17,572,117,2,9,16304
2014-01-01,10978,8,108,181,1,12,11288
2014-01-02,18375,15,592,192,3,20,19197
2014-01-03,18633,14,1116,145,2,23,19933
2014-01-04,19092,13,602,153,2,16,19878
2014-01-05,16403,11,185,147,0,20,16766
2014-01-06,19249,12,449,153,0,23,19886
2014-01-07,15695,14,1260,109,3,15,17096
2014-01-08,16950,13,1602,119,3,20,18707
2014-01-09,16705,17,1582,115,2,19,18440
2014-01-10,19617,14,1918,137,0,21,21707
2014-01-11,27141,17,1051,194,2,17,28422
2014-01-12,18033,13,301,236,2,21,18606
2014-01-13,15585,20,1542,108,3,21,17279
2014-01-14,16277,15,1603,108,2,16,18021
2014-01-15,16625,17,2061,104,3,20,18830
2014-01-16,17507,17,1935,121,2,21,19603
2014-01-17,17603,13,2034,123,0,23,19796
2014-01-18,20221,11,998,163,1,14,21408
2014-01-19,15418,15,230,128,0,21,15812
2014-01-20,16631,13,1424,118,2,23,18211
2014-01-21,16497,16,1989,108,1,16,18627
2014-01-22,16463,14,1834,106,4,21,18442
2014-01-23,17060,14,2165,103,4,21,19367
2014-01-24,16978,14,1923,139,2,24,19080
2014-01-25,14654,12,1132,169,1,15,15983
2014-01-26,12932,14,248,125,3,23,13345
2014-01-27,15137,16,1666,115,1,23,16958
2014-01-28,13402,15,1716,121,2,15,15271
2014-01-29,13461,15,1771,104,3,26,15380
2014-01-30,14781,13,1801,105,0,18,16718
2014-01-31,16998,15,2016,121,3,23,19176
2014-02-01,16963,12,1076,156,0,15,18222
2014-02-02,12066,11,258,130,2,20,12487
2014-02-03,15225,9,1308,126,0,22,16690
2014-02-04,14370,12,1831,115,1,15,16344
2014-02-05,15384,16,1708,128,7,21,17264
2014-02-06,15503,11,2005,113,2,20,17654
2014-02-07,17647,13,1984,115,0,22,19781
2014-02-08,18070,15,1022,133,2,14,19256
2014-02-09,15025,10,254,158,3,20,15470
2014-02-10,16392,14,1495,123,1,23,18048
2014-02-11,16100,16,1801,119,3,14,18053
2014-02-12,17101,16,1846,112,3,18,19096
2014-02-13,17393,15,1889,133,3,20,19453
2014-02-14,19745,14,2093,135,1,22,22010
2014-02-15,21446,14,1060,171,6,14,22711
2014-02-16,17781,12,267,182,0,21,18263
2014-02-17,16255,17,1361,136,1,22,17792
2014-02-18,15947,11,1971,136,5,13,18083
2014-02-19,16860,14,1820,133,0,22,18849
2014-02-20,17850,17,2246,129,4,19,20265
2014-02-21,19839,14,2145,146,2,19,22165
2014-02-22,20662,15,1071,198,4,15,21965
2014-02-23,16549,12,329,197,0,22,17109
2014-02-24,16851,18,1687,127,3,23,18709
2014-02-25,15449,14,2019,114,3,14,17613
2014-02-26,15926,16,2136,116,5,21,18220
2014-02-27,17171,16,2089,121,3,22,19422
2014-02-28,19951,12,2269,152,3,22,22409
2014-03-01,20420,14,1190,248,1,15,21888
2014-03-02,16624,12,259,219,0,21,17135
2014-03-03,17840,13,1779,151,3,22,19808
2014-03-04,15395,16,2077,134,1,15,17638
2014-03-05,16095,15,1974,128,2,21,18235
2014-03-06,18684,13,2215,155,2,20,21089
2014-03-07,20267,16,2191,138,4,24,22640
2014-03-08,21757,14,1153,229,1,15,23169
2014-03-09,18808,16,270,187,0,21,19302
2014-03-10,16679,17,1845,149,0,24,18714
2014-03-11,16834,19,2157,137,3,15,19165
2014-03-12,16992,14,2018,128,4,23,19179
2014-03-13,17565,15,2474,121,2,2,20179
2014-03-14,20052,11,2409,150,1,24,22647
2014-03-15,22730,16,1053,196,2,15,24012
2014-03-16,19715,16,307,206,2,19,20265
2014-03-17,17991,12,1667,132,1,23,19826
2014-03-18,17205,14,2442,166,3,17,19847
2014-03-19,18724,14,2043,140,3,22,20946
2014-03-20,18481,16,2303,138,7,23,20968
2014-03-21,20164,16,2586,163,3,26,22958
2014-03-22,21231,14,1331,203,5,16,22800
2014-03-23,18626,14,360,231,0,24,19255
2014-03-24,17880,17,1872,141,0,23,19933
2014-03-25,17478,18,2222,142,3,16,19879
2014-03-26,17224,18,2450,147,3,22,19864
2014-03-27,17026,16,2434,149,2,19,19646
2014-03-28,21280,16,2717,161,2,21,24197
2014-03-29,20335,12,1168,223,3,15,21756
2014-03-30,18854,15,343,216,1,23,19452
2014-03-31,17726,17,1970,148,2,24,19887
2014-04-01,17588,17,2645,152,7,22,20431
2014-04-02,17126,15,2249,140,5,24,19559
2014-04-03,18069,16,2403,182,6,22,20698
2014-04-04,19417,15,2492,160,2,24,22110
2014-04-05,20580,14,1170,307,4,20,22095
2014-04-06,18535,16,377,299,1,24,19252
2014-04-07,18390,14,2084,187,1,23,20699
2014-04-08,17727,22,2288,164,10,24,20235
2014-04-09,19348,14,2486,187,3,24,22062
2014-04-10,18768,20,2452,172,5,22,21439
2014-04-11,22012,20,2907,205,5,24,25173
2014-04-12,25422,18,1479,279,3,21,27222
2014-04-13,20960,13,353,317,14,23,21680
2014-04-14,18934,13,1910,210,3,26,21096
2014-04-15,21314,21,2499,208,9,22,24073
2014-04-16,23642,20,2548,225,3,8,26446
2014-04-17,25459,12,3016,287,7,26,28807
2014-04-18,23541,9,1941,264,11,28,25794
2014-04-19,23652,23,854,207,5,22,24763
2014-04-20,14570,15,131,107,2,26,14851
2014-04-21,25481,18,297,238,4,26,26064
2014-04-22,20639,20,1598,207,2,23,22489
2014-04-23,20018,17,2357,207,6,26,22631
2014-04-24,22466,20,2340,207,6,24,25063
2014-04-25,22135,19,2734,207,7,27,25129
2014-04-26,24625,20,1146,672,4,23,26490
2014-04-27,19548,19,359,715,2,26,20669
2014-04-28,20460,18,2176,337,3,28,23022
2014-04-29,20528,20,2693,224,5,21,23491
2014-04-30,24600,19,2488,270,7,27,27411
2014-05-01,18196,27,493,255,23,29,19023
2014-05-02,21178,20,1091,238,11,29,22567
2014-05-03,22051,20,941,305,2,31,23350
2014-05-04,24499,16,344,403,1,24,25287
2014-05-05,18796,18,1482,244,5,29,20574
2014-05-06,19118,15,1923,218,7,26,21307
2014-05-07,19287,16,2298,271,5,30,21907
2014-05-08,21128,16,2235,245,4,10,23638
2014-05-09,22041,21,2481,309,5,29,24886
2014-05-10,22739,20,1644,311,6,31,24751
2014-05-11,19861,17,348,354,4,30,20614
2014-05-12,18958,18,1829,214,3,11,21033
2014-05-13,19529,19,2459,258,5,30,22300
2014-05-14,19770,20,1965,223,5,29,22012
2014-05-15,18931,15,2577,306,3,29,21861
2014-05-16,20148,15,2333,254,6,32,22788
2014-05-17,21222,13,1224,512,5,18,22994
2014-05-18,16018,17,331,340,4,32,16742
2014-05-19,17056,17,2099,295,4,29,19500
2014-05-20,16051,18,2023,293,6,29,18420
2014-05-21,16658,14,2220,267,10,28,19197
2014-05-22,17620,22,2422,293,10,26,20393
2014-05-23,20391,21,2553,351,13,29,23358
2014-05-24,20666,15,1219,360,5,33,22298
2014-05-25,18835,18,392,326,2,33,19606
2014-05-26,18335,15,1977,284,3,29,20643
2014-05-27,18237,20,2437,264,5,29,20992
2014-05-28,18189,16,2235,281,12,32,20765
2014-05-29,17771,18,2154,290,12,30,20275
2014-05-30,21563,15,2484,287,9,33,24391
2014-05-31,22272,16,1367,370,6,29,24060
2014-06-01,19317,19,362,364,1,31,20094
2014-06-02,18994,15,1798,275,2,30,21114
2014-06-03,18146,17,2072,281,7,11,20534
2014-06-04,18486,19,2538,284,9,29,21365
2014-06-05,19773,21,2478,276,17,29,22594
2014-06-06,24396,20,2579,331,15,32,27373
2014-06-07,22423,17,1372,347,4,32,24195
2014-06-08,21619,18,582,383,5,31,22638
2014-06-09,19558,21,1444,289,4,31,21347
2014-06-10,18301,22,2231,284,5,39,20882
2014-06-11,18517,16,2141,238,12,31,20955
2014-06-12,19541,16,2496,318,14,30,22415
2014-06-13,18848,20,2506,296,9,29,21708
2014-06-14,21490,19,1517,360,5,34,23425
2014-06-15,20770,13,350,314,4,30,21481
2014-06-16,20463,16,2091,348,5,31,22954
2014-06-17,18864,23,2187,342,5,30,21451
2014-06-18,22034,16,2388,318,9,31,24796
2014-06-19,25347,18,1300,287,15,31,26998
2014-06-20,21631,18,2190,326,10,33,24208
2014-06-21,21484,17,1371,375,9,33,23289
2014-06-22,21739,16,392,354,6,33,22540
2014-06-23,19954,20,1760,281,5,30,22050
2014-06-24,20313,24,2703,329,6,33,23408
2014-06-25,23448,16,1186,352,9,32,25043
2014-06-26,22098,17,2863,487,9,31,25505
2014-06-27,22080,18,2463,292,12,36,24901
2014-06-28,23009,19,1262,367,9,35,24701
2014-06-29,23025,17,456,349,5,30,23882
2014-06-30,21142,18,2099,294,5,30,23588
2014-07-01,20151,19,2213,291,7,31,22712
2014-07-02,18544,22,2489,284,9,11,21359
2014-07-03,21822,21,2420,325,4,29,24621
2014-07-04,21536,24,2617,310,17,32,24536
2014-07-05,25390,18,1447,398,6,34,27293
2014-07-06,23663,20,413,287,4,31,24418
2014-07-07,22316,18,1990,338,7,30,24699
2014-07-08,22404,20,2353,271,9,33,25090
2014-07-09,21361,18,2283,300,10,32,24004
2014-07-10,22587,18,2439,318,7,32,25401
2014-07-11,23228,18,2714,310,8,32,26310
2014-07-12,26594,17,1185,322,7,33,28158
2014-07-13,22253,22,412,296,6,35,23024
2014-07-14,21830,21,1954,264,8,30,24107
2014-07-15,22938,19,2486,328,8,34,25813
2014-07-16,22494,22,2645,389,9,31,25590
2014-07-17,23733,22,2343,300,8,37,26443
2014-07-18,25252,21,2714,252,19,32,28290
2014-07-19,27653,18,1278,332,8,33,29322
2014-07-20,25129,18,370,299,8,35,25859
2014-07-21,24210,19,2064,272,8,35,26608
2014-07-22,20208,23,2468,259,6,32,22996
2014-07-23,22204,19,2511,277,15,31,25057
2014-07-24,23467,22,2406,261,9,29,26194
2014-07-25,24491,21,2373,295,15,33,27228
2014-07-26,25201,19,1404,278,8,33,26943
2014-07-27,23188,18,405,228,24,33,23896
2014-07-28,23138,16,1855,288,5,30,25332
2014-07-29,23293,23,2077,277,11,31,25712
2014-07-30,22318,21,2101,242,15,30,24727
2014-07-31,24033,26,2561,322,6,34,26982
2014-08-01,25482,25,2596,271,9,37,28420
2014-08-02,29376,18,1101,340,13,35,30883
2014-08-03,23622,17,545,325,9,31,24549
2014-08-04,24674,21,1751,246,7,29,26728
2014-08-05,26589,21,1623,310,9,33,28585
2014-08-06,23819,21,1971,275,11,31,26128
2014-08-07,21738,21,2215,280,13,35,24302
2014-08-08,24991,17,2402,281,17,28,27736
2014-08-09,25866,17,906,301,9,36,27135
2014-08-10,25306,14,408,320,7,33,26088
2014-08-11,24820,21,1938,268,6,31,27084
2014-08-12,23538,23,1989,284,17,32,25883
2014-08-13,22764,20,2152,254,11,31,25232
2014-08-14,26031,20,2133,313,14,33,28544
2014-08-15,25793,17,857,275,9,28,26979
2014-08-16,29632,16,1068,351,15,32,31114
2014-08-17,26041,18,411,319,9,34,26832
2014-08-18,24636,22,1798,350,4,32,26842
2014-08-19,22511,21,2213,253,13,31,25042
2014-08-20,22118,22,1820,256,14,30,24260
2014-08-21,24331,18,2385,277,20,34,27065
2014-08-22,23194,22,2063,300,10,32,25621
2014-08-23,25542,17,1339,304,8,32,27242
2014-08-24,22736,21,443,283,5,30,23518
2014-08-25,22017,17,2011,285,7,31,24368
2014-08-26,19945,24,2038,254,15,31,22307
2014-08-27,20639,22,2134,244,10,31,23080
2014-08-28,21666,17,2363,229,16,31,24322
2014-08-29,22487,20,2246,294,18,31,25096
2014-08-30,23154,19,1056,312,9,38,24588
2014-08-31,22383,15,426,290,6,31,23151
2014-09-01,21307,10,1888,241,6,30,23482
2014-09-02,22024,18,2161,329,5,31,24568
2014-09-03,21891,21,2146,240,12,29,24339
2014-09-04,21155,17,2359,284,7,32,23854
2014-09-05,23345,17,2541,272,14,31,26220
2014-09-06,26409,18,1220,345,6,30,28028
2014-09-07,22717,18,278,290,7,38,23348
2014-09-08,21055,14,2093,303,5,31,23501
2014-09-09,19579,23,2284,267,6,36,22195
2014-09-10,20820,16,2250,303,12,32,23433
2014-09-11,21796,17,2340,273,9,31,24466
2014-09-12,21796,22,2442,306,14,34,24614
2014-09-13,24670,11,1227,367,3,33,26311
2014-09-14,21813,15,361,353,2,28,22572
2014-09-15,21282,20,1759,280,4,33,23378
2014-09-16,19450,18,2444,343,9,32,22296
2014-09-17,19355,14,2337,280,13,31,22030
2014-09-18,20984,18,2494,318,10,33,23857
2014-09-19,22963,18,2582,293,9,30,25895
2014-09-20,25010,16,1462,368,7,30,26893
2014-09-21,20672,19,419,383,4,30,21527
2014-09-22,20934,16,1923,338,10,31,23252
2014-09-23,19562,23,2241,261,3,28,22118
2014-09-24,21194,21,2598,335,17,30,24195
2014-09-25,20601,16,2534,292,10,29,23482
2014-09-26,21932,18,2745,325,10,30,25060
2014-09-27,25088,20,1728,351,6,33,27226
2014-09-28,21963,14,373,379,14,30,22773
2014-09-29,19743,16,2079,275,4,30,22147
2014-09-30,19188,20,2445,270,8,30,21961
2014-10-01,20233,17,2299,249,11,29,22838
2014-10-02,22278,20,2612,248,15,30,25203
2014-10-03,22715,23,2514,306,5,30,25593
2014-10-04,23682,15,1220,314,2,31,25264
2014-10-05,22487,14,409,418,2,31,23361
2014-10-06,20282,21,2354,246,3,28,22934
2014-10-07,19133,12,2382,270,4,32,21833
2014-10-08,27768,13,1582,333,8,27,29731
2014-10-09,20530,23,2210,257,8,29,23057
2014-10-10,23036,18,2675,304,8,27,26068
2014-10-11,24656,15,1303,366,4,27,26371
2014-10-12,23755,20,494,445,11,30,24755
2014-10-13,19818,18,1836,250,5,22,21949
2014-10-14,19586,21,2166,227,5,27,22032
2014-10-15,20623,15,2803,276,7,28,23752
2014-10-16,20753,15,2182,256,4,29,23239
2014-10-17,22677,21,2280,244,3,29,25254
2014-10-18,25289,15,1524,327,3,26,27184
2014-10-19,21850,17,460,393,4,26,22750
2014-10-20,19657,15,1799,273,2,25,21771
2014-10-21,19292,23,2457,239,6,24,22041
2014-10-22,19437,21,2549,267,3,27,22304
2014-10-23,18879,18,1763,251,2,24,20937
2014-10-24,20908,19,2326,199,2,26,23480
2014-10-25,23124,22,1432,303,3,22,24906
2014-10-26,21218,15,428,371,1,23,22056
2014-10-27,19362,18,1916,223,1,23,21543
2014-10-28,18780,16,2094,213,3,17,21123
2014-10-29,20361,14,2229,204,7,22,22837
2014-10-30,21445,20,2695,205,5,22,24392
2014-10-31,21760,21,1831,208,10,24,23854
2014-11-01,28543,21,708,154,4,17,29447
2014-11-02,26683,17,393,171,2,20,27286
2014-11-03,21138,18,2136,177,7,23,23499
2014-11-04,18791,19,2562,163,2,19,21556
2014-11-05,18291,18,2269,173,0,22,20773
2014-11-06,20136,20,2186,192,1,21,22556
2014-11-07,22545,20,2837,198,1,25,25626
2014-11-08,22581,20,1421,235,3,15,24275
2014-11-09,20762,15,385,263,1,20,21446
2014-11-10,19352,20,1965,178,3,24,21542
2014-11-11,18742,20,2395,178,2,18,21355
2014-11-12,18854,19,2457,153,1,25,21509
2014-11-13,18279,18,2556,131,3,20,21007
2014-11-14,21122,20,2182,156,6,23,23509
2014-11-15,23480,17,1542,245,4,17,25305
2014-11-16,19652,18,421,220,4,19,20334
2014-11-17,18818,15,1883,197,2,24,20939
2014-11-18,18328,17,2132,156,1,18,20652
2014-11-19,19101,20,2411,179,6,22,21739
2014-11-20,19643,14,2458,175,4,22,22316
2014-11-21,21688,18,2370,166,5,21,24268
2014-11-22,22296,17,1290,218,6,17,23844
2014-11-23,18781,9,374,218,4,20,19406
2014-11-24,18563,15,2186,163,5,21,20953
2014-11-25,17863,24,2486,146,5,18,20542
2014-11-26,18598,17,2265,194,3,22,21099
2014-11-27,18818,14,2783,185,7,21,21828
2014-11-28,21098,24,2891,192,6,21,24232
2014-11-29,19939,18,1422,234,4,16,21633
2014-11-30,17801,19,317,238,4,20,18399
2014-12-01,17925,16,2063,151,5,22,20182
2014-12-02,17758,21,2464,164,6,18,20431
2014-12-03,18236,21,2316,152,4,19,20748
2014-12-04,18712,18,2198,165,4,22,21119
2014-12-05,20878,17,2446,170,6,24,23541
2014-12-06,19379,22,1548,308,8,17,21282
2014-12-07,17498,15,395,273,3,21,18205
2014-12-08,17965,17,1657,165,5,22,19831
2014-12-09,17585,21,2574,141,5,3,20329
2014-12-10,18465,19,2686,138,3,3,21314
2014-12-11,18981,20,2640,137,3,21,21802
2014-12-12,19923,24,2440,185,7,21,22600
2014-12-13,22549,19,1639,413,3,16,24639
2014-12-14,18550,22,426,384,3,17,19402
2014-12-15,19634,21,2388,163,5,19,22230
2014-12-16,18581,22,2229,145,4,17,20998
2014-12-17,20003,21,2691,129,5,21,22870
2014-12-18,20870,19,2556,169,2,20,23636
2014-12-19,23424,21,2691,169,7,23,26335
2014-12-20,22549,23,1336,344,6,17,24275
2014-12-21,20269,18,462,285,3,20,21057
2014-12-22,23293,20,2142,179,4,23,25661
2014-12-23,23682,21,2344,161,5,19,26232
2014-12-24,19057,21,1139,133,2,14,20366
2014-12-25,12783,8,189,59,0,0,13039
2014-12-26,19317,13,358,117,1,17,19823
2014-12-27,23901,22,604,129,6,13,24675
2014-12-28,11737,16,203,132,2,19,12109
2014-12-29,15982,19,1038,194,5,22,17260
2014-12-30,19836,19,1302,199,4,22,21382
2014-12-31,14248,21,669,134,1,15,15088
2015-01-01,9767,7,121,136,0,10,10041
2015-01-02,17642,17,610,253,1,25,18548
2015-01-03,17237,23,413,161,3,18,17855
2015-01-04,15558,14,248,154,0,21,15995
2015-01-05,17512,13,763,144,0,24,18456
2015-01-06,18995,19,626,144,1,19,19804
2015-01-07,16162,16,1127,111,0,21,17437
2015-01-08,17312,19,1400,133,1,21,18886
2015-01-09,19614,24,1664,137,0,16,21455
2015-01-10,28133,23,1107,225,4,14,29506
2015-01-11,18385,12,309,210,1,20,18937
2015-01-12,15055,17,1756,139,2,18,16987
2015-01-13,17108,18,1855,128,5,19,19133
2015-01-14,15765,22,1835,149,0,24,17795
2015-01-15,17567,19,1810,125,2,22,19545
2015-01-16,18323,15,2044,133,1,21,20537
2015-01-17,20791,15,981,152,1,17,21957
2015-01-18,17484,17,329,164,2,16,18012
2015-01-19,17046,16,1787,156,1,22,19028
2015-01-20,16470,10,1905,119,3,20,18527
2015-01-21,16199,21,1930,115,2,21,18288
2015-01-22,17032,12,2268,122,0,23,19457
2015-01-23,18266,16,2127,160,0,18,20587
2015-01-24,18615,10,1122,194,1,20,19962
2015-01-25,14914,20,315,130,0,21,15400
2015-01-26,16033,12,1659,135,1,23,17863
2015-01-27,15978,15,2086,142,4,19,18244
2015-01-28,15642,10,2107,137,2,19,17917
2015-01-29,15651,21,2059,143,0,23,17897
2015-01-30,16874,20,2265,148,0,21,19328
2015-01-31,18576,14,1080,172,2,16,19860
2015-02-01,14314,13,429,163,0,20,14939
2015-02-02,15993,12,1653,137,1,23,17819
2015-02-03,16539,15,2040,137,3,20,18754
2015-02-04,14673,17,2016,132,0,19,16857
2015-02-05,14985,16,1832,126,3,21,16983
2015-02-06,11490,17,1043,123,1,23,12697
2015-02-07,14597,17,1137,148,2,17,15918
2015-02-08,14024,8,375,164,3,21,14595
2015-02-09,15019,12,1740,145,1,21,16938
2015-02-10,14604,22,1861,116,3,22,16628
2015-02-11,16519,20,2110,150,2,22,18823
2015-02-12,17993,17,2190,139,0,22,20361
2015-02-13,19619,21,2203,162,1,23,22029
2015-02-14,20747,18,1234,205,4,15,22223
2015-02-15,18643,17,446,236,1,21,19364
2015-02-16,17374,19,1923,139,0,22,19477
2015-02-17,16989,21,2059,121,3,18,19211
2015-02-18,16135,21,2178,125,2,21,18482
2015-02-19,18106,22,2325,154,1,22,20630
2015-02-20,19715,19,2401,148,4,20,22307
2015-02-21,20499,19,1237,190,2,16,21963
2015-02-22,16321,13,398,324,0,20,17076
2015-02-23,17326,20,1916,144,1,24,19431
2015-02-24,16563,14,2216,138,6,16,18953
2015-02-25,17280,19,2378,138,3,21,19839
2015-02-26,17007,16,2515,132,2,21,19693
2015-02-27,19892,19,2576,157,3,22,22669
2015-02-28,20503,21,1321,186,4,14,22049
2015-03-01,18089,18,498,182,0,19,18806
2015-03-02,17190,15,1971,119,4,23,19322
2015-03-03,17240,15,2454,150,4,18,19881
2015-03-04,16829,12,2488,151,4,20,19504
2015-03-05,16410,17,2196,142,1,22,18788
2015-03-06,17787,23,2204,146,0,21,20181
2015-03-07,21052,19,1215,258,0,17,22561
2015-03-08,17963,15,326,255,1,21,18581
2015-03-09,17774,10,2200,170,1,22,20177
2015-03-10,17720,14,2380,156,3,16,20289
2015-03-11,17596,11,2509,155,6,23,20300
2015-03-12,18846,18,2493,175,0,21,21553
2015-03-13,20346,20,2601,159,6,23,23155
2015-03-14,24051,21,1348,250,5,15,25690
2015-03-15,20379,13,536,217,1,21,21167
2015-03-16,17922,14,2192,165,0,22,20315
2015-03-17,17917,14,2540,163,3,17,20654
2015-03-18,18016,9,2263,161,2,21,20472
2015-03-19,20644,21,2613,157,4,19,23458
2015-03-20,20288,17,2557,172,2,22,23058
2015-03-21,22275,16,1286,251,2,17,23847
2015-03-22,18861,16,410,216,0,22,19525
2015-03-23,18824,15,2357,182,5,23,21406
2015-03-24,17326,14,2441,192,4,19,19996
2015-03-25,18752,15,2572,156,2,20,21517
2015-03-26,19932,17,2600,163,1,21,22734
2015-03-27,21509,18,2521,194,4,20,24266
2015-03-28,24018,18,1440,258,3,16,25753
2015-03-29,19763,10,461,293,2,25,20554
2015-03-30,21058,14,2227,203,4,23,23529
2015-03-31,20650,16,2788,193,16,21,23684
2015-04-01,22701,12,2794,206,6,24,25743
2015-04-02,25246,16,2772,228,3,25,28290
2015-04-03,28122,17,1966,180,9,23,30317
2015-04-04,21863,15,833,217,1,11,22940
2015-04-05,15466,13,133,143,1,24,15780
2015-04-06,35721,9,460,207,0,25,36422
2015-04-07,22119,19,2115,201,2,20,24476
2015-04-08,19403,15,2462,223,5,22,22130
2015-04-09,18759,16,2700,177,4,22,21678
2015-04-10,22227,14,2410,230,6,23,24910
2015-04-11,22660,15,1339,216,2,24,24256
2015-04-12,19132,13,337,301,2,25,19810
2015-04-13,17846,15,1962,204,2,21,20050
2015-04-14,19353,16,2566,203,3,22,22163
2015-04-15,18941,16,2414,202,4,24,21601
2015-04-16,20497,17,2891,211,5,26,23647
2015-04-17,22023,15,2789,270,4,21,25122
2015-04-18,23904,17,1410,313,1,20,25665
2015-04-19,21937,16,456,293,14,23,22739
2015-04-20,19443,17,2516,260,2,25,22263
2015-04-21,18672,15,2633,198,2,23,21543
2015-04-22,19598,16,2688,237,3,27,22569
2015-04-23,20363,11,2660,234,6,26,23300
2015-04-24,22812,17,3103,286,8,19,26245
2015-04-25,25152,20,1459,365,1,24,27021
2015-04-26,22751,6,469,348,2,25,23601
2015-04-27,19059,17,1654,238,3,29,21000
2015-04-28,20477,18,2474,228,2,30,23229
2015-04-29,20333,19,2799,278,2,28,23459
2015-04-30,27079,19,2996,297,9,29,30429
2015-05-01,18869,17,636,321,5,29,19877
2015-05-02,25522,18,1043,311,5,31,26930
2015-05-03,24699,16,618,460,2,29,25824
2015-05-04,20589,18,1962,278,5,30,22882
2015-05-05,18170,25,2300,241,4,29,20769
2015-05-06,20977,19,2606,272,5,30,23909
2015-05-07,21271,19,2624,271,12,18,24215
2015-05-08,22785,14,2519,280,9,36,25643
2015-05-09,24739,18,1384,303,2,30,26476
2015-05-10,21396,14,521,311,4,31,22277
2015-05-11,20721,13,2378,286,9,30,23437
2015-05-12,19821,8,2522,283,5,31,22670
2015-05-13,21830,18,2489,296,5,30,24668
2015-05-14,23307,20,2523,254,8,30,26142
2015-05-15,23947,18,2788,325,6,31,27115
2015-05-16,27020,22,1388,628,3,30,29091
2015-05-17,21191,15,469,301,1,33,22010
2015-05-18,20112,18,1963,301,2,31,22427
2015-05-19,19482,19,2734,281,4,23,22543
2015-05-20,19029,16,2475,303,5,31,21859
2015-05-21,20181,15,2107,252,6,29,22590
2015-05-22,24364,10,2684,310,1,29,27398
2015-05-23,24129,23,1411,361,5,34,25963
2015-05-24,20592,18,533,421,3,35,21602
2015-05-25,21967,11,1691,316,2,29,24016
2015-05-26,19307,15,2493,302,6,29,22152
2015-05-27,19327,18,2477,337,7,28,22194
2015-05-28,20174,11,2872,326,5,29,23417
2015-05-29,22728,15,2558,307,14,32,25654
2015-05-30,23021,16,1383,341,6,37,24804
2015-05-31,21675,12,477,289,2,30,22485
2015-06-01,20053,18,2112,315,5,31,22534
2015-06-02,19238,16,2257,285,6,30,21832
2015-06-03,21138,11,2376,343,8,30,23906
2015-06-04,25664,16,1543,300,4,33,27560
2015-06-05,22437,14,2484,328,9,31,25303
2015-06-06,22509,12,1346,583,4,30,24484
2015-06-07,22270,11,531,430,5,33,23280
2015-06-08,20248,18,2253,318,2,30,22869
2015-06-09,19774,19,2731,295,5,34,22858
2015-06-10,20361,14,2433,308,12,30,23158
2015-06-11,21420,10,2588,281,9,33,24341
2015-06-12,23575,20,2655,296,5,31,26582
2015-06-13,26479,17,1270,383,4,34,28187
2015-06-14,25005,15,533,300,5,31,25889
2015-06-15,21869,4,2428,289,4,30,24624
2015-06-16,20493,14,2769,280,5,32,23593
2015-06-17,21425,14,2627,343,8,27,24444
2015-06-18,19577,14,2495,281,13,31,22411
2015-06-19,24470,11,3083,368,10,31,27973
2015-06-20,25800,17,1658,355,3,32,27865
2015-06-21,20661,16,444,341,5,34,21501
2015-06-22,27900,12,1493,365,9,34,29813
2015-06-23,19953,13,2415,327,5,31,22744
2015-06-24,23999,17,2761,310,10,30,27127
2015-06-25,26218,15,1662,351,5,33,28284
2015-06-26,22716,19,2322,295,10,37,25399
2015-06-27,24647,22,1403,329,4,32,26437
2015-06-28,28551,12,571,363,5,30,29532
2015-06-29,21554,14,2047,280,6,29,23930
2015-06-30,20121,18,2541,287,2,32,23001
2015-07-01,21514,18,2690,289,15,30,24556
2015-07-02,21392,17,2645,263,3,32,24352
2015-07-03,23017,16,2927,269,11,39,26279
2015-07-04,22198,15,1337,274,5,34,23863
2015-07-05,23364,12,428,286,9,30,24129
2015-07-06,21554,15,2242,295,5,27,24138
2015-07-07,19740,19,2264,289,11,35,22358
2015-07-08,20263,15,2023,271,10,28,22610
2015-07-09,24331,15,2229,295,8,33,26911
2015-07-10,26321,17,3164,265,10,33,29810
2015-07-11,25560,18,1391,309,4,22,27304
2015-07-12,23844,18,423,257,10,48,24600
2015-07-13,22581,18,2029,236,6,33,24903
2015-07-14,21980,18,2446,277,11,33,24765
2015-07-15,23680,13,2189,253,8,31,26174
2015-07-16,23972,12,2580,278,9,34,26885
2015-07-17,25167,17,2657,245,12,29,28127
2015-07-18,27873,17,1292,297,7,32,29518
2015-07-19,24210,16,722,306,6,29,25289
2015-07-20,24244,15,1893,257,7,32,26448
2015-07-21,23151,21,2317,258,6,30,25783
2015-07-22,21319,18,2256,261,6,34,23894
2015-07-23,20532,16,2208,269,10,25,23060
2015-07-24,23049,9,2458,262,7,34,25819
2015-07-25,29172,18,1287,307,10,34,30828
2015-07-26,23360,19,425,315,6,33,24158
2015-07-27,22316,12,1828,270,4,39,24469
2015-07-28,20770,20,2383,279,5,29,23486
2015-07-29,20642,18,2176,257,11,27,23131
2015-07-30,23629,21,2416,289,10,30,26395
2015-07-31,23873,16,2275,272,7,34,26477
2015-08-01,28664,17,1349,297,8,32,30367
2015-08-02,25091,6,414,292,4,33,25840
2015-08-03,24518,18,1839,228,6,27,26636
2015-08-04,22607,18,2187,257,8,31,25108
2015-08-05,26600,15,1609,256,6,33,28519
2015-08-06,23108,19,2066,263,7,32,25495
2015-08-07,24695,15,2339,286,11,37,27383
2015-08-08,29444,16,1481,431,14,33,31419
2015-08-09,24516,17,429,278,9,31,25280
2015-08-10,26181,18,2158,255,10,31,28653
2015-08-11,21996,15,1824,300,9,32,24176
2015-08-12,22722,10,2123,268,7,31,25161
2015-08-13,24903,20,2038,252,10,31,27254
2015-08-14,25501,19,2391,254,14,31,28210
2015-08-15,28771,18,995,356,8,32,30180
2015-08-16,27167,15,495,258,7,32,27974
2015-08-17,24682,18,1900,268,10,30,26908
2015-08-18,23391,20,2229,300,7,34,25981
2015-08-19,22066,15,1921,218,8,33,24261
2015-08-20,21882,19,2040,274,12,31,24258
2015-08-21,23911,18,2459,234,10,31,26663
2015-08-22,25549,19,1111,374,12,33,27098
2015-08-23,22038,18,437,297,6,31,22827
2015-08-24,21456,18,2046,242,7,32,23801
2015-08-25,20299,19,2084,276,11,31,22720
2015-08-26,21928,18,2437,246,16,33,24678
2015-08-27,21845,18,2059,261,13,33,24229
2015-08-28,21837,16,2335,248,12,31,24479
2015-08-29,24301,16,1389,265,7,32,26010
2015-08-30,23910,14,529,283,4,30,24770
2015-08-31,20721,15,2044,268,6,35,23089
2015-09-01,20578,19,2244,268,4,32,23145
2015-09-02,20423,15,2481,239,11,32,23201
2015-09-03,21795,23,2707,256,12,31,24824
2015-09-04,22754,22,2691,253,14,29,25763
2015-09-05,23843,18,1369,288,2,36,25556
2015-09-06,22039,14,468,279,5,32,22837
2015-09-07,21773,19,2323,249,12,31,24407
2015-09-08,20987,22,2524,292,11,33,23869
2015-09-09,21909,17,2638,299,9,31,24903
2015-09-10,22717,17,2461,269,15,32,25511
2015-09-11,23565,21,3475,291,14,33,27399
2015-09-12,26092,18,1413,295,5,39,27862
2015-09-13,24082,10,463,317,6,30,24908
2015-09-14,20581,12,2228,296,3,30,23150
2015-09-15,22000,17,2481,296,7,34,24835
2015-09-16,20311,12,2398,260,11,25,23017
2015-09-17,20618,16,2543,254,12,32,23475
2015-09-18,21279,12,2887,254,8,27,24467
2015-09-19,23561,8,1452,330,7,39,25397
2015-09-20,21653,9,494,313,12,33,22514
2015-09-21,19815,7,2184,276,5,34,22321
2015-09-22,18459,6,2250,257,8,27,21007
2015-09-23,18907,8,2360,317,10,32,21634
2015-09-24,20044,11,2040,270,12,30,22407
2015-09-25,20813,9,2459,305,14,33,23633
2015-09-26,23315,9,1389,321,7,38,25079
2015-09-27,23324,12,448,402,3,21,24210
2015-09-28,19812,9,2034,261,3,28,22147
2015-09-29,18879,15,2651,239,5,30,21819
2015-09-30,19307,9,2563,302,9,28,22218
2015-10-01,20749,5,2221,282,10,29,23296
2015-10-02,21771,9,2627,272,7,30,24716
2015-10-03,22874,8,1367,311,5,30,24595
2015-10-04,20862,4,480,305,1,30,21682
2015-10-05,19559,14,2037,289,3,28,21930
2015-10-06,17870,15,2510,241,6,26,20668
2015-10-07,20183,10,2532,247,6,29,23007
2015-10-08,27931,10,2061,255,2,30,30289
2015-10-09,22424,11,2740,278,10,27,25490
2015-10-10,22443,16,1431,337,7,29,24263
2015-10-11,21690,10,471,357,9,29,22566
2015-10-12,20313,12,1840,238,8,105,22516
2015-10-13,18460,16,2336,219,15,26,21072
2015-10-14,18830,16,2389,224,5,30,21494
2015-10-15,21163,14,2579,210,6,23,23995
2015-10-16,20951,8,2700,264,6,27,23956
2015-10-17,24269,15,1405,287,6,23,26005
2015-10-18,19569,6,463,292,0,27,20357
2015-10-19,18580,11,2069,253,5,25,20943
2015-10-20,18621,9,2481,206,5,23,21345
2015-10-21,18797,8,2082,233,3,25,21148
2015-10-22,20973,10,3103,261,5,23,24375
2015-10-23,22418,10,2362,245,3,23,25061
2015-10-24,22738,11,1380,239,3,20,24391
2015-10-25,21972,11,596,290,1,21,22891
2015-10-26,18122,11,2102,174,2,24,20435
2015-10-27,18278,11,2584,180,6,17,21076
2015-10-28,19636,9,2742,195,6,21,22609
2015-10-29,20776,11,2622,177,12,21,23619
2015-10-30,22622,11,2955,195,32,25,25840
2015-10-31,27059,15,1267,196,5,14,28556
2015-11-01,29054,13,536,148,0,18,29769
2015-11-02,22505,16,1929,159,1,19,24629
2015-11-03,19999,11,2170,165,6,17,22368
2015-11-04,18469,15,2293,148,1,21,20947
2015-11-05,19665,12,2607,153,3,21,22461
2015-11-06,21885,15,2600,188,3,21,24712
2015-11-07,23910,15,1479,180,3,14,25601
2015-11-08,21035,16,531,157,0,20,21759
2015-11-09,18643,10,2312,170,0,23,21158
2015-11-10,19379,15,2376,144,1,15,21930
2015-11-11,19748,13,2553,158,6,20,22498
2015-11-12,19050,15,2380,139,3,21,21608
2015-11-13,20447,8,2520,156,3,24,23158
2015-11-14,22267,15,1257,189,4,16,23748
2015-11-15,21616,12,436,192,2,20,22278
2015-11-16,18401,15,1990,136,2,22,20566
2015-11-17,19874,12,2529,152,3,18,22588
2015-11-18,18085,14,2600,206,5,24,20934
2015-11-19,20356,14,2613,161,4,20,23168
2015-11-20,21974,12,2908,130,5,24,25053
2015-11-21,21331,17,1501,189,2,16,23056
2015-11-22,18144,14,483,197,0,19,18857
2015-11-23,19467,15,2193,171,4,23,21873
2015-11-24,17566,16,2586,123,3,18,20312
2015-11-25,18667,14,2737,133,2,24,21577
2015-11-26,19528,15,2555,168,1,20,22287
2015-11-27,20461,9,2647,156,3,23,23299
2015-11-28,20344,18,1370,224,5,17,21978
2015-11-29,17810,15,490,197,2,23,18537
2015-11-30,18270,15,1962,143,4,24,20418
2015-12-01,18864,15,2330,123,4,18,21354
2015-12-02,19067,16,2056,142,2,22,21305
2015-12-03,19669,13,2343,119,4,20,22168
2015-12-04,21489,14,2511,140,2,20,24176
2015-12-05,22909,18,1396,282,5,13,24623
2015-12-06,18279,11,462,294,1,19,19066
2015-12-07,17989,13,2004,150,1,21,20178
2015-12-08,18295,11,2055,126,5,17,20509
2015-12-09,18404,12,2464,130,4,23,21037
2015-12-10,19293,12,2528,134,3,20,21990
2015-12-11,20468,14,2571,158,3,20,23234
2015-12-12,23015,14,1517,362,4,13,24925
2015-12-13,19142,17,400,342,0,20,19921
2015-12-14,18840,14,2057,138,4,24,21077
2015-12-15,19075,21,2395,136,6,16,21649
2015-12-16,20313,17,2509,118,4,22,22983
2015-12-17,20686,19,2536,137,3,18,23399
2015-12-18,21805,13,2564,159,8,24,24573
2015-12-19,26010,20,1530,310,6,14,27890
2015-12-20,18617,18,462,297,3,19,19416
2015-12-21,22607,13,2179,149,4,18,24970
2015-12-22,23384,15,2593,149,5,16,26162
2015-12-23,23812,12,2521,161,1,20,26527
2015-12-24,20865,21,1021,126,1,12,22046
2015-12-25,13722,4,274,74,0,0,14074
2015-12-26,20187,13,251,98,1,14,20564
2015-12-27,20737,8,351,137,1,16,21250
2015-12-28,19974,15,1253,128,3,20,21393
2015-12-29,20279,16,1392,151,4,17,21859
2015-12-30,24215,17,1340,195,4,21,25792
2015-12-31,16922,16,544,123,6,13,17624
2016-01-01,11287,11,137,85,1,9,11530
2016-01-02,20422,11,317,231,0,17,20998
2016-01-03,13944,16,259,185,0,23,14427
2016-01-04,14652,15,976,118,0,23,15784
2016-01-05,15879,17,1193,128,2,17,17236
2016-01-06,14810,11,830,142,1,24,15818
2016-01-07,15552,12,1231,142,0,19,16956
2016-01-08,18531,17,1445,129,2,21,20145
2016-01-09,22970,20,812,225,2,12,24041
2016-01-10,18361,14,344,169,1,21,18910
2016-01-11,18508,18,1474,150,0,22,20172
2016-01-12,16765,17,1984,129,3,17,18915
2016-01-13,17314,20,2007,130,1,16,19488
2016-01-14,16996,16,2095,123,0,21,19251
2016-01-15,19290,15,2212,148,1,22,21688
2016-01-16,20985,11,1317,160,1,14,22488
2016-01-17,15929,11,307,239,0,22,16508
2016-01-18,16559,18,1800,119,1,21,18518
2016-01-19,17075,16,2121,127,3,18,19360
2016-01-20,17348,14,2150,130,7,21,19670
2016-01-21,18771,17,2337,138,1,17,21281
2016-01-22,18986,15,2404,139,1,22,21567
2016-01-23,20679,17,1378,168,1,15,22258
2016-01-24,17407,11,387,146,2,21,17974
2016-01-25,16906,19,2024,145,3,21,19118
2016-01-26,15631,16,2029,120,1,16,17813
2016-01-27,16839,14,2482,128,1,23,19487
2016-01-28,18272,17,2543,135,2,20,20989
2016-01-29,19552,17,2546,142,4,22,22283
2016-01-30,20281,18,1149,190,1,14,21653
2016-01-31,17074,11,437,161,1,17,17701
2016-02-01,17254,21,1997,132,1,21,19426
2016-02-02,17529,16,2099,120,2,16,19782
2016-02-03,16516,14,2007,123,1,18,18679
2016-02-04,18711,15,2542,119,2,22,21411
2016-02-05,20177,17,2483,166,4,21,22868
2016-02-06,22510,17,1374,175,2,18,24096
2016-02-07,18494,13,345,206,2,20,19080
2016-02-08,18340,17,1695,149,0,21,20222
2016-02-09,17436,8,2353,134,1,14,19946
2016-02-10,17780,15,2255,144,0,21,20215
2016-02-11,20078,13,2577,140,1,19,22828
2016-02-12,20846,15,2562,133,0,21,23577
2016-02-13,21934,19,1314,162,2,14,23445
2016-02-14,18883,16,328,188,0,19,19434
2016-02-15,19811,15,1964,130,0,23,21943
2016-02-16,18640,15,2109,132,2,18,20916
2016-02-17,17806,12,2321,142,1,20,20302
2016-02-18,19447,19,2703,145,2,17,22333
2016-02-19,21701,17,2860,142,1,24,24745
2016-02-20,22953,17,1343,184,3,16,24516
2016-02-21,19269,15,488,175,1,17,19965
2016-02-22,18835,21,1936,139,1,22,20954
2016-02-23,18361,17,2383,136,4,17,20918
2016-02-24,18781,18,2560,127,3,22,21511
2016-02-25,19026,19,2576,130,3,18,21772
2016-02-26,20859,18,2666,171,5,20,23739
2016-02-27,22445,23,1213,156,5,14,23856
2016-02-28,18516,26,438,176,0,20,19176
2016-02-29,18153,16,1855,138,3,20,20185
2016-03-01,18129,19,2256,136,2,18,20560
2016-03-02,19266,16,2319,135,3,20,21759
2016-03-03,19067,16,2676,148,2,19,21928
2016-03-04,19531,13,2562,140,4,22,22272
2016-03-05,22620,19,1591,228,3,17,24478
2016-03-06,18485,9,348,202,0,21,19065
2016-03-07,19274,14,2125,129,3,23,21568
2016-03-08,18098,15,2546,132,6,20,20817
2016-03-09,18659,20,2737,151,2,21,21590
2016-03-10,21315,26,2626,158,1,22,24148
2016-03-11,22212,19,3004,173,3,24,25435
2016-03-12,24394,16,1567,201,2,15,26195
2016-03-13,19011,15,369,226,0,18,19639
2016-03-14,19119,18,2215,163,1,24,21540
2016-03-15,19673,19,2298,159,8,17,22174
2016-03-16,18849,17,2566,138,2,23,21595
2016-03-17,20344,20,2739,166,5,21,23295
2016-03-18,22984,16,2734,159,8,24,25925
2016-03-19,25544,17,1283,184,2,16,27046
2016-03-20,21225,11,495,211,4,21,21967
2016-03-21,20858,18,2245,163,3,23,23310
2016-03-22,22099,17,2611,152,11,17,24907
2016-03-23,23120,15,3009,167,1,18,26330
2016-03-24,24832,18,2759,194,10,19,27832
2016-03-25,24361,15,2083,206,5,23,26693
2016-03-26,22393,19,735,152,4,16,23319
2016-03-27,15841,10,256,106,3,22,16238
2016-03-28,25740,11,526,182,2,21,26482
2016-03-29,20243,19,1657,180,5,21,22125
2016-03-30,19365,19,2218,181,5,25,21813
2016-03-31,20166,15,2604,160,4,22,22971
2016-04-01,22730,17,2629,190,10,19,25595
2016-04-02,22291,16,1500,188,3,21,24019
2016-04-03,20685,16,389,229,4,23,21346
2016-04-04,19729,11,2184,155,6,22,22107
2016-04-05,19254,19,2594,195,12,20,22094
2016-04-06,17918,14,2580,154,7,25,20698
2016-04-07,20248,18,2797,172,7,20,23262
2016-04-08,22539,16,2695,171,8,24,25453
2016-04-09,23235,19,1533,250,10,20,25067
2016-04-10,19102,17,424,229,5,24,19801
2016-04-11,20599,14,2293,214,6,24,23150
2016-04-12,19620,14,2787,176,2,23,22622
2016-04-13,19960,24,2861,168,8,23,23044
2016-04-14,21473,22,3062,190,6,25,24778
2016-04-15,24723,16,3119,194,6,27,28085
2016-04-16,25320,16,1560,786,5,23,27710
2016-04-17,21874,9,454,269,0,22,22628
2016-04-18,20372,21,2535,176,2,23,23129
2016-04-19,2585,0,334,5,2,1,2927
2016-04-20,16015,8,2215,135,2,6,18381
2016-04-21,18142,16,2268,168,6,23,20623
2016-04-22,23048,24,3084,189,10,26,26381
2016-04-23,23313,22,1257,243,6,6,24847
2016-04-24,20729,16,486,226,4,23,21484
2016-04-25,21703,20,2545,221,7,23,24519
2016-04-26,20365,22,2881,214,5,25,23512
2016-04-27,21757,16,2080,254,3,19,24129
2016-04-28,22193,14,2886,240,13,28,25374
2016-04-29,24241,21,3085,223,8,26,27604
2016-04-30,23623,18,1425,313,14,29,25422
2016-05-01,20244,14,441,261,6,30,20996
2016-05-02,19259,19,1347,194,4,32,20855
2016-05-03,21548,18,2386,212,7,27,24198
2016-05-04,21840,21,2500,249,6,31,24647
2016-05-05,24521,23,2705,227,9,25,27510
2016-05-06,23171,16,2974,238,11,30,26440
2016-05-07,24251,17,1625,284,4,31,26212
2016-05-08,21248,20,498,275,4,29,22074
2016-05-09,20690,16,2414,228,7,29,23384
2016-05-10,21809,13,2506,221,3,27,24579
2016-05-11,21848,22,2536,222,6,29,24663
2016-05-12,21644,23,2583,242,7,26,24525
2016-05-13,23710,21,2966,367,7,27,27098
2016-05-14,27443,16,1630,498,3,31,29621
2016-05-15,23800,14,545,383,1,32,24775
2016-05-16,22057,30,1964,276,3,28,24358
2016-05-17,19765,23,2463,288,5,28,22572
2016-05-18,21304,16,2701,210,4,31,24266
2016-05-19,23101,22,3175,238,8,30,26574
2016-05-20,24334,23,2999,273,3,31,27663
2016-05-21,23710,15,1555,315,4,30,25629
2016-05-22,22807,20,539,277,4,34,23681
2016-05-23,21629,20,2429,258,0,30,24366
2016-05-24,20521,21,2801,263,4,33,23643
2016-05-25,22961,15,2845,291,7,34,26153
2016-05-26,26888,22,1663,254,9,31,28867
2016-05-27,23925,20,2827,272,6,32,27082
2016-05-28,25036,20,1394,325,9,39,26823
2016-05-29,24269,11,419,382,1,31,25113
2016-05-30,21674,17,2141,242,5,33,24112
2016-05-31,19824,18,2551,252,7,29,22681
2016-06-01,21410,22,2708,216,6,34,24396
2016-06-02,22731,18,2604,251,10,35,25649
2016-06-03,24381,13,3097,280,7,32,27810
2016-06-04,25415,16,1372,293,4,31,27131
2016-06-05,20794,17,454,304,6,32,21607
2016-06-06,22118,16,2101,241,6,35,24517
2016-06-07,19715,24,3004,270,11,18,23042
2016-06-08,20033,17,2860,239,13,31,23193
2016-06-09,22409,23,2926,233,5,32,25628
2016-06-10,25567,16,3069,266,14,24,28956
2016-06-11,24972,16,1509,288,5,33,26823
2016-06-12,20466,16,459,281,6,26,21254
2016-06-13,22110,27,2498,302,3,16,24956
2016-06-14,20165,22,2307,267,6,33,22800
2016-06-15,22264,16,2646,243,10,34,25213
2016-06-16,22930,18,2830,245,6,33,26062
2016-06-17,22472,24,2980,272,7,31,25786
2016-06-18,25602,11,1279,336,6,36,27270
2016-06-19,22607,18,533,301,6,33,23498
2016-06-20,21851,21,2182,299,9,32,24394
2016-06-21,19336,24,2419,286,10,29,22104
2016-06-22,25762,12,1809,296,10,39,27928
2016-06-23,22639,15,2463,323,11,37,25488
2016-06-24,26131,21,2831,330,16,28,29357
2016-06-25,26608,13,1036,318,7,35,28017
2016-06-26,23744,13,459,298,6,34,24554
2016-06-27,22370,22,1983,246,4,33,24658
2016-06-28,22229,23,2273,260,10,29,24824
2016-06-29,20950,20,2811,250,14,36,24081
2016-06-30,22199,24,2566,309,14,33,25145
2016-07-01,25205,18,2553,291,10,36,28113
2016-07-02,25165,16,1411,301,9,32,26934
2016-07-03,23730,18,528,334,7,32,24649
2016-07-04,23831,20,2287,268,11,34,26451
2016-07-05,21329,17,2399,299,10,35,24089
2016-07-06,21542,21,2411,260,12,30,24276
2016-07-07,23464,23,2591,269,16,33,26396
2016-07-08,26635,26,3074,279,18,28,30060
2016-07-09,26275,13,1206,273,20,36,27823
2016-07-10,23614,19,488,287,8,26,24442
2016-07-11,24012,19,2244,213,5,34,26527
2016-07-12,21588,21,2428,249,8,34,24328
2016-07-13,22036,15,2238,248,15,32,24584
2016-07-14,24446,22,2775,264,9,30,27546
2016-07-15,26514,23,2724,243,9,31,29544
2016-07-16,28487,18,1374,251,9,35,30174
2016-07-17,25090,14,662,267,7,31,26071
2016-07-18,23392,16,2123,244,9,25,25809
2016-07-19,22047,22,2207,236,11,32,24555
2016-07-20,23583,16,2207,241,13,28,26088
2016-07-21,27549,20,2713,298,9,32,30621
2016-07-22,26610,21,2627,262,10,29,29559
2016-07-23,27358,20,956,251,13,34,28632
2016-07-24,24508,21,516,284,7,37,25373
2016-07-25,25757,19,2216,246,11,37,28286
2016-07-26,22526,21,2475,274,9,34,25339
2016-07-27,21972,18,2382,201,8,36,24617
2016-07-28,25415,23,2619,264,15,31,28367
2016-07-29,25353,24,2293,257,10,33,27970
2016-07-30,27940,18,1435,345,9,31,29778
2016-07-31,25415,21,495,283,13,38,26265
2016-08-01,26843,22,1878,283,12,32,29070
2016-08-02,24361,26,2297,277,11,30,27002
2016-08-03,23595,21,2283,240,11,38,26188
2016-08-04,23702,29,2478,245,17,35,26506
2016-08-05,28110,20,1832,260,14,35,30271
2016-08-06,27445,20,1186,271,13,33,28968
2016-08-07,29744,13,579,300,5,38,30679
2016-08-08,24854,21,2232,231,11,30,27379
2016-08-09,24271,24,2184,276,14,36,26805
2016-08-10,25548,21,2161,273,12,31,28046
2016-08-11,28940,23,2228,327,14,32,31564
2016-08-12,27845,27,2632,267,81,34,30886
2016-08-13,28333,26,982,315,12,40,29708
2016-08-14,28367,19,430,303,5,39,29163
2016-08-15,29973,17,600,238,9,31,30868
2016-08-16,28206,24,2460,253,10,28,30981
2016-08-17,24528,18,1953,260,11,36,26806
2016-08-18,25524,24,2146,262,21,34,28011
2016-08-19,25817,24,2424,260,11,29,28565
2016-08-20,27390,17,1202,387,10,36,29042
2016-08-21,23936,19,424,285,6,35,24705
2016-08-22,24791,17,1866,247,7,32,26960
2016-08-23,23739,20,2477,270,4,29,26539
2016-08-24,21855,25,2325,234,12,34,24485
2016-08-25,22562,22,2136,276,16,25,25037
2016-08-26,24808,19,2359,254,15,34,27489
2016-08-27,25630,19,1257,329,10,35,27280
2016-08-28,24956,22,474,268,9,39,25768
2016-08-29,22752,19,2138,276,8,37,25230
2016-08-30,21703,22,2088,285,9,32,24139
2016-08-31,21295,16,2282,284,9,35,23921
2016-09-01,23784,18,2354,236,11,35,26438
2016-09-02,24766,25,2856,281,10,36,27974
2016-09-03,28519,20,1522,355,5,37,30458
2016-09-04,23551,11,501,297,6,31,24397
2016-09-05,23231,22,1986,274,6,31,25550
2016-09-06,22129,18,2552,319,6,32,25056
2016-09-07,22133,20,2679,316,8,33,25189
2016-09-08,23880,16,2876,284,16,32,27104
2016-09-09,23233,22,2408,273,15,34,25985
2016-09-10,27022,17,1585,366,8,35,29033
2016-09-11,24472,15,528,296,4,33,25348
2016-09-12,22022,18,2052,302,6,31,24431
2016-09-13,20476,20,2080,263,9,33,22881
2016-09-14,22656,22,2603,297,8,25,25611
2016-09-15,24145,19,2635,304,16,33,27152
2016-09-16,24990,20,2681,290,13,31,28025
2016-09-17,26695,15,1348,318,7,35,28418
2016-09-18,23745,18,453,363,4,34,24617
2016-09-19,23695,23,1955,303,4,30,26010
2016-09-20,21695,26,2344,317,8,29,24419
2016-09-21,21823,22,2696,288,4,21,24854
2016-09-22,23185,25,2591,282,12,28,26123
2016-09-23,23246,25,2157,268,8,34,25738
2016-09-24,27048,23,1789,340,6,34,29240
2016-09-25,22609,26,453,325,6,24,23443
2016-09-26,21169,19,2314,286,5,32,23825
2016-09-27,21200,24,2489,236,9,30,23988
2016-09-28,20886,13,2927,235,27,33,24121
2016-09-29,22426,25,2537,253,18,29,25288
2016-09-30,25072,18,2992,294,12,33,28421
2016-10-01,25949,19,1431,296,5,30,27730
2016-10-02,23875,16,498,339,4,34,24766
2016-10-03,22700,24,2639,290,4,33,25690
2016-10-04,21078,15,2414,286,3,34,23830
2016-10-05,21005,22,2524,240,8,31,23830
2016-10-06,20155,14,2461,244,16,28,22918
2016-10-07,24720,19,2895,318,9,29,27990
2016-10-08,27551,17,1355,345,7,33,29308
2016-10-09,24138,19,527,362,10,31,25087
2016-10-10,21188,18,2231,222,8,33,23700
2016-10-11,20252,20,2800,234,8,26,23340
2016-10-12,21450,20,2494,246,14,29,24253
2016-10-13,20809,26,2451,230,6,29,23551
2016-10-14,21759,15,2787,262,9,31,24863
2016-10-15,25694,24,1672,312,4,31,27737
2016-10-16,22956,21,600,357,1,32,23967
2016-10-17,20181,18,2389,235,4,26,22853
2016-10-18,18976,16,2376,214,8,24,21614
2016-10-19,19974,22,2610,244,4,27,22881
2016-10-20,21088,20,2213,245,4,26,23596
2016-10-21,23185,15,2680,259,9,29,26177
2016-10-22,24325,15,1462,262,6,30,26100
2016-10-23,21094,20,480,340,0,28,21962
2016-10-24,19785,20,2266,234,4,26,22335
2016-10-25,18354,21,2217,161,6,4,20763
2016-10-26,19316,21,2188,179,12,8,21724
2016-10-27,19804,22,2682,215,7,4,22734
2016-10-28,25617,24,2653,237,6,26,28563
2016-10-29,27427,22,1447,241,5,11,29153
2016-10-30,24859,19,528,219,1,1,25627
2016-10-31,25366,27,1184,155,2,22,26756
2016-11-01,28501,18,689,172,1,5,29386
2016-11-02,22501,24,2151,166,7,4,24853
2016-11-03,19623,19,2471,165,8,1,22287
2016-11-04,21220,24,2750,193,14,21,24222
2016-11-05,22070,20,1646,202,4,3,23945
2016-11-06,18651,19,406,180,1,2,19259
2016-11-07,17838,18,2181,167,6,8,20218
2016-11-08,18066,24,2544,182,5,7,20828
2016-11-09,18424,20,2438,190,3,5,21080
2016-11-10,19614,20,2804,159,4,0,22601
2016-11-11,19568,15,2254,183,2,3,22025
2016-11-12,20452,18,1359,187,2,18,22036
2016-11-13,18050,20,454,239,1,21,18785
2016-11-14,17721,125,1790,142,2,0,19780
2016-11-15,17870,17,2292,158,3,19,20359
2016-11-16,18089,25,2447,163,2,22,20748
2016-11-17,19155,24,2516,176,3,22,21896
2016-11-18,21661,18,2761,166,2,3,24611
2016-11-19,21865,21,1291,230,4,15,23426
2016-11-20,18681,20,447,221,0,19,19388
2016-11-21,18540,20,2051,189,3,21,20824
2016-11-22,17837,25,2930,159,3,21,20975
2016-11-23,17511,20,2377,157,6,22,20093
2016-11-24,19400,25,2379,153,3,22,21982
2016-11-25,19584,21,3022,171,3,21,22822
2016-11-26,20597,27,1547,204,6,15,22396
2016-11-27,18991,19,429,220,0,19,19678
2016-11-28,18929,17,2014,166,3,22,21151
2016-11-29,17480,24,2565,163,4,20,20256
2016-11-30,18135,19,2718,160,3,23,21058
2016-12-01,19103,21,2658,164,3,19,21968
2016-12-02,20243,22,2842,171,4,23,23305
2016-12-03,21878,20,1317,331,4,15,23565
2016-12-04,18254,17,453,244,1,20,18989
2016-12-05,18575,21,2163,158,2,18,20937
2016-12-06,18039,22,2365,145,3,21,20595
2016-12-07,17958,21,2453,160,2,20,20614
2016-12-08,19336,21,2494,164,3,23,22041
2016-12-09,19863,19,2662,165,2,21,22732
2016-12-10,21953,26,1695,435,10,16,24135
2016-12-11,19373,17,384,325,0,20,20119
2016-12-12,19133,19,2020,162,3,19,21356
2016-12-13,18369,21,2438,137,7,19,20991
2016-12-14,18832,20,2374,151,5,21,21403
2016-12-15,20012,19,2506,163,6,22,22728
2016-12-16,22058,20,2869,172,3,21,25143
2016-12-17,23869,21,1430,371,4,31,25726
2016-12-18,18920,20,597,352,2,23,19914
2016-12-19,19644,19,2000,168,1,20,21852
2016-12-20,19782,20,2439,150,4,21,22416
2016-12-21,21323,19,2575,158,1,18,24094
2016-12-22,23816,26,2997,174,1,21,27035
2016-12-23,27666,20,2543,199,3,23,30454
2016-12-24,20072,21,848,159,1,11,21112
2016-12-25,11957,12,133,57,0,0,12159
2016-12-26,21329,17,370,118,1,17,21852
2016-12-27,22432,23,1303,146,1,4,23909
2016-12-28,22537,20,1799,144,1,23,24524
2016-12-29,22787,20,1628,178,1,19,24633
2016-12-30,23982,20,1279,173,3,20,25477
2016-12-31,16911,18,413,131,1,11,17485
2017-01-01,13543,17,163,195,0,12,13930
2017-01-02,19783,23,748,197,1,19,20771
2017-01-03,18421,22,1203,153,0,21,19820
2017-01-04,20690,27,1402,161,1,20,22301
2017-01-05,19732,23,1754,131,1,18,21659
2017-01-06,16612,11,588,131,0,16,17358
2017-01-07,17344,24,594,150,1,17,18130
2017-01-08,17075,12,327,190,0,18,17622
2017-01-09,16637,21,1422,148,1,24,18253
2017-01-10,18185,15,1686,133,0,17,20036
2017-01-11,16853,24,1831,122,5,22,18857
2017-01-12,19553,16,2108,132,1,24,21834
2017-01-13,18065,20,2050,169,0,22,20326
2017-01-14,19204,18,1268,225,5,16,20736
2017-01-15,17736,27,423,139,0,19,18344
2017-01-16,17176,19,1843,157,0,19,19214
2017-01-17,12894,25,1699,128,0,22,14768
2017-01-18,13679,19,1780,130,0,23,15631
2017-01-19,16185,25,1960,127,2,22,18321
2017-01-20,18797,24,2237,149,0,21,21228
2017-01-21,20062,23,1212,178,1,16,21492
2017-01-22,16434,16,317,161,1,20,16949
2017-01-23,16958,20,1910,143,3,21,19055
2017-01-24,16031,21,2069,147,4,21,18293
2017-01-25,16727,28,2164,413,1,20,19353
2017-01-26,17115,23,2193,129,1,23,19484
2017-01-27,18769,25,2425,172,1,22,21414
2017-01-28,19456,17,1185,218,1,16,20893
2017-01-29,16863,19,446,166,0,21,17515
2017-01-30,16811,20,1816,138,1,23,18809
2017-01-31,16560,23,2211,144,0,22,18960
2017-02-01,16084,21,2182,126,3,24,18440
2017-02-02,18202,20,2477,146,1,19,20865
2017-02-03,19770,20,2142,145,0,20,22097
2017-02-04,21215,22,1204,167,1,15,22624
2017-02-05,17348,22,433,148,1,20,17972
2017-02-06,17504,27,1842,131,0,22,19526
2017-02-07,16861,23,2079,133,0,18,19114
2017-02-08,18068,21,1682,139,1,21,19932
2017-02-09,19196,21,2838,158,1,20,22234
2017-02-10,21279,21,2729,159,0,21,24209
2017-02-11,22678,23,1318,162,2,14,24197
2017-02-12,19364,21,574,204,1,20,20184
2017-02-13,19358,21,2048,172,2,23,21624
2017-02-14,18989,25,2342,131,1,19,21507
2017-02-15,19722,21,2246,146,3,20,22158
2017-02-16,20758,23,2114,150,0,19,23064
2017-02-17,21593,17,2698,159,1,19,24487
2017-02-18,23647,25,1438,181,3,14,25308
2017-02-19,19761,18,479,158,2,20,20438
2017-02-20,19819,28,1966,155,2,22,21992
2017-02-21,18634,18,2520,138,3,20,21333
2017-02-22,19142,25,2679,152,3,19,22020
2017-02-23,20151,23,2541,143,4,22,22884
2017-02-24,21620,16,2509,196,3,22,24366
2017-02-25,23146,21,1413,212,4,15,24811
2017-02-26,21318,21,473,201,1,19,22033
2017-02-27,19213,23,2192,140,4,20,21592
2017-02-28,19082,22,2574,138,1,21,21838
2017-03-01,19866,24,2537,161,2,21,22611
2017-03-02,20878,25,2764,150,3,20,23840
2017-03-03,22290,21,2858,160,6,22,25357
2017-03-04,24423,19,1431,198,3,13,26087
2017-03-05,20501,13,465,245,0,18,21242
2017-03-06,20476,24,2152,159,3,23,22837
2017-03-07,19257,18,2404,142,2,21,21844
2017-03-08,19887,21,2730,159,5,21,22823
2017-03-09,21174,20,2872,146,3,20,24235
2017-03-10,22881,22,2941,188,8,20,26060
2017-03-11,24929,12,1386,223,4,18,26572
2017-03-12,21211,13,498,219,0,21,21962
2017-03-13,19979,24,2359,171,4,20,22557
2017-03-14,18515,23,2882,157,5,22,21604
2017-03-15,20253,26,2345,163,4,22,22813
2017-03-16,22063,26,2969,148,5,23,25234
2017-03-17,23563,21,2946,166,2,20,26718
2017-03-18,25199,26,1619,201,3,19,27067
2017-03-19,22435,23,515,202,2,22,23199
2017-03-20,20642,20,2339,176,4,22,23203
2017-03-21,20125,22,2773,152,2,18,23092
2017-03-22,20202,25,2920,168,3,24,23342
2017-03-23,21058,23,2950,169,4,21,24225
2017-03-24,22174,16,2922,197,3,24,25336
2017-03-25,25303,19,1420,199,4,15,26960
2017-03-26,19860,24,540,197,0,3,20624
2017-03-27,19731,23,2264,161,4,40,22223
2017-03-28,18733,17,2732,162,5,19,21668
2017-03-29,20680,29,2940,187,8,7,23851
2017-03-30,21669,16,3255,171,4,5,25120
2017-03-31,23806,26,3247,184,7,10,27280
2017-04-01,26043,20,1824,263,9,19,28178
2017-04-02,22252,14,503,273,2,6,23050
2017-04-03,21042,19,2534,187,2,8,23792
2017-04-04,19677,22,2831,171,4,7,22712
2017-04-05,21271,23,2651,199,2,23,24169
2017-04-06,22150,24,2895,203,9,24,25305
2017-04-07,24689,22,3401,270,5,23,28410
2017-04-08,27731,22,1714,356,7,24,29854
2017-04-09,22318,19,583,413,0,21,23354
2017-04-10,22653,15,2520,265,7,22,25482
2017-04-11,22594,19,3039,238,9,21,25920
2017-04-12,25814,26,3274,276,6,23,29419
2017-04-13,27244,31,3282,242,10,24,30833
2017-04-14,29500,16,2430,279,7,26,32258
2017-04-15,22476,24,950,222,2,19,23693
2017-04-16,15938,23,207,174,1,9,16352
2017-04-17,25007,19,526,242,5,11,25810
2017-04-18,26229,11,2191,269,5,26,28731
2017-04-19,23437,14,2850,247,4,23,26575
2017-04-20,24650,29,2969,243,4,8,27903
2017-04-21,25846,22,3547,294,17,10,29736
2017-04-22,25918,20,1676,486,4,21,28125
2017-04-23,23248,20,666,436,14,9,24393
2017-04-24,23062,23,2453,294,8,25,25865
2017-04-25,21783,29,3097,329,5,22,25265
2017-04-26,22646,23,3423,290,8,23,26413
2017-04-27,22883,29,2463,304,6,24,25709
2017-04-28,26209,22,3584,337,8,20,30180
2017-04-29,26093,19,1833,407,6,25,28383
2017-04-30,23233,27,506,394,4,23,24187
2017-05-01,21743,6,610,396,3,28,22786
2017-05-02,21310,18,1411,302,2,9,23052
2017-05-03,22456,24,2953,304,11,27,25775
2017-05-04,22749,21,2503,322,14,7,25616
2017-05-05,25453,25,2956,321,15,10,28780
2017-05-06,25330,17,1538,306,3,17,27211
2017-05-07,21991,23,499,378,4,14,22909
2017-05-08,22742,25,2474,259,10,11,25521
2017-05-09,21624,24,2763,253,9,7,24680
2017-05-10,22629,22,2877,277,10,15,25830
2017-05-11,23772,24,3249,309,5,11,27370
2017-05-12,23383,21,3279,331,5,10,27029
2017-05-13,24535,21,1442,406,2,15,26421
2017-05-14,22930,19,501,332,1,16,23799
2017-05-15,22922,21,2493,307,3,17,25763
2017-05-16,21414,22,2964,324,6,7,24737
2017-05-17,22754,25,2888,298,12,10,25987
2017-05-18,22826,21,2703,331,10,32,25923
2017-05-19,24880,27,2857,356,6,35,28161
2017-05-20,26429,15,1514,445,6,20,28429
2017-05-21,23402,19,604,320,3,8,24356
2017-05-22,21946,21,2153,295,2,16,24433
2017-05-23,22657,25,2958,313,8,12,25973
2017-05-24,22514,19,2967,335,6,13,25854
2017-05-25,27317,26,3216,867,17,8,31451
2017-05-26,24332,24,3143,352,10,16,27877
2017-05-27,26123,18,1640,452,4,19,28256
2017-05-28,24287,25,580,411,6,18,25327
2017-05-29,22350,27,2901,314,3,13,25608
2017-05-30,21014,25,3089,336,6,9,24479
2017-05-31,21931,24,3251,321,10,17,25554
2017-06-01,23795,27,3157,358,6,7,27350
2017-06-02,27214,22,2827,372,9,15,30459
2017-06-03,26244,13,1350,405,8,17,28037
2017-06-04,26113,11,557,415,6,15,27117
2017-06-05,24344,27,2515,374,8,17,27285
2017-06-06,21802,28,2904,326,7,17,25084
2017-06-07,22714,29,2919,338,15,14,26029
2017-06-08,22630,23,3286,362,9,10,26320
2017-06-09,26014,24,3357,393,12,16,29816
2017-06-10,25919,19,1612,372,8,19,27949
2017-06-11,24314,20,591,365,6,9,25305
2017-06-12,23567,23,2750,411,12,16,26779
2017-06-13,23542,25,3300,356,12,11,27246
2017-06-14,24963,27,3142,382,22,15,28551
2017-06-15,31664,23,1961,358,16,12,34034
2017-06-16,26373,24,2816,443,16,12,29684
2017-06-17,28357,19,1515,412,7,8,30318
2017-06-18,25073,18,514,446,5,18,26074
2017-06-19,23712,26,2220,373,7,17,26355
2017-06-20,22180,26,2794,381,12,14,25407
2017-06-21,23456,21,3131,334,18,14,26974
2017-06-22,28783,14,2442,450,19,14,31722
2017-06-23,27414,24,2629,370,12,11,30460
2017-06-24,28743,21,1425,443,12,19,30663
2017-06-25,27168,27,658,442,5,12,28312
2017-06-26,23819,23,2426,335,9,16,26628
2017-06-27,22663,25,2994,338,10,13,26043
2017-06-28,22126,20,2761,359,12,11,25289
2017-06-29,23803,26,3222,316,11,14,27392
2017-06-30,25999,23,3199,361,8,17,29607
2017-07-01,27621,18,1504,377,5,18,29543
2017-07-02,25429,22,623,330,7,8,26419
2017-07-03,24970,24,2554,318,5,16,27887
2017-07-04,23296,21,2969,306,8,15,26615
2017-07-05,22642,26,2930,375,7,12,25992
2017-07-06,24951,15,2788,270,17,10,28051
2017-07-07,25695,27,3456,319,17,17,29531
2017-07-08,27376,16,1503,326,13,21,29255
2017-07-09,26201,21,595,286,8,7,27118
2017-07-10,25049,27,2603,284,13,18,27994
2017-07-11,23306,16,2732,307,7,12,26380
2017-07-12,24158,25,2948,308,15,14,27468
2017-07-13,25147,20,2733,321,9,11,28241
2017-07-14,26900,26,2850,296,8,21,30101
2017-07-15,27960,19,1421,297,10,7,29714
2017-07-16,25811,13,637,301,7,15,26784
2017-07-17,25320,21,2329,269,11,18,27968
2017-07-18,24092,22,2578,270,10,13,26985
2017-07-19,23988,23,2529,280,12,17,26849
2017-07-20,28184,24,3072,367,16,14,31677
2017-07-21,26833,22,2727,300,21,13,29916
2017-07-22,31149,29,1533,303,7,18,33039
2017-07-23,26879,20,439,263,7,20,27628
2017-07-24,24556,22,2059,280,14,33,26964
2017-07-25,22464,22,2200,219,15,11,24931
2017-07-26,24878,30,2675,281,9,16,27889
2017-07-27,25739,27,2254,261,16,16,28313
2017-07-28,26613,24,3032,251,11,20,29951
2017-07-29,27260,24,1388,283,12,17,28984
2017-07-30,26394,18,480,269,5,15,27181
2017-07-31,26076,22,1883,233,7,21,28242
2017-08-01,25977,24,2409,237,14,15,28676
2017-08-02,24519,25,2175,249,15,19,27002
2017-08-03,27416,28,2498,259,16,11,30228
2017-08-04,29797,26,2828,285,14,17,32967
2017-08-05,32832,17,1115,382,19,19,34384
2017-08-06,24596,19,398,241,14,7,25275
2017-08-07,28150,24,2291,255,6,20,30746
2017-08-08,25168,21,2423,273,13,14,27912
2017-08-09,26255,22,2314,263,14,13,28881
2017-08-10,24939,26,2050,251,23,9,27298
2017-08-11,25625,26,2338,231,13,18,28251
2017-08-12,30569,22,1208,313,7,24,32143
2017-08-13,27736,16,397,325,6,16,28496
2017-08-14,28706,28,1484,278,16,15,30527
2017-08-15,30074,22,1021,281,9,16,31423
2017-08-16,28607,26,2055,258,9,17,30972
2017-08-17,27742,25,2300,238,15,16,30336
2017-08-18,26208,25,1749,262,11,14,28269
2017-08-19,28794,26,1353,291,12,22,30498
2017-08-20,26682,20,447,264,4,13,27430
2017-08-21,27126,27,1874,263,5,17,29312
2017-08-22,23953,29,2413,253,10,12,26670
2017-08-23,23427,28,2412,243,14,17,26141
2017-08-24,23399,29,2567,215,23,15,26248
2017-08-25,26666,24,2620,230,14,19,29573
2017-08-26,26065,25,1260,310,9,19,27688
2017-08-27,24839,16,475,277,6,15,25628
2017-08-28,25147,29,2156,269,5,17,27623
2017-08-29,24108,28,2363,252,12,12,26775
2017-08-30,23550,27,2580,299,12,19,26487
2017-08-31,24196,27,2906,242,17,12,27400
2017-09-01,26073,22,2488,290,11,32,28916
2017-09-02,26907,29,1318,260,11,22,28547
2017-09-03,24070,20,439,279,2,16,24826
2017-09-04,23783,26,2116,274,8,19,26226
2017-09-05,22420,27,2463,257,8,9,25184
2017-09-06,22271,26,2607,236,11,17,25168
2017-09-07,24762,30,2894,299,23,13,28021
2017-09-08,25960,22,2949,265,20,16,29232
2017-09-09,29363,24,1111,285,10,15,30808
2017-09-10,24998,19,519,274,5,15,25830
2017-09-11,23633,27,2221,287,5,18,26191
2017-09-12,22980,27,3044,296,8,14,26369
2017-09-13,22681,28,2573,255,11,10,25558
2017-09-14,23417,26,2881,219,8,15,26566
2017-09-15,27154,23,2857,276,11,18,30339
2017-09-16,27101,25,1503,361,12,20,29022
2017-09-17,26587,21,582,367,4,7,27568
2017-09-18,23198,24,2138,246,9,18,25633
2017-09-19,23474,24,2500,271,5,14,26288
2017-09-20,23785,24,2934,330,14,14,27101
2017-09-21,25136,22,2925,262,15,13,28373
2017-09-22,25102,26,2843,265,13,19,28268
2017-09-23,27326,18,1447,305,16,16,29128
2017-09-24,24414,17,616,381,11,15,25454
2017-09-25,23016,30,2229,294,10,15,25594
2017-09-26,21720,27,2349,234,11,10,24351
2017-09-27,22350,24,2676,262,17,14,25343
2017-09-28,23495,28,3097,315,14,12,26961
2017-09-29,25642,28,2892,298,17,15,28892
2017-09-30,27723,24,1431,359,2,16,29555
2017-10-01,25626,22,660,381,7,15,26711
2017-10-02,22820,21,2334,300,11,14,25500
2017-10-03,22261,19,2785,275,4,13,25357
2017-10-04,22298,27,2568,236,14,10,25153
2017-10-05,23125,25,2831,252,17,8,26258
2017-10-06,24106,23,2826,388,14,14,27371
2017-10-07,27467,25,1585,367,7,14,29465
2017-10-08,25011,23,596,425,12,5,26072
2017-10-09,21843,23,2440,322,12,12,24652
2017-10-10,22381,28,2516,349,8,11,25293
2017-10-11,22475,25,2602,254,6,14,25376
2017-10-12,23228,28,2775,253,12,6,26302
2017-10-13,24687,21,2785,267,4,15,27779
2017-10-14,26300,29,1521,450,7,14,28321
2017-10-15,26515,18,597,390,9,14,27543
2017-10-16,21787,25,2081,293,6,11,24203
2017-10-17,21134,26,2660,254,10,9,24093
2017-10-18,21498,28,2555,268,9,11,24369
2017-10-19,22340,28,2819,276,8,10,25481
2017-10-20,25286,26,2911,277,7,13,28520
2017-10-21,26558,27,1637,316,10,16,28564
2017-10-22,23692,21,534,399,2,12,24660
2017-10-23,22678,27,2135,303,4,9,25156
2017-10-24,21173,27,2365,240,5,7,23817
2017-10-25,22469,33,2846,241,14,9,25612
2017-10-26,23273,25,2871,279,6,9,26463
2017-10-27,24987,25,3377,272,9,12,28682
2017-10-28,28206,22,1684,315,4,8,30239
2017-10-29,26630,18,490,301,4,7,27450
2017-10-30,23410,24,2289,233,3,7,25966
2017-10-31,25273,24,2317,220,3,6,27843
2017-11-01,28852,18,798,167,7,7,29849
2017-11-02,25719,26,2430,203,4,7,28389
2017-11-03,25736,24,3283,203,8,7,29261
2017-11-04,26281,22,1752,251,6,4,28316
2017-11-05,22762,22,429,260,2,7,23482
2017-11-06,20574,23,2293,212,2,7,23111
2017-11-07,21726,23,2978,211,2,6,24946
2017-11-08,21981,23,2639,161,7,6,24817
2017-11-09,21735,24,2785,161,4,6,24715
2017-11-10,24114,19,2966,214,5,7,27325
2017-11-11,26551,17,1855,201,9,3,28636
2017-11-12,21950,13,512,196,5,9,22685
2017-11-13,20877,24,2003,191,2,7,23104
2017-11-14,21343,22,2612,159,2,8,24146
2017-11-15,21596,25,2852,186,4,8,24671
2017-11-16,23477,27,2907,176,2,7,26596
2017-11-17,22817,22,3026,216,5,7,26093
2017-11-18,24250,28,1542,199,5,4,26028
2017-11-19,22357,16,591,273,3,7,23247
2017-11-20,21439,27,2426,186,2,7,24087
2017-11-21,20126,24,2405,132,2,6,22695
2017-11-22,21140,26,3016,162,3,6,24353
2017-11-23,22809,25,3159,151,6,8,26158
2017-11-24,24569,29,3026,203,4,10,27841
2017-11-25,22746,27,1690,234,2,3,24702
2017-11-26,20592,20,483,221,1,6,21323
2017-11-27,21670,24,2860,192,3,8,24757
2017-11-28,20878,27,3021,159,3,6,24094
2017-11-29,19769,26,3197,149,5,7,23153
2017-11-30,20969,30,2907,155,2,7,24070
2017-12-01,24057,23,3150,192,5,7,27434
2017-12-02,23232,20,1611,289,3,3,25158
2017-12-03,18720,20,461,275,4,7,19487
2017-12-04,21004,23,2179,158,2,8,23374
2017-12-05,20917,24,3068,150,4,8,24171
2017-12-06,20467,25,2565,144,4,5,23210
2017-12-07,22148,21,3208,158,2,6,25543
2017-12-08,24774,25,2383,196,3,7,27388
2017-12-09,20230,20,1395,339,4,3,21991
2017-12-10,18558,12,475,351,3,8,19407
2017-12-11,21452,21,2448,164,4,5,24094
2017-12-12,21280,24,2827,162,4,5,24302
2017-12-13,21810,28,2876,181,6,6,24907
2017-12-14,21574,23,3022,188,4,7,24818
2017-12-15,23788,25,3343,180,6,6,27348
2017-12-16,25445,17,1689,385,6,3,27545
2017-12-17,20994,13,491,351,4,6,21859
2017-12-18,22338,18,2612,177,4,9,25158
2017-12-19,23714,29,2987,150,5,6,26891
2017-12-20,24580,26,2902,161,8,7,27684
2017-12-21,27160,25,3094,183,4,8,30474
2017-12-22,27118,25,2603,180,4,8,29938
2017-12-23,29870,21,1263,245,3,3,31405
2017-12-24,17716,12,332,125,1,5,18191
2017-12-25,14784,13,192,75,0,0,15064
2017-12-26,23877,16,385,140,2,6,24426
2017-12-27,24887,22,1354,125,3,6,26397
2017-12-28,24928,27,1815,157,3,8,26938
2017-12-29,25181,21,1907,185,5,7,27306
2017-12-30,25434,16,812,207,4,4,26477
2017-12-31,15381,13,238,101,1,4,15738
2018-01-01,16679,15,209,205,0,6,17114
2018-01-02,22046,23,830,212,1,5,23117
2018-01-03,23446,27,1588,174,2,7,25244
2018-01-04,23258,26,1657,160,2,7,25110
2018-01-05,23652,18,1765,144,2,8,25589
2018-01-06,21136,22,763,182,2,3,22108
2018-01-07,21156,23,390,170,1,7,21747
2018-01-08,21100,21,2034,167,0,7,23329
2018-01-09,20424,27,2064,118,0,7,22640
2018-01-10,22358,27,2224,135,1,6,24751
2018-01-11,22605,23,2417,121,3,7,25176
2018-01-12,23307,20,2603,131,0,7,26068
2018-01-13,27044,28,1270,220,1,3,28566
2018-01-14,19858,28,364,211,1,8,20470
2018-01-15,16889,21,1781,139,3,7,18840
2018-01-16,18610,25,2173,136,0,5,20949
2018-01-17,19641,25,2571,151,2,7,22397
2018-01-18,19933,32,3005,132,1,7,23110
2018-01-19,21999,27,2865,147,2,7,25047
2018-01-20,23231,23,1525,198,1,3,24981
2018-01-21,19197,20,469,190,0,8,19884
2018-01-22,19520,28,2255,167,1,9,21980
2018-01-23,17705,25,2460,137,1,6,20334
2018-01-24,18215,24,2989,132,2,7,21369
2018-01-25,19784,28,2936,152,3,9,22912
2018-01-26,21443,28,3444,171,1,8,25095
2018-01-27,22336,24,1493,196,1,3,24053
2018-01-28,20268,24,477,194,0,8,20971
2018-01-29,18792,26,2330,151,1,7,21307
2018-01-30,19210,26,2839,146,1,6,22228
2018-01-31,19110,26,2573,134,4,8,21855
2018-02-01,20430,24,3274,148,0,8,23884
2018-02-02,21036,23,2553,160,1,7,23780
2018-02-03,17381,26,1304,223,2,3,18939
2018-02-04,17968,16,482,253,1,7,18727
2018-02-05,18038,24,2426,137,1,7,20633
2018-02-06,17880,23,2338,139,3,7,20390
2018-02-07,16218,32,2461,120,3,7,18841
2018-02-08,18490,28,2164,169,0,7,20858
2018-02-09,21627,29,2953,173,3,7,24792
2018-02-10,23007,25,1582,238,2,3,24857
2018-02-11,19979,21,634,267,1,8,20910
2018-02-12,18681,21,2240,196,2,7,21147
2018-02-13,16726,24,2294,138,0,7,19189
2018-02-14,19979,17,2735,143,3,8,22885
2018-02-15,19500,28,2243,147,1,5,21924
2018-02-16,21477,24,2395,184,3,8,24091
2018-02-17,24107,25,1506,214,3,4,25859
2018-02-18,19303,21,402,245,1,7,19979
2018-02-19,19666,18,2232,164,1,9,22090
2018-02-20,18052,26,2949,181,0,6,21214
2018-02-21,18706,26,2206,136,2,7,21083
2018-02-22,16717,27,2222,150,0,7,19123
2018-02-23,19309,19,2555,176,0,9,22068
2018-02-24,20417,24,1463,226,1,3,22134
2018-02-25,14715,22,382,203,0,7,15329
2018-02-26,14131,19,1949,161,1,7,16268
2018-02-27,10809,22,1451,140,1,5,12428
2018-02-28,15087,21,2068,155,1,7,17339
2018-03-01,14648,21,2471,140,1,7,17288
2018-03-02,17518,19,1951,171,4,7,19670
2018-03-03,18448,21,1430,208,1,3,20111
2018-03-04,16633,20,417,242,2,7,17321
2018-03-05,18454,27,2464,173,2,7,21127
2018-03-06,17964,22,2273,134,2,8,20403
2018-03-07,19001,24,2053,158,5,7,21248
2018-03-08,20981,25,2723,177,5,6,23917
2018-03-09,23394,21,3447,202,2,8,27074
2018-03-10,24047,21,1660,229,5,3,25965
2018-03-11,21043,23,603,292,1,9,21971
2018-03-12,19892,22,2151,201,0,7,22273
2018-03-13,18510,26,2862,174,1,7,21580
2018-03-14,19591,24,2861,163,5,8,22652
2018-03-15,21455,24,2690,208,2,7,24386
2018-03-16,24876,25,3129,212,1,8,28251
2018-03-17,24736,27,1808,273,2,3,26849
2018-03-18,19287,21,455,267,0,8,20038
2018-03-19,18726,19,2294,236,1,8,21284
2018-03-20,19128,24,2941,170,4,7,22274
2018-03-21,18237,26,2910,157,1,6,21337
2018-03-22,20332,15,2506,168,0,7,23028
2018-03-23,21314,24,2831,184,3,8,24364
2018-03-24,25934,27,1733,261,1,3,27959
2018-03-25,20862,22,472,290,0,10,21656
2018-03-26,21536,24,2546,197,4,10,24317
2018-03-27,20891,27,2989,225,14,8,24154
2018-03-28,22727,22,3155,260,3,11,26178
2018-03-29,25635,23,3935,197,7,16,29813
2018-03-30,26846,24,2372,246,5,8,29501
2018-03-31,21748,20,919,244,1,7,22939
2018-04-01,16813,23,200,170,2,6,17214
2018-04-02,27915,18,580,208,1,8,28730
2018-04-03,24878,26,2475,214,9,7,27609
2018-04-04,23356,21,2897,211,3,13,26501
2018-04-05,25671,22,3191,248,3,7,29142
2018-04-06,24899,23,3530,228,4,8,28692
2018-04-07,24992,18,1556,300,8,10,26884
2018-04-08,23750,22,539,360,4,5,24680
2018-04-09,21643,19,2560,247,1,9,24479
2018-04-10,22081,26,2988,212,7,6,25320
2018-04-11,20590,26,2937,189,14,7,23763
2018-04-12,23174,26,3190,262,9,5,26666
2018-04-13,23958,25,3499,213,6,10,27711
2018-04-14,25890,19,1711,284,5,8,27917
2018-04-15,24400,21,565,286,4,8,25284
2018-04-16,22318,30,2477,302,5,10,25142
2018-04-17,21750,26,2882,250,8,9,24925
2018-04-18,22325,22,3424,183,5,8,25967
2018-04-19,21740,28,3007,248,5,9,25037
2018-04-20,24537,28,3539,353,5,9,28471
2018-04-21,27876,20,1745,384,1,9,30035
2018-04-22,25078,21,567,361,17,8,26052
2018-04-23,22625,25,2884,278,6,9,25827
2018-04-24,22473,28,3254,275,5,8,26043
2018-04-25,23914,23,2942,314,3,8,27204
2018-04-26,25615,23,3452,258,10,9,29367
2018-04-27,26376,24,2759,353,8,10,29530
2018-04-28,24728,26,1811,358,4,9,26936
2018-04-29,26601,18,588,322,3,11,27543
2018-04-30,28030,27,2374,321,7,13,30772
2018-05-01,22860,22,726,354,5,8,23975
2018-05-02,20859,25,1600,342,13,9,22848
2018-05-03,24314,22,2940,325,12,14,27627
2018-05-04,26033,23,3810,322,28,13,30229
2018-05-05,27251,20,1882,327,5,17,29502
2018-05-06,24226,26,546,394,5,16,25213
2018-05-07,23510,29,2590,320,0,13,26462
2018-05-08,22827,25,2911,282,8,14,26067
2018-05-09,23222,24,3157,292,10,10,26715
2018-05-10,28867,25,3188,311,9,14,32414
2018-05-11,25904,24,3248,307,5,13,29501
2018-05-12,28140,22,1714,436,8,18,30338
2018-05-13,24431,23,567,387,6,9,25423
2018-05-14,23307,36,2763,249,3,17,26375
2018-05-15,23386,24,2755,283,5,15,26468
2018-05-16,23482,21,3415,277,10,15,27220
2018-05-17,24837,26,3282,340,13,8,28506
2018-05-18,24410,28,3227,323,7,16,28011
2018-05-19,28506,26,1941,385,3,18,30879
2018-05-20,26449,21,545,413,16,15,27459
2018-05-21,26182,24,2238,276,13,14,28747
2018-05-22,22602,23,3167,402,9,10,26213
2018-05-23,21755,24,2884,287,5,19,24974
2018-05-24,25396,22,3551,268,9,16,29262
2018-05-25,26159,21,3454,338,8,16,29996
2018-05-26,25440,26,1539,405,6,19,27435
2018-05-27,25177,19,588,406,2,19,26211
2018-05-28,23914,20,2560,330,7,21,26852
2018-05-29,23301,23,3093,304,13,17,26751
2018-05-30,23905,27,2990,325,7,16,27270
2018-05-31,29283,17,1988,372,12,17,31689
2018-06-01,27301,23,3336,310,15,15,31000
2018-06-02,27328,23,1563,395,6,17,29332
2018-06-03,23903,25,588,404,2,10,24932
2018-06-04,23455,23,2196,335,12,16,26037
2018-06-05,21805,22,3001,305,9,14,25156
2018-06-06,22578,23,2558,298,8,17,25482
2018-06-07,23689,30,3169,290,17,10,27205
2018-06-08,25969,22,3151,336,10,20,29508
2018-06-09,26979,20,2035,348,2,20,29404
2018-06-10,24083,20,567,365,10,22,25067
2018-06-11,24899,25,2790,370,7,19,28110
2018-06-12,22748,24,2623,289,5,18,25707
2018-06-13,24722,25,2938,290,10,10,27995
2018-06-14,25880,23,2920,360,13,14,29210
2018-06-15,29610,26,3408,338,12,17,33411
2018-06-16,26479,24,1599,383,4,18,28507
2018-06-17,24802,19,629,370,7,17,25844
2018-06-18,25246,26,2542,370,8,13,28205
2018-06-19,24017,27,3299,304,9,17,27673
2018-06-20,23742,29,2940,314,8,17,27050
2018-06-21,25519,25,3489,346,16,14,29409
2018-06-22,30122,19,2275,366,5,12,32799
2018-06-23,29222,27,2133,347,10,21,31760
2018-06-24,27007,16,503,389,11,11,27937
2018-06-25,33895,25,1422,425,6,20,35793
2018-06-26,23928,27,2598,326,11,16,26906
2018-06-27,23354,28,3020,295,13,11,26721
2018-06-28,23996,24,3256,311,10,12,27609
2018-06-29,28462,19,3468,304,15,22,32290
2018-06-30,29210,24,1387,333,13,23,30990
2018-07-01,26120,19,567,423,6,19,27154
2018-07-02,24285,26,2575,283,11,13,27193
2018-07-03,23019,25,2884,272,10,16,26226
2018-07-04,22949,33,2514,290,15,12,25813
2018-07-05,24532,30,2686,267,9,18,27542
2018-07-06,25837,22,3385,300,13,16,29573
2018-07-07,27519,24,1561,294,12,22,29432
2018-07-08,24399,18,560,330,6,18,25331
2018-07-09,24509,27,2378,294,10,18,27236
2018-07-10,23421,20,2712,252,11,12,26428
2018-07-11,23717,25,2905,234,11,17,26909
2018-07-12,24093,27,2534,302,15,15,26986
2018-07-13,25690,21,3275,275,10,17,29288
2018-07-14,31801,23,1547,340,10,21,33742
2018-07-15,24731,24,438,247,6,17,25463
2018-07-16,23659,25,3432,265,10,20,27411
2018-07-17,24411,18,2755,274,6,14,27478
2018-07-18,24167,23,2582,255,13,11,27051
2018-07-19,24888,27,3021,253,11,18,28218
2018-07-20,28994,25,2740,268,11,18,32056
2018-07-21,31430,20,1416,338,11,22,33237
2018-07-22,27800,22,532,261,13,13,28641
2018-07-23,27769,24,2378,266,10,21,30468
2018-07-24,24214,26,2633,224,7,17,27121
2018-07-25,24645,30,2507,270,5,19,27476
2018-07-26,26199,23,2720,284,14,9,29249
2018-07-27,27430,26,3081,242,16,43,30838
2018-07-28,29305,21,1255,1827,9,22,32439
2018-07-29,27773,22,577,315,10,16,28713
2018-07-30,28709,27,2250,291,6,9,31292
2018-07-31,25428,24,2656,298,18,14,28438
2018-08-01,24720,26,2564,240,10,18,27578
2018-08-02,26739,23,2997,248,10,10,30027
2018-08-03,20405,24,1864,246,8,21,22568
2018-08-04,29536,20,1512,314,12,21,31415
2018-08-05,26374,22,501,326,9,16,27248
2018-08-06,26953,35,2535,266,12,20,29821
2018-08-07,26222,22,2147,248,12,12,28663
2018-08-08,23240,25,2752,226,19,16,26278
2018-08-09,24176,20,2469,313,13,17,27008
2018-08-10,24728,25,2686,271,12,19,27741
2018-08-11,28268,22,1234,254,12,19,29809
2018-08-12,25002,23,497,255,7,19,25803
2018-08-13,26264,23,2366,255,8,15,28931
2018-08-14,26023,30,2367,253,8,17,28698
2018-08-15,31364,22,948,293,14,15,32656
2018-08-16,28142,23,2546,297,9,9,31026
2018-08-17,25542,24,2228,264,15,23,28096
2018-08-18,27787,31,1186,308,26,23,29361
2018-08-19,32409,18,482,372,9,10,33300
2018-08-20,24162,24,1741,240,8,14,26189
2018-08-21,24401,25,2502,249,12,17,27206
2018-08-22,23243,27,2779,240,12,19,26320
2018-08-23,26207,20,2472,256,13,15,28983
2018-08-24,25379,24,2764,246,19,13,28445
2018-08-25,26579,22,1136,326,14,20,28097
2018-08-26,23990,27,515,336,5,17,24890
2018-08-27,26427,23,2147,250,6,15,28868
2018-08-28,22391,27,2974,226,8,17,25643
2018-08-29,22252,27,2715,244,8,17,25263
2018-08-30,23185,26,2948,241,14,11,26425
2018-08-31,25801,26,3039,294,11,18,29189
2018-09-01,25961,21,1445,328,7,16,27778
2018-09-02,24808,16,592,333,3,18,25770
2018-09-03,24117,26,2433,255,5,16,26852
2018-09-04,23086,25,2873,251,39,16,26290
2018-09-05,23118,22,3273,234,8,12,26667
2018-09-06,24533,32,2853,256,16,17,27707
2018-09-07,23967,27,3118,249,7,16,27384
2018-09-08,29256,26,1578,304,8,16,31188
2018-09-09,25665,19,583,320,7,9,26603
2018-09-10,22951,34,2454,301,8,16,25764
2018-09-11,21734,29,2660,319,18,15,24775
2018-09-12,22254,25,2827,264,8,19,25397
2018-09-13,23754,25,3088,253,13,11,27144
2018-09-14,24899,17,2986,283,31,18,28234
2018-09-15,27142,20,1726,328,6,20,29242
2018-09-16,26227,22,558,346,7,12,27172
2018-09-17,23679,24,2512,286,10,14,26525
2018-09-18,22224,24,2895,257,12,17,25429
2018-09-19,28037,18,2835,296,11,16,31213
2018-09-20,26237,26,3175,280,15,14,29747
2018-09-21,29067,23,3462,259,25,13,32849
2018-09-22,27758,15,2063,414,13,20,30283
2018-09-23,23954,17,606,462,3,15,25057
2018-09-24,33597,61,3133,437,4,97,37329
2018-09-25,21879,27,2870,266,3,11,25056
2018-09-26,21969,29,2270,262,20,20,24570
2018-09-27,23384,27,2953,286,22,18,26690
2018-09-28,25054,18,3224,281,16,16,28609
2018-09-29,25807,27,1780,289,7,20,27930
2018-09-30,23927,23,566,395,4,18,24933
2018-10-01,22383,36,2629,308,4,17,25377
2018-10-02,21764,24,2658,254,7,14,24721
2018-10-03,22768,23,3030,271,6,17,26115
2018-10-04,22826,26,3309,300,14,19,26494
2018-10-05,25032,23,3532,355,15,15,28972
2018-10-06,25472,26,1466,291,3,17,27275
2018-10-07,23339,20,447,365,3,18,24192
2018-10-08,37224,19,1613,481,3,15,39355
2018-10-09,20811,23,2864,277,7,12,23994
2018-10-10,22258,25,2844,260,8,15,25410
2018-10-11,22994,25,3280,258,8,16,26581
2018-10-12,24294,24,3240,249,11,15,27833
2018-10-13,25504,24,1718,338,4,16,27604
2018-10-14,24315,23,528,395,18,19,25298
2018-10-15,22160,21,2480,255,23,12,24951
2018-10-16,18707,28,2221,269,6,8,21239
2018-10-17,24024,23,2904,241,1,11,27204
2018-10-18,23211,32,3095,280,6,10,26634
2018-10-19,23454,26,3414,274,4,15,27187
2018-10-20,25851,18,1371,355,6,15,27616
2018-10-21,24513,14,563,448,3,7,25548
2018-10-22,21214,18,2600,281,2,10,24125
2018-10-23,20693,27,2541,226,9,8,23504
2018-10-24,20486,23,2731,245,19,11,23515
2018-10-25,22078,30,2891,258,16,10,25283
2018-10-26,25039,25,3304,361,7,8,28744
2018-10-27,24646,25,1816,295,2,13,26797
2018-10-28,22647,16,522,313,2,11,23511
2018-10-29,20073,27,2394,220,1,8,22723
2018-10-30,22652,23,3315,202,0,6,26198
2018-10-31,25319,27,2585,200,5,8,28144
2018-11-01,25459,21,1020,214,3,7,26724
2018-11-02,27885,29,2599,200,6,7,30726
2018-11-03,26541,19,1266,255,3,5,28089
2018-11-04,24822,19,569,286,1,10,25707
2018-11-05,20978,23,2466,220,1,8,23696
2018-11-06,19717,25,2962,207,4,5,22920
2018-11-07,20347,20,2849,182,4,6,23408
2018-11-08,21248,21,2953,160,2,8,24392
2018-11-09,21944,24,2979,214,3,9,25173
2018-11-10,24997,22,1851,262,3,5,27140
2018-11-11,21708,18,636,336,0,8,22706
2018-11-12,20542,26,2340,182,1,7,23098
2018-11-13,19810,28,2805,188,3,8,22842
2018-11-14,20480,22,3180,191,4,6,23883
2018-11-15,21219,24,2968,197,6,8,24422
2018-11-16,23403,22,3186,169,2,9,26791
2018-11-17,23218,18,1510,250,1,6,25003
2018-11-18,20020,12,544,265,1,8,20850
2018-11-19,20204,24,2210,220,1,8,22667
2018-11-20,18098,17,2671,152,0,7,20945
2018-11-21,18400,24,2021,170,1,8,20624
2018-11-22,20984,27,3210,200,1,8,24430
2018-11-23,23200,23,3165,189,3,8,26588
2018-11-24,22174,23,1554,264,2,4,24021
2018-11-25,19315,19,525,265,1,8,20133
2018-11-26,19199,22,2439,170,1,8,21839
2018-11-27,18388,23,2851,162,1,6,21431
2018-11-28,18430,21,2879,158,1,7,21496
2018-11-29,17581,24,2767,176,1,8,20557
2018-11-30,21195,24,3098,172,3,9,24501
2018-12-01,21154,23,1442,294,2,4,22919
2018-12-02,18442,21,553,314,2,8,19340
2018-12-03,17836,25,2378,156,1,8,20404
2018-12-04,18967,23,2750,154,2,5,21901
2018-12-05,19135,24,2580,170,4,6,21919
2018-12-06,19462,26,3053,166,4,10,22721
2018-12-07,20993,23,2945,189,5,8,24163
2018-12-08,21884,22,1366,350,2,5,23629
2018-12-09,19216,22,513,336,1,7,20095
2018-12-10,20232,26,2785,181,3,8,23235
2018-12-11,19957,26,2993,164,0,5,23145
2018-12-12,20446,23,2754,161,5,6,23395
2018-12-13,21017,23,3160,174,2,7,24383
2018-12-14,19694,21,3205,176,1,7,23104
2018-12-15,18117,17,1279,328,1,4,19746
2018-12-16,18016,17,486,322,0,8,18849
2018-12-17,20494,23,2455,141,3,7,23123
2018-12-18,21237,21,2709,124,2,9,24102
2018-12-19,21784,20,2583,150,1,2,24540
2018-12-20,23983,24,3030,173,3,8,27221
2018-12-21,27454,19,3048,144,3,9,30677
2018-12-22,30913,19,1469,288,3,4,32696
2018-12-23,20440,16,372,242,1,9,21080
2018-12-24,18087,22,917,132,2,7,19167
2018-12-25,12266,12,191,70,0,0,12539
2018-12-26,20763,15,489,122,0,4,21393
2018-12-27,23345,20,1304,156,0,8,24833
2018-12-28,23731,19,1600,174,1,9,25534
2018-12-29,25422,23,1004,228,2,5,26684
2018-12-30,20655,19,351,203,3,7,21238
2018-12-31,16848,19,557,143,1,7,17575
2019-01-01,13559,13,227,220,0,1,14020
2019-01-02,21352,19,791,246,0,6,22414
2019-01-03,21114,19,1498,200,0,9,22840
2019-01-04,21060,21,1497,135,0,8,22721
2019-01-05,20836,19,837,189,3,4,21888
2019-01-06,18237,16,508,206,2,7,18976
2019-01-07,17249,24,1668,196,2,8,19147
2019-01-08,18334,16,2159,143,1,5,20658
2019-01-09,15988,23,2152,137,2,6,18308
2019-01-10,19597,17,2364,157,0,5,22140
2019-01-11,21387,25,2650,141,1,8,24212
2019-01-12,26365,27,1212,200,2,4,27810
2019-01-13,18612,20,494,256,0,9,19391
2019-01-14,16408,26,2786,150,3,6,19379
2019-01-15,18848,21,2600,135,2,5,21611
2019-01-16,18205,27,2260,129,3,6,20630
2019-01-17,19694,26,2937,165,4,8,22834
2019-01-18,20209,23,2661,140,1,8,23042
2019-01-19,20411,13,1457,204,1,4,22090
2019-01-20,18139,18,462,192,3,8,18822
2019-01-21,17184,29,2237,149,1,8,19608
2019-01-22,19092,18,2834,119,12,11,22086
2019-01-23,15381,24,2502,141,4,7,18059
2019-01-24,15804,14,2733,137,0,9,18697
2019-01-25,18297,25,2706,176,2,7,21213
2019-01-26,19748,22,1438,226,3,4,21441
2019-01-27,17274,18,453,190,0,8,17943
2019-01-28,17391,25,2273,164,1,8,19862
2019-01-29,16489,26,2636,144,0,6,19301
2019-01-30,18320,21,2871,146,2,6,21366
2019-01-31,19223,25,2921,150,3,8,22330
2019-02-01,21657,23,2550,178,1,6,24415
2019-02-02,21744,23,1465,215,1,4,23452
2019-02-03,17928,17,462,224,2,4,18637
2019-02-04,18373,28,2461,161,0,8,21031
2019-02-05,17559,26,2209,151,2,5,19952
2019-02-06,18707,28,2643,165,2,5,21550
2019-02-07,20348,26,2680,171,1,6,23232
2019-02-08,21279,27,2297,164,5,8,23780
2019-02-09,23171,20,1797,220,3,4,25215
2019-02-10,19937,22,529,238,5,8,20739
2019-02-11,19538,24,2490,189,0,7,22248
2019-02-12,18258,26,2632,183,3,7,21109
2019-02-13,18971,26,2967,179,1,6,22150
2019-02-14,21493,30,2860,169,2,9,24563
2019-02-15,23018,20,2938,187,2,8,26173
2019-02-16,24340,19,1476,236,2,4,26077
2019-02-17,21702,22,527,262,1,7,22521
2019-02-18,19979,28,2427,158,3,9,22604
2019-02-19,18362,24,2566,157,4,4,21117
2019-02-20,19481,24,2736,143,4,7,22395
2019-02-21,19682,25,2672,159,1,8,22547
2019-02-22,19456,16,3004,138,3,7,22624
2019-02-23,22334,25,1476,237,1,4,24077
2019-02-24,19727,21,571,222,2,8,20551
2019-02-25,18092,26,2506,187,2,8,20821
2019-02-26,18652,25,2601,143,2,6,21429
2019-02-27,19464,27,2786,163,3,6,22449
2019-02-28,21165,23,3128,165,5,8,24494
2019-03-01,22677,25,2859,201,3,8,25773
2019-03-02,23660,25,1688,235,2,4,25614
2019-03-03,21156,19,536,252,1,8,21972
2019-03-04,19737,25,2617,188,3,7,22577
2019-03-05,19864,31,3012,185,7,6,23105
2019-03-06,19507,27,2798,169,2,6,22509
2019-03-07,21259,27,2879,180,3,8,24356
2019-03-08,23597,24,3388,171,1,7,27188
2019-03-09,25730,27,1585,246,1,4,27593
2019-03-10,21930,17,589,297,0,6,22839
2019-03-11,20628,23,2551,187,4,10,23403
2019-03-12,19358,25,3190,211,3,7,22794
2019-03-13,19662,24,3035,191,3,6,22921
2019-03-14,20833,20,3401,161,3,8,24426
2019-03-15,24912,27,2946,183,8,8,28084
2019-03-16,25598,23,1755,249,7,4,27636
2019-03-17,22593,25,775,291,4,7,23695
2019-03-18,20248,26,2741,199,2,7,23223
2019-03-19,20765,28,2806,183,1,6,23789
2019-03-20,20618,27,3084,198,3,9,23939
2019-03-21,20848,29,2782,203,3,5,23870
2019-03-22,23981,27,3640,269,3,8,27928
2019-03-23,24689,20,1719,247,3,4,26682
2019-03-24,23236,22,615,245,2,11,24131
2019-03-25,20899,24,2560,207,4,9,23703
2019-03-26,18778,29,2930,176,1,7,21921
2019-03-27,20042,21,2724,201,4,7,22999
2019-03-28,20590,25,3395,222,3,7,24242
2019-03-29,23671,20,3349,226,5,8,27279
2019-03-30,23814,16,1699,278,6,4,25817
2019-03-31,22185,19,533,292,3,8,23040
2019-04-01,20773,27,2773,196,5,11,23785
2019-04-02,19865,30,2998,194,6,8,23101
2019-04-03,20932,29,3300,204,6,8,24479
2019-04-04,21903,23,2876,219,7,8,25036
2019-04-05,23685,28,3365,221,7,6,27312
2019-04-06,26291,22,1817,291,4,7,28432
2019-04-07,21788,22,671,329,3,8,22821
2019-04-08,20867,27,2387,250,5,10,23546
2019-04-09,20356,26,2774,227,4,7,23394
2019-04-10,22670,26,3067,197,5,8,25973
2019-04-11,23704,23,2896,264,8,10,26905
2019-04-12,24857,19,3050,271,6,12,28215
2019-04-13,26396,20,1718,363,4,5,28506
2019-04-14,23442,23,659,470,15,10,24619
2019-04-15,24545,27,2703,287,5,12,27579
2019-04-16,23994,26,2936,274,27,11,27268
2019-04-17,24439,24,3466,362,9,11,28311
2019-04-18,31034,31,4050,308,5,8,35436
2019-04-19,30196,25,2285,318,7,11,32842
2019-04-20,24328,24,1021,266,3,11,25653
2019-04-21,18141,21,270,228,5,15,18680
2019-04-22,29621,19,763,314,1,12,30730
2019-04-23,25585,22,2636,241,4,12,28500
2019-04-24,23847,23,3016,253,3,15,27157
2019-04-25,25625,24,3127,288,5,15,29084
2019-04-26,26721,22,3095,254,9,15,30116
2019-04-27,27339,31,1550,404,5,16,29345
2019-04-28,24033,14,628,392,1,18,25086
2019-04-29,23027,25,2779,302,5,17,26155
2019-04-30,26156,26,3396,334,7,12,29931
2019-05-01,19041,20,712,341,4,13,20131
2019-05-02,22385,23,1780,253,18,16,24475
2019-05-03,25335,22,3057,364,18,16,28812
2019-05-04,26686,13,1472,353,7,17,28548
2019-05-05,22347,17,583,407,4,16,23374
2019-05-06,24710,24,2307,285,3,16,27345
2019-05-07,22461,23,2876,296,5,14,25675
2019-05-08,22925,23,2602,342,9,11,25912
2019-05-09,24317,25,3612,336,15,33,28338
2019-05-10,27000,20,3248,308,10,16,30602
2019-05-11,26521,15,1623,364,9,18,28550
2019-05-12,23128,22,516,332,0,9,24007
2019-05-13,22310,21,2614,297,2,18,25262
2019-05-14,21935,22,2918,343,10,13,25241
2019-05-15,23104,24,3181,300,12,12,26633
2019-05-16,23626,28,3248,313,8,10,27233
2019-05-17,25505,22,3477,328,15,16,29363
2019-05-18,25823,20,1496,446,4,17,27806
2019-05-19,23368,19,606,418,8,19,24438
2019-05-20,22985,24,2478,347,14,18,25866
2019-05-21,22595,25,2865,294,9,15,25803
2019-05-22,22033,19,2680,358,12,15,25117
2019-05-23,22862,16,2959,303,11,11,26162
2019-05-24,25856,17,3345,364,18,13,29613
2019-05-25,27088,21,1593,345,9,18,29074
2019-05-26,22668,19,566,436,8,15,23712
2019-05-27,22705,26,2572,301,5,14,25623
2019-05-28,22525,17,2625,320,10,9,25506
2019-05-29,23221,24,3010,266,9,17,26547
2019-05-30,27577,18,3592,356,14,15,31572
2019-05-31,24637,24,3287,343,15,17,28323
2019-06-01,26656,15,1808,411,8,15,28913
2019-06-02,23429,24,599,432,2,18,24504
2019-06-03,23141,20,2336,300,8,19,25824
2019-06-04,22569,27,2649,327,10,17,25599
2019-06-05,24066,24,3107,293,14,17,27521
2019-06-06,26720,24,3113,350,11,16,30234
2019-06-07,27083,14,3525,337,19,17,30995
2019-06-08,30646,26,1519,370,13,21,32595
2019-06-09,26619,17,617,441,17,19,27730
2019-06-10,23710,23,2355,315,5,18,26426
2019-06-11,22907,25,2835,304,13,8,26092
2019-06-12,24152,22,2826,341,13,18,27372
2019-06-13,24276,16,2932,319,21,15,27579
2019-06-14,26360,25,3566,338,16,18,30323
2019-06-15,28794,23,1649,363,12,20,30861
2019-06-16,23399,18,606,366,9,16,24414
2019-06-17,24760,21,2539,311,10,18,27659
2019-06-18,24070,28,2953,295,11,14,27371
2019-06-19,25796,23,3145,300,15,16,29295
2019-06-20,31103,24,1884,288,11,21,33331
2019-06-21,26681,23,2856,335,15,12,29922
2019-06-22,28726,21,1535,348,9,20,30659
2019-06-23,28367,18,560,437,7,20,29409
2019-06-24,29024,25,2093,340,14,19,31515
2019-06-25,29216,13,1553,371,9,14,31176
2019-06-26,23709,24,2690,297,14,11,26745
2019-06-27,24338,26,2695,321,24,14,27418
2019-06-28,26520,26,2926,302,17,19,29810
2019-06-29,30339,22,1642,321,14,22,32360
2019-06-30,24251,20,564,347,9,17,25208
2019-07-01,27069,26,2328,311,11,14,29759
2019-07-02,23063,22,2329,283,14,19,25730
2019-07-03,23542,24,2784,330,9,18,26707
2019-07-04,24671,18,2757,240,12,18,27716
2019-07-05,29308,24,3157,321,14,18,32842
2019-07-06,29180,22,1442,268,11,19,30942
2019-07-07,24796,25,574,339,7,18,25759
2019-07-08,24989,19,2268,250,15,20,27561
2019-07-09,25973,26,2676,286,19,11,28991
2019-07-10,25197,23,3101,259,7,18,28605
2019-07-11,25032,33,2432,262,22,17,27798
2019-07-12,27213,26,2700,259,14,19,30231
2019-07-13,30512,23,1441,275,12,16,32279
2019-07-14,26503,21,610,316,15,22,27487
2019-07-15,27039,36,2405,248,10,18,29756
2019-07-16,24831,16,2358,281,14,17,27517
2019-07-17,28003,36,2491,259,6,10,30805
2019-07-18,26189,27,2884,272,11,18,29401
2019-07-19,26918,21,3158,286,17,18,30418
2019-07-20,32813,24,1568,308,18,19,34750
2019-07-21,33142,20,603,307,5,19,34096
2019-07-22,26988,22,2337,239,11,20,29617
2019-07-23,24451,25,2682,263,10,13,27444
2019-07-24,24147,27,2923,273,6,17,27393
2019-07-25,28287,26,2785,290,12,19,31419
2019-07-26,28409,27,2742,257,10,19,31464
2019-07-27,29719,12,1096,304,11,22,31164
2019-07-28,26484,22,615,322,3,16,27462
2019-07-29,32626,29,2299,307,9,19,35289
2019-07-30,28447,27,2359,300,11,18,31162
2019-07-31,26035,29,2644,218,9,21,28956
2019-08-01,27992,22,2856,237,11,19,31137
2019-08-02,31781,25,2868,265,8,19,34966
2019-08-03,34755,22,1600,343,10,36,36766
2019-08-04,28649,26,563,312,11,24,29585
2019-08-05,33942,22,1734,261,10,18,35987
2019-08-06,23950,28,1978,262,10,14,26242
2019-08-07,26706,43,2394,271,8,21,29443
2019-08-08,28439,23,2513,263,17,18,31273
2019-08-09,29736,29,2889,260,13,18,32945
2019-08-10,39407,26,1048,349,14,21,40865
2019-08-11,29870,18,623,280,34,14,30839
2019-08-12,33045,24,2190,270,16,18,35563
2019-08-13,28111,29,2346,284,12,17,30799
2019-08-14,33965,26,2257,289,12,17,36566
2019-08-15,31504,16,1048,308,25,14,32915
2019-08-16,39086,29,2085,289,15,16,41520
2019-08-17,31391,23,1085,271,15,19,32804
2019-08-18,31863,19,667,306,6,19,32880
2019-08-19,28215,26,1934,291,19,18,30503
2019-08-20,25690,27,2370,265,12,2,28366
2019-08-21,25617,27,2493,262,8,17,28424
2019-08-22,27204,17,2652,246,16,18,30153
2019-08-23,27181,20,2463,274,13,19,29970
2019-08-24,27999,23,985,275,11,18,29311
2019-08-25,24827,21,585,314,9,10,25766
2019-08-26,26264,20,2350,279,10,17,28940
2019-08-27,24632,26,2520,287,14,18,27497
2019-08-28,25197,28,2740,233,13,14,28225
2019-08-29,25745,25,2743,262,13,17,28805
2019-08-30,26266,28,3156,300,20,15,29785
2019-08-31,26759,21,1398,322,9,20,28529
2019-09-01,27194,18,588,299,4,20,28123
2019-09-02,25000,30,2610,291,10,19,27960
2019-09-03,25057,19,2676,293,5,13,28063
2019-09-04,22790,23,2750,252,7,12,25834
2019-09-05,24485,28,2806,278,16,17,27630
2019-09-06,26301,27,3105,283,6,18,29740
2019-09-07,30858,20,1465,300,6,24,32673
2019-09-08,25859,19,538,375,6,12,26809
2019-09-09,24280,27,2375,287,8,17,26994
2019-09-10,23776,24,2837,312,6,14,26969
2019-09-11,23287,21,2676,268,9,17,26278
2019-09-12,24034,31,2877,258,14,19,27233
2019-09-13,27224,24,3117,270,16,19,30670
2019-09-14,28150,24,1459,369,8,22,30032
2019-09-15,27161,21,599,344,5,18,28148
2019-09-16,24064,22,2500,314,10,15,26925
2019-09-17,22677,23,2572,282,8,13,25575
2019-09-18,24181,26,2703,289,8,17,27224
2019-09-19,25645,25,2742,307,17,15,28751
2019-09-20,27426,27,2939,373,9,15,30789
2019-09-21,28462,22,1515,342,4,20,30365
2019-09-22,26087,20,638,407,5,18,27175
2019-09-23,22592,25,2151,325,5,16,25114
2019-09-24,22741,28,2818,382,13,17,25999
2019-09-25,24049,23,2824,267,4,12,27179
2019-09-26,24784,17,3229,321,15,16,28382
2019-09-27,25852,14,2815,305,5,11,29002
2019-09-28,26773,15,1666,345,5,16,28820
2019-09-29,25201,16,577,415,5,19,26233
2019-09-30,22870,26,2857,336,4,17,26110
2019-10-01,22831,27,2412,349,12,12,25643
2019-10-02,21987,14,2421,283,13,11,24729
2019-10-03,25657,22,2983,324,8,17,29011
2019-10-04,25903,24,3339,296,15,18,29595
2019-10-05,26924,19,1636,348,6,17,28950
2019-10-06,24029,22,606,434,6,18,25115
2019-10-07,26274,19,2405,389,4,14,29105
2019-10-08,35213,22,2160,460,12,13,37880
2019-10-09,21327,20,2843,308,5,10,24513
2019-10-10,24738,22,2957,262,11,9,27999
2019-10-11,25444,26,2719,304,9,15,28517
2019-10-12,26965,21,1269,428,6,17,28706
2019-10-13,26739,20,621,492,16,16,27904
2019-10-14,22498,24,2291,277,19,13,25122
2019-10-15,22665,25,2679,278,7,13,25667
2019-10-16,22384,28,2586,299,5,14,25316
2019-10-17,23360,28,3051,330,4,8,26781
2019-10-18,24832,25,3088,306,8,17,28276
2019-10-19,27565,23,1468,401,8,16,29481
2019-10-20,25371,21,511,447,4,12,26366
2019-10-21,22504,25,2405,289,2,11,25236
2019-10-22,21100,25,2613,293,7,7,24045
2019-10-23,21322,28,2568,269,4,10,24201
2019-10-24,23197,26,2571,326,8,11,26139
2019-10-25,26123,28,3246,289,5,11,29702
2019-10-26,26911,25,1407,321,6,9,28679
2019-10-27,25868,27,568,377,3,7,26850
2019-10-28,23892,20,2382,309,1,8,26612
2019-10-29,24258,25,2791,239,6,6,27325
2019-10-30,25507,29,3251,191,2,6,28986
2019-10-31,28223,21,2248,218,4,6,30720
2019-11-01,30311,18,957,240,5,8,31539
2019-11-02,30556,24,1134,245,5,3,31967
2019-11-03,27454,20,632,312,1,8,28427
2019-11-04,24160,21,2321,213,2,10,26727
2019-11-05,21985,23,2551,224,1,8,24792
2019-11-06,22952,23,2535,184,3,6,25703
2019-11-07,22647,28,2672,192,6,6,25551
2019-11-08,24519,28,3043,189,4,7,27790
2019-11-09,25251,20,1394,280,2,3,26950
2019-11-10,22217,19,527,344,0,5,23112
2019-11-11,22433,21,2046,172,4,8,24684
2019-11-12,21013,27,2539,192,3,6,23780
2019-11-13,20880,16,2815,184,2,6,23903
2019-11-14,22802,24,2988,185,4,8,26011
2019-11-15,24725,16,3011,198,4,7,27961
2019-11-16,25651,23,1340,239,3,6,27262
2019-11-17,21453,22,518,287,1,8,22289
2019-11-18,20408,24,2498,187,3,8,23128
2019-11-19,22217,28,2773,168,3,5,25194
2019-11-20,22379,27,2824,154,7,9,25400
2019-11-21,21944,22,3030,161,2,8,25167
2019-11-22,25215,25,3174,188,5,8,28615
2019-11-23,24485,17,1595,222,7,4,26330
2019-11-24,22640,7,594,249,0,9,23499
2019-11-25,21022,19,1982,168,7,9,23207
2019-11-26,20722,18,2621,140,5,6,23512
2019-11-27,20573,15,2779,184,9,6,23566
2019-11-28,21672,17,2856,151,4,7,24707
2019-11-29,24006,20,2921,157,6,10,27120
2019-11-30,23456,27,1429,281,4,4,25201
2019-12-01,20223,13,568,264,0,7,21075
2019-12-02,20902,27,2536,152,3,9,23629
2019-12-03,20761,30,2335,169,0,6,23301
2019-12-04,21651,20,2539,141,2,6,24359
2019-12-05,21674,25,2909,161,3,6,24778
2019-12-06,23572,21,3316,170,1,9,27089
2019-12-07,23743,23,1431,387,3,4,25591
2019-12-08,20616,15,599,306,0,6,21542
2019-12-09,20394,27,2277,164,0,8,22870
2019-12-10,19175,28,2624,138,0,6,21971
2019-12-11,21538,23,2550,163,2,5,24281
2019-12-12,22009,26,2499,144,4,6,24688
2019-12-13,22507,28,3024,185,0,7,25751
2019-12-14,24910,14,1605,369,2,4,26904
2019-12-15,22760,20,581,374,0,8,23743
2019-12-16,22504,17,2450,140,3,6,25120
2019-12-17,23431,24,2835,154,1,6,26451
2019-12-18,23882,27,3116,155,1,6,27187
2019-12-19,24991,26,2620,172,4,8,27821
2019-12-20,29123,24,3306,192,3,8,32656
2019-12-21,30747,28,1539,315,1,4,32634
2019-12-22,21347,22,697,276,0,8,22350
2019-12-23,26598,20,1700,194,0,8,28520
2019-12-24,19994,21,1120,126,4,5,21270
2019-12-25,14521,12,266,81,2,0,14882
2019-12-26,22766,22,449,129,0,6,23372
2019-12-27,25761,15,988,146,2,8,26920
2019-12-28,26229,21,827,168,3,4,27252
2019-12-29,22217,19,378,237,4,7,22862
2019-12-30,26178,22,1153,209,1,7,27570
2019-12-31,17430,23,595,140,4,5,18197
2020-01-01,14882,6,244,238,3,17,15390
2020-01-02,23104,27,645,173,2,8,23959
2020-01-03,24056,22,1237,157,3,7,25482
2020-01-04,24124,24,669,194,3,4,25018
2020-01-05,21890,18,426,161,1,7,22503
2020-01-06,23858,14,720,186,0,10,24788
2020-01-07,18523,23,1645,154,3,6,20354
2020-01-08,19888,25,2077,141,2,6,22139
2020-01-09,20052,26,2450,138,0,7,22673
2020-01-10,23708,23,2701,140,2,8,26582
2020-01-11,25706,25,1371,203,3,4,27312
2020-01-12,19661,25,471,239,2,8,20406
2020-01-13,18846,23,1886,139,1,13,20908
2020-01-14,18156,24,2410,141,1,4,20736
2020-01-15,19122,18,2316,128,1,7,21592
2020-01-16,21013,23,2805,142,3,6,23992
2020-01-17,22107,26,2781,132,2,7,25055
2020-01-18,22831,24,1420,204,2,5,24486
2020-01-19,18851,21,505,150,1,6,19534
2020-01-20,19265,22,2340,141,0,7,21775
2020-01-21,18896,23,2684,132,0,6,21741
2020-01-22,18972,21,2648,126,3,5,21775
2020-01-23,19745,23,2746,125,1,7,22647
2020-01-24,21484,24,2785,159,3,9,24464
2020-01-25,23566,22,1286,196,1,4,25075
2020-01-26,18102,23,453,181,0,8,18767
2020-01-27,18483,19,2210,139,1,7,20859
2020-01-28,18715,23,2454,156,3,6,21357
2020-01-29,18082,29,2558,135,3,5,20812
2020-01-30,20015,27,2766,139,1,9,22957
2020-01-31,20542,27,2922,169,1,3,23664
2020-02-01,23313,19,1296,197,2,5,24832
2020-02-02,19728,19,634,189,1,7,20578
2020-02-03,19912,25,2515,148,3,8,22611
2020-02-04,17798,24,2645,137,1,6,20611
2020-02-05,18022,27,2466,130,1,5,20651
2020-02-06,19111,20,2551,122,1,7,21812
2020-02-07,21308,35,2840,157,2,4,24346
2020-02-08,23262,21,1129,201,1,3,24617
2020-02-09,20422,24,586,208,4,8,21252
2020-02-10,19989,22,2231,157,0,7,22406
2020-02-11,19736,58,2647,136,6,5,22588
2020-02-12,19358,23,2754,146,3,5,22289
2020-02-13,20411,28,2990,140,2,8,23579
2020-02-14,23068,28,3001,158,4,9,26268
2020-02-15,25825,27,1531,259,2,6,27650
2020-02-16,22791,18,588,216,0,7,23620
2020-02-17,20881,32,2055,166,2,7,23143
2020-02-18,20433,26,2702,149,0,6,23316
2020-02-19,20970,26,2689,166,3,7,23861
2020-02-20,21353,20,2675,152,2,4,24206
2020-02-21,24846,28,3325,170,3,8,28380
2020-02-22,24404,23,1328,194,3,4,25956
2020-02-23,23550,24,831,232,1,8,24646
2020-02-24,20491,29,2369,152,1,7,23049
2020-02-25,19284,26,2550,146,3,6,22015
2020-02-26,18265,23,2399,140,2,4,20833
2020-02-27,19851,27,2823,146,1,5,22853
2020-02-28,21104,24,2714,177,0,7,24026
2020-02-29,22225,26,1336,176,1,4,23768
2020-03-01,18550,21,610,179,0,8,19368
2020-03-02,19016,28,2339,160,4,7,21554
2020-03-03,19163,27,2688,129,0,3,22010
2020-03-04,19286,28,3013,128,4,4,22463
2020-03-05,20415,26,2943,137,1,7,23529
2020-03-06,22193,32,3203,163,1,8,25600
2020-03-07,22208,23,1518,181,1,4,23935
2020-03-08,21005,21,588,276,0,9,21899
2020-03-09,20009,21,2587,171,1,9,22798
2020-03-10,19217,26,2629,138,1,5,22016
2020-03-11,18451,25,2566,131,4,4,21181
2020-03-12,20118,27,2450,148,8,7,22758
2020-03-13,19092,13,2560,92,5,9,21771
2020-03-14,14688,26,1544,135,1,3,16397
2020-03-15,6060,18,524,66,2,6,6676
2020-03-16,5224,27,1446,43,2,4,6746
2020-03-17,3922,21,1317,19,1,1,5281
2020-03-18,2849,15,1584,13,2,2,4465
2020-03-19,2212,18,1465,15,1,3,3714
2020-03-20,2064,4,1615,11,1,1,3696
2020-03-21,1284,17,886,4,2,1,2194
2020-03-22,925,16,229,0,0,1,1171
2020-03-23,1344,16,1077,2,0,1,2440
2020-03-24,1215,16,1217,4,2,1,2455
2020-03-25,990,12,1339,3,2,3,2349
2020-03-26,1306,11,1506,5,1,0,2829
2020-03-27,1332,18,1692,1,0,0,3043
2020-03-28,687,20,783,1,3,0,1494
2020-03-29,241,15,167,1,2,0,426
2020-03-30,1172,14,1379,2,0,1,2568
2020-03-31,1241,8,1682,2,0,0,2933
2020-04-01,1391,17,1717,3,1,0,3129
2020-04-02,1384,11,1799,3,1,0,3198
2020-04-03,1884,21,1889,4,2,1,3801
2020-04-04,848,16,660,2,3,0,1529
2020-04-05,373,17,181,7,2,1,581
2020-04-06,1346,12,1467,0,1,0,2826
2020-04-07,1526,15,1848,0,1,0,3390
2020-04-08,1433,17,1883,3,1,0,3337
2020-04-09,1674,18,2078,4,2,0,3776
2020-04-10,1740,18,1892,1,2,1,3654
2020-04-11,570,20,388,0,0,0,978
2020-04-12,178,15,46,0,0,0,239
2020-04-13,507,11,218,0,2,0,738
2020-04-14,1619,13,1388,0,2,0,3022
2020-04-15,1835,14,1836,1,0,0,3686
2020-04-16,1742,14,1977,0,0,0,3733
2020-04-17,2099,16,2276,0,1,1,4393
2020-04-18,1061,20,925,1,0,0,2007
2020-04-19,424,21,183,1,1,0,630
2020-04-20,1951,16,1558,0,0,0,3525
2020-04-21,1902,17,1903,0,1,0,3823
2020-04-22,2101,14,2281,0,1,0,4397
2020-04-23,2144,19,2302,2,1,0,4468
2020-04-24,3121,16,2550,0,2,0,5689
2020-04-25,1259,13,864,0,2,0,2138
2020-04-26,564,17,228,0,0,0,809
2020-04-27,1425,15,1454,3,1,0,2898
2020-04-28,2462,20,2370,2,5,0,4859
2020-04-29,2636,20,2423,4,1,0,5084
2020-04-30,3735,19,3026,3,2,0,6785
2020-05-01,2494,22,655,1,0,0,3172
2020-05-02,1068,16,502,0,4,0,1590
2020-05-03,931,0,203,1,0,0,1135
2020-05-04,2687,10,1926,2,2,2,4629
2020-05-05,3113,20,2331,5,3,0,5472
2020-05-06,3049,21,2531,3,3,0,5607
2020-05-07,3326,19,2761,3,1,1,6111
2020-05-08,4606,21,2835,5,2,0,7469
2020-05-09,2303,17,945,0,3,0,3268
2020-05-10,1392,14,286,0,0,0,1692
2020-05-11,3674,4,2016,7,0,0,5701
2020-05-12,3828,17,2337,6,0,0,6188
2020-05-13,4738,17,2666,8,2,2,7433
2020-05-14,5133,13,2646,12,1,3,7808
2020-05-15,6354,20,2908,9,1,0,9292
2020-05-16,4742,21,1158,4,4,0,5929
2020-05-17,4225,20,316,5,3,0,4569
2020-05-18,6806,10,2173,10,4,0,9003
2020-05-19,6850,19,2621,10,1,0,9501
2020-05-20,8909,17,3409,16,1,0,12352
2020-05-21,10703,24,2637,17,4,0,13385
2020-05-22,8431,20,2991,7,5,0,11454
2020-05-23,7285,19,1149,4,3,0,8460
2020-05-24,7148,22,363,4,1,0,7538
2020-05-25,9652,18,2463,8,2,0,12143
2020-05-26,9353,20,3111,33,2,0,12519
2020-05-27,9740,14,2843,20,1,1,12619
2020-05-28,10458,17,2761,13,3,1,13253
2020-05-29,16080,21,2945,14,8,1,19069
2020-05-30,15385,22,999,9,6,0,16421
2020-05-31,14716,21,494,6,4,0,15241
2020-06-01,18193,11,1958,10,3,0,20175
2020-06-02,17238,22,2616,15,7,0,19898
2020-06-03,17914,16,2714,9,6,1,20660
2020-06-04,17474,20,3150,12,4,0,20660
2020-06-05,21416,10,3288,14,3,1,24732
2020-06-06,22742,20,1558,9,5,1,24335
2020-06-07,18634,22,522,13,6,0,19197
2020-06-08,20168,17,2836,7,6,0,23034
2020-06-09,20350,19,3031,12,5,0,23417
2020-06-10,25717,18,2801,14,9,1,28560
2020-06-11,27398,19,1938,8,0,0,29363
2020-06-12,25436,14,3118,11,6,0,28585
2020-06-13,23206,16,1301,18,4,1,24546
2020-06-14,21554,23,651,14,1,0,22243
2020-06-15,20789,11,2476,14,5,3,23298
2020-06-16,19013,19,3088,20,4,0,22144
2020-06-17,20611,20,2830,30,7,2,23500
2020-06-18,21444,16,3071,42,3,2,24578
2020-06-19,23522,12,3096,53,1,2,26686
2020-06-20,21378,25,1334,68,3,0,22808
2020-06-21,14130,21,484,44,1,2,14682
2020-06-22,24268,19,1723,57,3,2,26072
2020-06-23,17422,20,2731,45,5,1,20224
2020-06-24,23889,22,2943,44,5,2,26905
2020-06-25,10143,18,2103,53,6,1,12324
2020-06-26,12995,18,2772,59,4,3,15851
2020-06-27,8999,19,1110,57,5,7,10197
2020-06-28,7990,15,391,58,3,1,8458
2020-06-29,8420,18,2321,49,5,4,10817
2020-06-30,10056,17,2426,58,7,1,12565
2020-07-01,15702,25,2667,35,4,5,18438
2020-07-02,18753,24,2696,50,5,3,21531
2020-07-03,20997,22,3319,66,7,6,24417
2020-07-04,19115,26,1190,66,6,7,20410
2020-07-05,17141,27,782,91,4,5,18050
2020-07-06,16087,20,2677,61,4,5,18854
2020-07-07,16422,19,2925,50,2,1,19419
2020-07-08,17088,30,2795,63,6,5,19987
2020-07-09,17217,24,3252,65,9,3,20570
2020-07-10,19017,21,2916,74,8,5,22041
2020-07-11,17004,24,1553,70,4,12,18667
2020-07-12,14295,20,477,74,4,8,14878
2020-07-13,14151,20,2345,52,4,7,16579
2020-07-14,13614,24,2628,69,3,6,16344
2020-07-15,14927,24,2855,54,5,4,17869
2020-07-16,14879,30,2632,69,7,7,17624
2020-07-17,18079,24,3113,67,3,10,21296
2020-07-18,17097,21,1045,63,6,16,18248
2020-07-19,13914,21,536,59,1,4,14535
2020-07-20,15527,24,2315,72,6,9,17953
2020-07-21,14805,25,2801,57,11,6,17705
2020-07-22,15055,19,2505,55,8,6,17648
2020-07-23,16182,22,2716,61,6,7,18994
2020-07-24,19301,20,3042,75,8,10,22456
2020-07-25,20157,19,1381,70,6,13,21646
2020-07-26,16252,11,473,62,7,10,16815
2020-07-27,16331,17,2415,65,10,5,18843
2020-07-28,15634,17,2614,76,6,5,18352
2020-07-29,16911,23,2617,54,9,9,19623
2020-07-30,18123,17,2448,64,7,8,20667
2020-07-31,20581,25,2856,56,9,7,23534
2020-08-01,22028,24,1189,58,7,18,23324
2020-08-02,17837,24,454,69,9,6,18399
2020-08-03,19055,7,2022,69,8,9,21170
2020-08-04,18116,19,2382,69,5,5,20596
2020-08-05,19235,12,1954,68,3,8,21280
2020-08-06,19187,23,2289,69,8,8,21584
2020-08-07,21703,16,2524,75,6,14,24338
2020-08-08,21886,17,1215,61,8,18,23205
2020-08-09,19562,22,537,69,8,15,20213
2020-08-10,20393,18,2246,66,7,11,22741
2020-08-11,18691,20,2048,73,9,4,20845
2020-08-12,18226,23,2328,58,6,9,20650
2020-08-13,20375,27,2585,69,13,9,23078
2020-08-14,23589,25,2367,72,5,13,26071
2020-08-15,21899,17,661,83,7,14,22681
2020-08-16,18611,21,549,63,7,11,19262
2020-08-17,18983,22,1989,146,8,9,21157
2020-08-18,16255,19,2174,58,7,6,18519
2020-08-19,16950,18,2303,52,4,7,19334
2020-08-20,16345,24,2168,57,8,7,18609
2020-08-21,16483,22,2606,73,9,10,19203
2020-08-22,16326,26,1016,83,9,13,17473
2020-08-23,16513,13,466,71,4,8,17075
2020-08-24,14378,16,2075,159,4,9,16641
2020-08-25,14343,19,2598,60,4,5,17029
2020-08-26,14754,19,2411,58,1,6,17249
2020-08-27,15691,18,2345,77,3,6,18140
2020-08-28,16692,25,2770,65,6,8,19566
2020-08-29,15496,24,1221,73,2,16,16832
2020-08-30,14008,15,489,66,0,11,14589
2020-08-31,15611,17,2117,71,5,5,17826
2020-09-01,14562,22,2507,50,2,4,17147
2020-09-02,14488,21,2623,41,1,7,17181
2020-09-03,15141,25,2576,59,2,7,17810
2020-09-04,15795,20,2565,58,6,9,18453
2020-09-05,16261,15,1291,60,1,13,17641
2020-09-06,13824,7,465,69,3,10,14378
2020-09-07,14250,13,2100,66,4,6,16439
2020-09-08,14413,25,2179,73,5,3,16698
2020-09-09,14222,27,2777,49,1,5,17081
2020-09-10,16096,20,2703,65,3,12,18899
2020-09-11,17714,21,2540,68,5,7,20355
2020-09-12,16328,29,1362,57,3,14,17793
2020-09-13,14679,18,480,62,3,3,15245
2020-09-14,15467,18,2059,69,4,5,17622
2020-09-15,14555,23,2339,64,1,5,16987
2020-09-16,14610,25,2634,57,6,5,17337
2020-09-17,15732,25,2645,60,4,4,18470
2020-09-18,17651,23,2628,76,7,5,20390
2020-09-19,16355,26,1203,48,2,12,17646
2020-09-20,14130,24,559,59,0,8,14780
2020-09-21,14815,16,2253,64,2,3,17153
2020-09-22,13957,25,2615,66,5,2,16670
2020-09-23,14141,24,2480,53,7,4,16709
2020-09-24,15545,21,2594,67,5,7,18239
2020-09-25,16692,20,2458,71,1,5,19247
2020-09-26,16052,25,1244,56,1,8,17386
2020-09-27,14130,24,449,56,2,7,14668
2020-09-28,14206,26,2136,66,3,6,16443
2020-09-29,15327,22,2532,47,4,2,17934
2020-09-30,16427,15,2628,66,2,3,19141
2020-10-01,18299,19,2476,56,9,3,20862
2020-10-02,22970,26,2808,71,2,6,25883
2020-10-03,18477,25,1483,49,2,4,20040
2020-10-04,15798,21,475,57,1,5,16357
2020-10-05,17114,17,2215,60,0,4,19410
2020-10-06,16351,26,2543,57,2,2,18981
2020-10-07,16655,24,2343,49,1,3,19075
2020-10-08,17771,21,2730,52,3,3,20580
2020-10-09,20242,17,2626,49,3,4,22941
2020-10-10,19449,22,1207,58,6,3,20745
2020-10-11,15664,10,510,63,2,3,16252
2020-10-12,17664,19,2152,62,7,2,19906
2020-10-13,17150,21,2243,53,3,2,19472
2020-10-14,16407,23,2774,54,3,2,19263
2020-10-15,16513,26,2598,53,1,2,19193
2020-10-16,19258,27,2804,72,7,3,22171
2020-10-17,18075,22,1221,55,3,3,19379
2020-10-18,14942,25,493,52,0,2,15514
2020-10-19,15583,26,2220,61,3,4,17897
2020-10-20,15696,13,2296,60,4,1,18070
2020-10-21,15404,25,2644,48,4,2,18127
2020-10-22,16637,23,2582,62,5,0,19309
2020-10-23,18863,26,2881,62,5,5,21842
2020-10-24,17174,23,1693,63,3,3,18959
2020-10-25,13880,21,472,38,1,1,14413
2020-10-26,14879,23,2107,62,5,4,17080
2020-10-27,13607,23,2409,47,1,0,16087
2020-10-28,13951,22,3207,55,3,2,17240
2020-10-29,15316,25,2341,47,2,1,17732
2020-10-30,19441,13,2732,66,3,5,22260
2020-10-31,16662,23,1306,49,3,4,18047
2020-11-01,14895,26,581,43,1,1,15547
2020-11-02,16783,24,2074,44,1,3,18929
2020-11-03,14869,23,2433,42,3,1,17371
2020-11-04,13532,26,3070,37,6,0,16671
2020-11-05,13880,26,2752,47,3,2,16710
2020-11-06,16833,16,2929,41,6,2,19827
2020-11-07,14259,8,1463,36,4,1,15771
2020-11-08,12153,25,431,36,3,1,12649
2020-11-09,13436,18,2258,57,4,3,15776
2020-11-10,13126,19,2407,45,3,1,15601
2020-11-11,13797,37,2850,39,4,0,16727
2020-11-12,13927,22,2801,38,4,1,16793
2020-11-13,16438,21,3237,62,5,2,19765
2020-11-14,14301,27,1342,28,4,1,15703
2020-11-15,11913,21,529,44,4,2,12513
2020-11-16,13654,22,2521,43,3,3,16246
2020-11-17,13222,15,2612,57,2,0,15908
2020-11-18,14837,16,1931,27,6,0,16817
2020-11-19,13777,22,2609,49,4,3,16464
2020-11-20,15197,16,3224,54,3,2,18496
2020-11-21,13014,19,1681,33,3,1,14751
2020-11-22,11381,23,508,36,2,2,11952
2020-11-23,13564,23,2342,46,4,3,15982
2020-11-24,12696,21,2720,42,3,0,15482
2020-11-25,13124,21,2822,46,10,1,16024
2020-11-26,13565,23,2819,40,3,1,16451
2020-11-27,15673,18,3457,41,4,3,19196
2020-11-28,12928,21,1364,28,6,2,14349
2020-11-29,11842,19,605,29,3,2,12500
2020-11-30,15769,6,2374,43,2,4,18198
2020-12-01,6825,19,2437,47,4,0,9332
2020-12-02,5799,17,2517,33,3,0,8369
2020-12-03,5827,18,2455,39,3,1,8343
2020-12-04,7999,16,2623,38,1,3,10680
2020-12-05,4555,18,1125,23,3,2,5726
2020-12-06,3167,22,323,26,2,1,3541
2020-12-07,5921,21,2360,32,2,3,8339
2020-12-08,5358,19,2000,39,4,0,7420
2020-12-09,5929,21,2268,37,4,1,8260
2020-12-10,6519,19,2691,40,4,2,9275
2020-12-11,7893,16,3369,43,3,3,11327
2020-12-12,4919,20,1196,22,5,1,6163
2020-12-13,3619,17,382,23,3,1,4045
2020-12-14,6007,21,2624,33,4,3,8692
2020-12-15,7030,14,2700,30,5,1,9780
2020-12-16,8110,22,2712,25,5,2,10876
2020-12-17,8537,17,2714,26,4,1,11299
2020-12-18,11581,20,3342,45,2,4,14994
2020-12-19,9370,24,1628,51,5,2,11080
2020-12-20,5470,17,508,41,6,2,6044
2020-12-21,7604,24,2446,42,3,3,10122
2020-12-22,6834,17,2007,37,3,1,8899
2020-12-23,8929,13,2625,40,7,2,11616
2020-12-24,6031,14,782,24,0,2,6853
2020-12-25,2487,14,210,10,0,0,2721
2020-12-26,2295,17,313,3,0,1,2629
2020-12-27,2626,23,223,12,1,2,2887
2020-12-28,4298,13,998,13,2,4,5328
2020-12-29,4847,15,1512,18,1,1,6394
2020-12-30,5786,19,1408,10,4,2,7229
2020-12-31,3838,15,636,13,2,1,4505
2021-01-01,2048,14,93,1,0,0,2156
2021-01-02,2954,16,287,8,0,1,3266
2021-01-03,3760,14,281,10,0,3,4068
2021-01-04,5592,10,1146,19,1,3,6771
2021-01-05,6114,13,1512,15,1,0,7655
2021-01-06,5408,16,866,17,1,0,6308
2021-01-07,6513,15,1639,22,4,3,8196
2021-01-08,6771,16,2210,24,2,2,9025
2021-01-09,5705,26,986,28,2,1,6748
2021-01-10,4960,18,450,32,0,3,5463
2021-01-11,6883,17,1939,28,1,3,8871
2021-01-12,6528,18,2264,20,1,0,8831
2021-01-13,6691,17,2548,17,12,0,9285
2021-01-14,6746,19,2582,19,1,2,9369
2021-01-15,9078,25,3190,28,1,2,12324
2021-01-16,6157,21,1038,28,5,3,7252
2021-01-17,4650,20,373,23,1,2,5069
2021-01-18,7184,10,2343,31,2,4,9574
2021-01-19,7552,21,2724,31,3,3,10334
2021-01-20,7754,18,2721,29,2,0,10524
2021-01-21,8136,16,2622,23,1,0,10798
2021-01-22,9005,25,3074,36,0,2,12142
2021-01-23,6308,22,1137,24,1,2,7494
2021-01-24,4637,21,385,30,0,1,5074
2021-01-25,6924,14,2355,25,1,1,9320
2021-01-26,7514,19,2834,21,2,1,10391
2021-01-27,7969,19,3014,27,6,3,11038
2021-01-28,9043,15,3001,26,3,2,12090
2021-01-29,10071,18,2746,30,2,3,12870
2021-01-30,6539,28,1360,27,2,3,7959
2021-01-31,4527,22,474,25,1,2,5051
2021-02-01,7533,14,2223,33,1,3,9807
2021-02-02,7725,16,2530,32,3,0,10306
2021-02-03,7893,24,2867,30,3,2,10819
2021-02-04,8981,16,3058,28,1,1,12085
2021-02-05,11281,14,3223,33,4,2,14557
2021-02-06,6789,21,1433,31,5,1,8280
2021-02-07,5321,22,391,23,0,1,5758
2021-02-08,7104,17,1883,27,1,4,9036
2021-02-09,8331,16,2544,28,0,0,10919
2021-02-10,8305,20,2854,24,1,2,11206
2021-02-11,9545,16,3237,30,2,3,12833
2021-02-12,11147,19,3095,39,0,1,14301
2021-02-13,6746,16,1308,24,2,1,8097
2021-02-14,5525,20,380,33,0,2,5960
2021-02-15,8450,17,2815,41,2,1,11326
2021-02-16,8119,21,2913,38,1,1,11093
2021-02-17,8802,15,2913,33,3,3,11769
2021-02-18,9394,21,2905,34,1,1,12356
2021-02-19,10868,18,3887,49,1,3,14826
2021-02-20,7436,17,1972,27,2,1,9455
2021-02-21,6317,16,703,25,0,2,7063
2021-02-22,8899,14,2552,37,2,3,11507
2021-02-23,8823,17,3153,37,1,1,12032
2021-02-24,9264,19,3177,26,8,2,12496
2021-02-25,9935,20,3054,33,0,2,13044
2021-02-26,12256,17,3076,36,2,4,15391
2021-02-27,7922,27,1535,30,1,2,9517
2021-02-28,6247,22,453,31,1,3,6757
2021-03-01,8846,16,2677,37,1,5,11582
2021-03-02,9146,15,2709,38,1,0,11909
2021-03-03,9336,16,2988,38,2,3,12383
2021-03-04,10408,15,3286,41,2,4,13756
2021-03-05,12048,15,3119,40,5,2,15229
2021-03-06,7394,18,1312,31,2,2,8759
2021-03-07,6027,20,421,27,1,4,6500
2021-03-08,9024,16,2714,42,3,4,11803
2021-03-09,8582,18,3052,42,3,1,11698
2021-03-10,9204,16,2869,35,4,2,12130
2021-03-11,9253,16,3533,42,4,4,12852
2021-03-12,12765,17,3391,42,0,3,16218
2021-03-13,6683,20,1498,30,6,1,8238
2021-03-14,4313,24,347,16,3,4,4707
2021-03-15,8143,19,2640,45,1,3,10851
2021-03-16,8654,19,3059,48,1,2,11783
2021-03-17,8630,20,3222,39,5,2,11918
2021-03-18,9904,21,3083,39,1,2,13050
2021-03-19,11740,23,3667,49,7,2,15488
2021-03-20,7669,19,1634,31,2,3,9358
2021-03-21,5332,24,407,32,1,3,5799
2021-03-22,8060,13,2686,41,0,5,10805
2021-03-23,8504,18,2936,50,3,0,11511
2021-03-24,8799,15,3191,29,3,3,12040
2021-03-25,9532,18,3246,41,2,3,12842
2021-03-26,12851,18,3477,40,2,2,16390
2021-03-27,11979,21,1552,42,4,1,13599
2021-03-28,5946,21,482,26,1,4,6480
2021-03-29,8676,17,2560,44,2,5,11304
2021-03-30,8886,14,3128,42,1,1,12072
2021-03-31,13854,13,3217,38,6,3,17131
2021-04-01,16345,13,3623,49,3,6,20039
2021-04-02,12821,13,2294,50,8,5,15191
2021-04-03,6462,20,788,38,3,1,7312
2021-04-04,3641,20,141,23,0,3,3828
2021-04-05,8744,15,644,23,0,5,9431
2021-04-06,9376,17,2066,40,2,1,11502
2021-04-07,9228,21,2688,29,6,1,11973
2021-04-08,10220,16,2760,32,2,3,13033
2021-04-09,12066,14,3703,26,4,6,15819
2021-04-10,8825,16,1570,42,5,2,10460
2021-04-11,6730,17,501,33,1,5,7287
2021-04-12,9118,11,2391,40,3,6,11569
2021-04-13,8745,17,3052,28,3,8,11853
2021-04-14,9644,17,3117,27,6,8,12819
2021-04-15,10108,16,3393,28,3,8,13556
2021-04-16,13267,22,3723,37,9,5,17063
2021-04-17,8327,17,1570,34,7,1,9956
2021-04-18,6284,19,490,27,0,5,6825
2021-04-19,9351,15,2787,26,3,6,12188
2021-04-20,9393,20,2902,32,3,2,12352
2021-04-21,10232,20,3190,25,5,1,13473
2021-04-22,10372,19,3139,27,3,4,13564
2021-04-23,13569,13,3368,33,1,8,16992
2021-04-24,9642,19,1649,39,13,3,11365
2021-04-25,7693,17,679,25,3,4,8421
2021-04-26,9605,14,2526,39,3,6,12193
2021-04-27,8385,20,2311,26,4,1,10747
2021-04-28,10802,20,3633,27,5,3,14490
2021-04-29,11538,16,3601,25,4,3,15187
2021-04-30,13592,15,3236,32,2,7,16884
2021-05-01,7829,22,659,40,3,5,8558
2021-05-02,7544,18,458,39,0,4,8063
2021-05-03,9816,17,2447,34,2,5,12321
2021-05-04,11014,18,2518,49,4,1,13604
2021-05-05,11185,18,2990,31,4,2,14230
2021-05-06,11491,18,3100,37,7,3,14656
2021-05-07,14486,13,3550,35,1,6,18091
2021-05-08,11044,20,1474,40,2,3,12583
2021-05-09,8841,15,451,28,1,4,9340
2021-05-10,10317,22,2467,44,2,8,12860
2021-05-11,10526,18,2964,43,5,0,13556
2021-05-12,15639,21,3060,43,4,2,18769
2021-05-13,15826,20,2940,53,6,4,18849
2021-05-14,12847,17,3097,50,2,6,16019
2021-05-15,10484,22,1422,31,12,4,11975
2021-05-16,11252,17,602,38,0,5,11914
2021-05-17,10817,20,2576,47,1,7,13468
2021-05-18,11219,15,3086,47,5,3,14375
2021-05-19,11268,22,3345,35,5,5,14680
2021-05-20,12648,20,3188,52,3,4,15915
2021-05-21,18197,17,3529,47,5,7,21802
2021-05-22,15495,16,1604,43,2,6,17166
2021-05-23,10171,24,660,35,1,5,10896
2021-05-24,11322,15,1995,53,2,7,13394
2021-05-25,10946,19,2866,48,2,2,13883
2021-05-26,11396,19,3373,47,6,5,14846
2021-05-27,12585,15,3042,58,6,5,15711
2021-05-28,16360,22,3223,60,2,9,19676
2021-05-29,13143,23,1631,42,8,5,14852
2021-05-30,10531,14,553,55,2,6,11161
2021-05-31,11741,15,2848,57,3,6,14670
2021-06-01,13065,17,2960,51,4,5,16102
2021-06-02,18408,21,3131,56,7,5,21628
2021-06-03,18582,16,2144,58,3,6,20809
2021-06-04,14838,13,3034,36,10,9,17940
2021-06-05,12693,20,1289,50,13,6,14071
2021-06-06,14027,19,572,49,3,9,14679
2021-06-07,13725,10,3080,76,7,8,16906
2021-06-08,13043,12,3032,67,8,3,16165
2021-06-09,13761,18,2775,61,7,6,16628
2021-06-10,14586,15,3416,61,10,6,18094
2021-06-11,19842,20,3535,75,9,12,23493
2021-06-12,14725,24,1741,49,7,8,16554
2021-06-13,12892,18,494,63,9,11,13487
2021-06-14,14722,5,2729,77,4,8,17545
2021-06-15,14685,19,2969,77,6,6,17762
2021-06-16,15920,16,3160,48,6,9,19159
2021-06-17,16290,15,3131,72,9,7,19524
2021-06-18,19153,16,3366,74,9,9,22627
2021-06-19,16311,21,1661,99,9,11,18112
2021-06-20,15361,20,668,85,4,10,16148
2021-06-21,15837,15,2442,74,6,9,18383
2021-06-22,18314,15,2227,69,8,5,20638
2021-06-23,16249,26,2831,60,8,13,19187
2021-06-24,18291,16,3151,59,10,10,21537
2021-06-25,18263,11,2577,87,7,13,20958
2021-06-26,16952,18,1425,125,6,12,18538
2021-06-27,16037,20,679,130,3,14,16883
2021-06-28,16285,12,2455,81,7,8,18848
2021-06-29,15248,20,2977,81,9,7,18342
2021-06-30,17101,18,2825,65,4,10,20023
2021-07-01,17332,22,3166,89,6,15,20630
2021-07-02,21895,19,3321,83,8,13,25339
2021-07-03,19938,18,1497,115,9,22,21599
2021-07-04,17332,21,613,102,8,18,18094
2021-07-05,16832,12,2679,91,5,12,19631
2021-07-06,16674,19,2443,77,13,8,19234
2021-07-07,16229,14,2871,73,7,15,19209
2021-07-08,19946,21,2921,86,12,10,22996
2021-07-09,22000,15,3363,91,7,15,25491
2021-07-10,19542,23,1333,101,7,17,21023
2021-07-11,17112,19,891,103,5,20,18150
2021-07-12,17677,13,2624,90,13,19,20436
2021-07-13,16802,24,3015,76,9,14,19940
2021-07-14,18382,15,2579,68,7,13,21064
2021-07-15,20557,16,3069,98,20,8,23768
2021-07-16,23052,18,2942,99,9,15,26135
2021-07-17,18789,15,1377,120,9,22,20332
2021-07-18,18906,19,666,98,12,17,19718
2021-07-19,19686,16,2035,95,7,12,21851
2021-07-20,18507,17,2880,92,13,11,21520
2021-07-21,19779,24,2798,91,8,13,22713
2021-07-22,20941,14,3081,88,12,9,24145
2021-07-23,22573,14,3313,100,5,19,26024
2021-07-24,21924,15,1373,115,12,22,23461
2021-07-25,19637,24,607,109,6,16,20399
2021-07-26,20092,22,2205,89,7,11,22426
2021-07-27,18546,20,2529,87,11,11,21204
2021-07-28,18243,19,2832,91,8,11,21204
2021-07-29,20834,18,3203,89,11,15,24170
2021-07-30,24443,21,3162,104,10,15,27755
2021-07-31,22087,17,1299,130,20,18,23571
2021-08-01,23782,16,786,108,18,17,24727
2021-08-02,23802,25,2321,102,11,11,26272
2021-08-03,20047,17,2780,80,7,7,22938
2021-08-04,20317,24,2758,90,10,15,23214
2021-08-05,24130,15,2455,97,6,11,26714
2021-08-06,22575,22,2476,123,12,14,25222
2021-08-07,22120,25,1205,123,9,21,23503
2021-08-08,23154,26,677,129,10,19,24015
2021-08-09,22777,25,2272,102,11,13,25200
2021-08-10,107390,21,2793,109,13,11,110337
2021-08-11,20616,17,2434,81,8,14,23170
2021-08-12,22707,8,2623,104,10,13,25465
2021-08-13,23645,12,2788,108,10,14,26577
2021-08-14,22347,10,1126,121,14,19,23637
2021-08-15,22163,25,567,133,11,18,22917
2021-08-16,23727,21,3119,104,10,13,26994
2021-08-17,19862,12,2605,96,12,7,22594
2021-08-18,19932,23,2507,103,12,12,22589
2021-08-19,20027,16,2828,87,13,13,22984
2021-08-20,21766,24,2578,102,10,17,24497
2021-08-21,21187,18,1150,146,12,20,22533
2021-08-22,20168,24,626,127,16,16,20977
2021-08-23,19559,18,2442,121,7,11,22158
2021-08-24,19193,23,2562,115,14,12,21919
2021-08-25,19058,19,2739,88,9,7,21920
2021-08-26,19656,15,3261,93,18,14,23057
2021-08-27,21055,24,3042,121,9,9,24260
2021-08-28,20778,18,1147,140,4,17,22104
2021-08-29,19082,22,677,155,7,18,19961
2021-08-30,19597,21,2521,113,6,14,22272
2021-08-31,18463,22,2955,105,7,11,21563
2021-09-01,19023,21,2618,97,4,17,21780
2021-09-02,20095,17,3222,114,5,10,23463
2021-09-03,22326,23,3430,113,10,17,25919
2021-09-04,21500,24,1514,128,3,19,23188
2021-09-05,19476,27,588,144,10,19,20264
2021-09-06,18498,22,2796,125,3,13,21457
2021-09-07,17878,22,2847,128,12,12,20899
2021-09-08,19344,19,2983,114,4,10,22474
2021-09-09,19921,19,3188,127,11,13,23279
2021-09-10,22441,15,3524,135,10,15,26140
2021-09-11,20608,20,1551,154,4,21,22358
2021-09-12,20018,18,877,147,5,11,21076
2021-09-13,18823,20,2567,137,2,16,21565
2021-09-14,18170,14,3215,111,5,11,21526
2021-09-15,18449,24,2966,109,5,13,21566
2021-09-16,19748,15,3364,118,15,8,23268
2021-09-17,21535,18,3125,147,11,14,24850
2021-09-18,20509,18,1553,132,6,18,22236
2021-09-19,19105,24,662,147,5,15,19958
2021-09-20,19722,8,2661,110,4,14,22519
2021-09-21,17945,19,3020,124,6,12,21126
2021-09-22,18140,20,2997,115,5,13,21290
2021-09-23,19843,22,3095,120,10,11,23101
2021-09-24,21530,15,3549,111,6,13,25224
2021-09-25,20253,26,1522,127,6,18,21952
2021-09-26,20048,20,720,172,9,15,20984
2021-09-27,17388,25,2349,119,5,11,19897
2021-09-28,16677,17,2805,109,6,11,19625
2021-09-29,16227,24,2895,130,8,12,19296
2021-09-30,18183,19,3278,112,6,8,21606
2021-10-01,20042,19,3371,118,9,14,23573
2021-10-02,18729,21,1635,121,5,17,20528
2021-10-03,18083,18,608,144,2,15,18870
2021-10-04,17025,22,2658,103,0,12,19820
2021-10-05,15646,21,2867,108,3,9,18654
2021-10-06,17143,17,2994,96,8,13,20271
2021-10-07,17352,19,3111,144,2,10,20638
2021-10-08,22214,16,3225,115,5,13,25588
2021-10-09,20983,17,1510,113,3,20,22646
2021-10-10,16733,22,593,142,11,18,17519
2021-10-11,17428,15,2568,119,6,12,20148
2021-10-12,18060,20,2716,107,6,11,20920
2021-10-13,61483,16,75685,1994,5,12,139195
2021-10-14,66077,19,82532,2186,3,10,150827
2021-10-15,21669,18,3703,116,4,13,25523
2021-10-16,20406,20,1464,117,2,14,22023
2021-10-17,19650,27,694,134,3,13,20521
2021-10-18,17350,16,2498,101,5,12,19982
2021-10-19,17347,20,2737,103,3,10,20220
2021-10-20,17128,22,3063,75,9,15,20312
2021-10-21,18451,19,3164,105,3,9,21751
2021-10-22,22706,16,3463,101,6,9,26301
2021-10-23,20081,26,1409,120,3,14,21653
2021-10-24,17978,28,654,143,1,15,18819
2021-10-25,18449,14,2799,99,5,9,21375
2021-10-26,16087,19,2682,88,6,13,18895
2021-10-27,17910,22,2901,98,16,11,20958
2021-10-28,20598,19,3258,88,4,11,23978
2021-10-29,26143,14,3648,95,4,9,29913
2021-10-30,23699,21,1633,92,6,6,25457
2021-10-31,20673,26,478,104,11,6,21298
2021-11-01,22882,18,756,77,0,6,23739
2021-11-02,20716,20,2620,62,1,17,23436
2021-11-03,18213,19,3097,51,6,8,21394
2021-11-04,17132,22,3099,92,3,9,20357
2021-11-05,19979,21,3370,68,9,6,23453
2021-11-06,17616,19,1893,89,3,7,19627
2021-11-07,15012,21,601,84,5,9,15732
2021-11-08,15484,21,2570,76,1,6,18158
2021-11-09,15031,14,2711,78,2,8,17844
2021-11-10,16847,23,3080,63,4,7,20024
2021-11-11,17749,22,3348,70,5,9,21203
2021-11-12,20254,21,3581,85,4,6,23951
2021-11-13,17701,19,1488,86,7,6,19307
2021-11-14,14670,22,537,93,1,9,15332
2021-11-15,15148,14,2392,72,3,8,17637
2021-11-16,14777,18,3110,92,2,9,18008
2021-11-17,16745,20,2963,71,5,7,19811
2021-11-18,20819,24,2529,72,3,7,23454
2021-11-19,19736,20,3515,69,5,8,23353
2021-11-20,17514,22,1454,86,3,3,19082
2021-11-21,18307,21,625,94,4,7,19058
2021-11-22,15990,22,2377,74,4,10,18477
2021-11-23,15520,24,2871,67,4,7,18493
2021-11-24,15584,17,3094,64,7,8,18774
2021-11-25,16330,16,3055,77,3,7,19488
2021-11-26,18576,21,3580,77,1,8,22263
2021-11-27,15285,20,1349,64,2,6,16726
2021-11-28,13095,22,559,100,1,7,13784
2021-11-29,14769,15,2728,68,4,8,17592
2021-11-30,15113,22,3014,67,3,8,18227
2021-12-01,15430,19,2804,60,3,8,18324
2021-12-02,17422,20,2949,72,3,7,20473
2021-12-03,18909,17,3208,83,2,9,22228
2021-12-04,16447,21,1647,74,7,6,18202
2021-12-05,13585,21,491,85,9,8,14199
2021-12-06,15599,15,2618,80,4,8,18324
2021-12-07,15956,25,3192,73,6,8,19260
2021-12-08,16136,23,2741,63,6,8,18977
2021-12-09,16056,25,2323,60,3,9,18476
2021-12-10,19506,21,3072,76,3,9,22687
2021-12-11,16671,14,1566,79,2,7,18339
2021-12-12,14457,22,546,114,1,9,15149
2021-12-13,15311,12,2531,80,3,8,17945
2021-12-14,15682,17,2846,72,5,7,18629
2021-12-15,16783,17,2776,58,4,7,19645
2021-12-16,19695,23,3227,77,3,9,23034
2021-12-17,21879,21,3396,80,2,8,25386
2021-12-18,24746,21,1546,99,2,8,26422
2021-12-19,17999,15,608,115,2,7,18746
2021-12-20,17977,28,3045,71,2,8,21131
2021-12-21,19164,17,2905,81,3,8,22178
2021-12-22,24074,24,3189,88,2,7,27384
2021-12-23,27337,15,3054,84,4,7,30501
2021-12-24,19463,24,1515,72,4,6,21084
2021-12-25,10271,19,202,27,0,0,10519
2021-12-26,14934,19,390,66,0,8,15417
2021-12-27,18285,14,1636,54,2,8,19999
2021-12-28,18602,27,1629,64,4,8,20334
2021-12-29,17543,16,1726,63,3,9,19360
2021-12-30,19718,17,1505,85,2,10,21337
2021-12-31,12917,18,590,44,3,5,13577
2022-01-01,10127,22,207,31,2,5,10394
2022-01-02,17901,13,532,96,0,6,18548
2022-01-03,16700,20,1481,76,2,8,18287
2022-01-04,16915,11,1639,62,5,7,18639
2022-01-05,19003,18,1854,50,1,7,20933
2022-01-06,15859,18,947,78,0,7,16909
2022-01-07,16587,17,1512,84,4,8,18212
2022-01-08,18327,18,944,91,1,7,19388
2022-01-09,19764,21,785,115,2,7,20694
2022-01-10,15592,21,2019,81,0,8,17721
2022-01-11,13934,20,2382,58,0,6,16400
2022-01-12,14878,17,2546,57,1,6,17505
2022-01-13,15366,22,2889,67,3,7,18354
2022-01-14,18269,20,3180,71,3,9,21552
2022-01-15,17477,19,1214,74,2,6,18792
2022-01-16,15677,25,569,128,0,7,16406
2022-01-17,15207,22,2517,61,4,7,17818
2022-01-18,15454,17,2689,61,2,8,18231
2022-01-19,15458,22,2736,52,4,8,18280
2022-01-20,15773,22,2977,63,3,6,18844
2022-01-21,18611,23,3257,71,0,9,21971
2022-01-22,17121,18,1182,56,1,6,18384
2022-01-23,14896,20,643,85,2,10,15656
2022-01-24,14112,25,2366,77,1,7,16588
2022-01-25,13957,24,2782,56,3,7,16829
2022-01-26,14937,17,2741,48,3,9,17755
2022-01-27,16099,25,2590,61,3,6,18784
2022-01-28,17108,19,3124,65,3,7,20326
2022-01-29,17278,23,1126,60,3,7,18497
2022-01-30,16032,20,590,74,1,7,16724
2022-01-31,15395,18,2628,69,3,7,18120
2022-02-01,15371,21,2693,72,1,6,18164
2022-02-02,15492,25,2470,46,4,8,18045
2022-02-03,17341,20,2883,53,4,6,20307
2022-02-04,19962,23,2589,69,1,6,22650
2022-02-05,19567,21,1690,69,1,7,21355
2022-02-06,16364,26,660,73,5,7,17135
2022-02-07,16061,18,2699,65,0,7,18850
2022-02-08,14694,18,1791,59,4,4,16570
2022-02-09,16587,27,2863,46,4,6,19533
2022-02-10,17711,21,3015,63,1,5,20816
2022-02-11,20135,17,3383,66,4,7,23612
2022-02-12,20007,18,1347,75,3,5,21455
2022-02-13,18489,27,702,103,2,8,19331
2022-02-14,17406,19,2576,65,5,8,20079
2022-02-15,16497,25,2630,54,1,6,19213
2022-02-16,16760,26,2994,52,5,6,19843
2022-02-17,19203,19,3415,61,3,5,22706
2022-02-18,20411,19,3239,73,4,9,23755
2022-02-19,20424,21,1472,87,4,8,22016
2022-02-20,18430,24,640,94,2,8,19198
2022-02-21,18723,22,2730,58,4,8,21545
2022-02-22,17917,29,2980,57,3,6,20992
2022-02-23,19441,19,3303,59,4,9,22835
2022-02-24,20271,22,3042,60,3,6,23404
2022-02-25,24234,27,3529,69,5,7,27871
2022-02-26,21477,12,1472,85,5,7,23058
2022-02-27,19434,12,664,149,0,8,20267
2022-02-28,17288,10,2620,83,2,9,20012
2022-03-01,16243,27,2738,80,2,2,19092
2022-03-02,16532,23,3068,60,7,7,19697
2022-03-03,18466,23,3487,67,6,7,22056
2022-03-04,21409,23,3557,82,4,9,25084
2022-03-05,20227,24,1387,82,3,6,21729
2022-03-06,17475,25,603,132,2,7,18244
2022-03-07,18850,21,2580,88,4,8,21551
2022-03-08,15587,17,2791,73,4,7,18479
2022-03-09,16134,11,3092,79,4,7,19327
2022-03-10,18015,23,3459,79,5,6,21587
2022-03-11,19368,25,3925,100,6,7,23431
2022-03-12,19999,9,1410,1079,6,7,22510
2022-03-13,17922,11,677,123,1,7,18741
2022-03-14,17556,12,2951,86,4,7,20616
2022-03-15,16920,24,3023,76,6,6,20055
2022-03-16,16735,24,3190,77,7,6,20039
2022-03-17,19050,17,3227,72,10,7,22383
2022-03-18,19119,19,4086,94,8,7,23333
2022-03-19,20779,18,1410,101,5,7,22320
2022-03-20,18368,17,662,104,2,7,19160
2022-03-21,15925,20,2781,94,5,6,18831
2022-03-22,15528,15,3200,85,4,7,18839
2022-03-23,15786,19,3461,80,8,7,19361
2022-03-24,17541,23,3460,87,6,6,21123
2022-03-25,20434,20,3359,99,2,7,23921
2022-03-26,19902,26,1579,117,6,8,21638
2022-03-27,18246,22,624,147,1,7,19047
2022-03-28,16182,18,2796,89,7,9,19101
2022-03-29,16459,19,3242,82,5,10,19817
2022-03-30,16571,25,3381,70,6,7,20060
2022-03-31,18610,21,3558,83,7,8,22287
2022-04-01,21158,21,3477,103,2,10,24771
2022-04-02,19325,11,1388,100,3,7,20834
2022-04-03,15994,26,630,143,1,7,16801
2022-04-04,17233,21,3328,91,3,8,20684
2022-04-05,16478,17,3246,84,8,7,19840
2022-04-06,16971,9,2891,79,9,8,19967
2022-04-07,19075,22,3694,94,9,8,22902
2022-04-08,21503,22,3795,97,4,8,25429
2022-04-09,26902,18,1583,109,13,8,28633
2022-04-10,19318,22,684,199,4,10,20237
2022-04-11,18849,22,3164,84,2,8,22129
2022-04-12,19376,21,3316,103,2,9,22827
2022-04-13,22555,22,3506,94,6,7,26190
2022-04-14,28744,23,3993,106,11,9,32886
2022-04-15,27926,20,2204,106,8,10,30274
2022-04-16,19555,20,1019,94,4,10,20702
2022-04-17,14181,27,241,76,0,7,14532
2022-04-18,32619,23,864,126,2,8,33642
2022-04-19,22431,17,2824,88,8,12,25380
2022-04-20,21605,20,3139,90,8,7,24869
2022-04-21,21132,27,3429,110,8,8,24714
2022-04-22,22852,21,3665,104,4,7,26653
2022-04-23,22782,12,1764,155,5,11,24729
2022-04-24,20301,20,688,182,3,8,21202
2022-04-25,19168,22,2816,131,5,8,22150
2022-04-26,19433,21,3162,125,6,11,22758
2022-04-27,19430,25,2632,94,13,9,22203
2022-04-28,20462,21,4144,112,7,6,24752
2022-04-29,27784,21,3525,150,7,7,31494
2022-04-30,24637,20,1561,144,4,10,26376
2022-05-01,19898,24,652,179,4,8,20765
2022-05-02,17469,18,1517,136,6,12,19158
2022-05-03,19080,22,2737,129,7,6,21981
2022-05-04,19468,21,3038,100,7,13,22647
2022-05-05,21342,25,3538,126,10,10,25051
2022-05-06,24347,21,3377,135,7,12,27899
2022-05-07,23496,25,1492,163,4,12,25192
2022-05-08,21899,20,737,179,1,8,22844
2022-05-09,20151,19,3161,156,5,8,23500
2022-05-10,19844,24,3179,142,7,11,23207
2022-05-11,20417,16,3022,139,3,10,23607
2022-05-12,22066,11,3530,134,6,8,25755
2022-05-13,24417,25,3847,125,6,10,28430
2022-05-14,25087,14,1434,160,6,13,26714
2022-05-15,24454,14,662,182,2,9,25323
2022-05-16,20457,15,2827,154,4,13,23470
2022-05-17,19979,15,3520,149,8,10,23681
2022-05-18,20268,19,3276,131,3,12,23709
2022-05-19,21888,22,3164,146,13,10,25243
2022-05-20,23551,21,3629,129,4,11,27345
2022-05-21,24896,19,1618,183,5,12,26733
2022-05-22,24064,23,665,208,3,11,24974
2022-05-23,20842,19,2668,157,8,10,23704
2022-05-24,19956,19,3287,129,8,8,23407
2022-05-25,22221,20,3477,160,12,13,25903
2022-05-26,29089,21,3284,156,10,9,32569
2022-05-27,22185,29,3317,142,11,14,25698
2022-05-28,21357,14,1564,180,4,14,23133
2022-05-29,20006,11,571,187,1,12,20788
2022-05-30,32465,19,1967,201,7,11,34670
2022-05-31,19991,22,3132,148,10,10,23313
2022-06-01,19743,20,3410,126,9,17,23325
2022-06-02,21699,14,3197,147,9,13,25079
2022-06-03,22420,23,3160,144,8,19,25774
2022-06-04,24807,19,1643,209,3,21,26702
2022-06-05,23316,24,703,216,7,11,24277
2022-06-06,23267,14,2409,180,10,16,25896
2022-06-07,18949,19,2927,148,6,12,22061
2022-06-08,19652,20,3134,138,6,16,22966
2022-06-09,21453,23,2835,154,12,11,24488
2022-06-10,24526,19,3457,176,8,23,28209
2022-06-11,23404,19,1706,221,10,25,25385
2022-06-12,22455,22,707,178,5,23,23390
2022-06-13,21232,16,2635,178,11,15,24087
2022-06-14,19219,25,2884,151,11,17,22307
2022-06-15,24978,21,3053,144,6,18,28220
2022-06-16,28590,20,2180,170,10,19,30989
2022-06-17,23831,21,2932,155,9,20,26968
2022-06-18,24223,11,1621,178,9,20,26062
2022-06-19,24546,11,727,289,7,18,25598
2022-06-20,21080,6,2665,186,11,21,23969
2022-06-21,19737,26,2842,173,4,16,22798
2022-06-22,25417,26,2576,175,376,16,28586
2022-06-23,20141,21,2866,156,15,9,23208
2022-06-24,25014,20,3468,164,15,22,28703
2022-06-25,25063,20,1745,229,5,23,27085
2022-06-26,23980,16,775,246,12,23,25052
2022-06-27,21582,17,2716,163,11,22,24511
2022-06-28,19136,9,2723,167,10,15,22060
2022-06-29,19820,14,2773,148,6,19,22780
2022-06-30,21157,20,3002,140,9,13,24341
2022-07-01,24079,18,3218,174,11,21,27521
2022-07-02,24238,19,999,189,10,22,25477
2022-07-03,22772,26,632,194,5,22,23651
2022-07-04,21856,18,2506,159,11,19,24569
2022-07-05,19838,15,2768,154,12,16,22803
2022-07-06,19962,15,3004,128,5,20,23134
2022-07-07,22724,21,2765,156,13,18,25697
2022-07-08,29419,14,3180,128,7,20,32768
2022-07-09,25966,16,1127,184,9,25,27327
2022-07-10,23248,16,687,194,8,25,24178
2022-07-11,22409,20,2620,180,5,19,25253
2022-07-12,22109,20,2943,166,12,13,25263
2022-07-13,22848,19,2838,128,10,18,25861
2022-07-14,24938,8,3094,174,12,15,28241
2022-07-15,26089,25,3126,165,13,24,29442
2022-07-16,28397,14,1231,158,12,25,29837
2022-07-17,24561,32,670,185,7,23,25478
2022-07-18,22156,15,2291,169,10,24,24665
2022-07-19,20091,13,2818,154,7,19,23102
2022-07-20,23194,10,2660,155,9,24,26052
2022-07-21,22507,11,3105,133,14,20,25790
2022-07-22,25861,17,3224,176,9,24,29311
2022-07-23,26469,17,1340,173,7,21,28027
2022-07-24,21518,18,679,182,10,25,22432
2022-07-25,23142,14,2541,162,16,18,25893
2022-07-26,22599,12,2597,149,12,21,25390
2022-07-27,22164,14,2899,140,8,17,25242
2022-07-28,23878,16,2647,114,13,14,26682
2022-07-29,33503,13,3269,126,15,23,36949
2022-07-30,27090,18,1031,147,11,24,28321
2022-07-31,25365,18,664,155,12,23,26237
2022-08-01,24694,21,2138,129,8,20,27010
2022-08-02,23510,12,2476,119,11,18,26146
2022-08-03,21958,16,2456,121,6,17,24574
2022-08-04,23149,12,2371,133,11,33,25709
2022-08-05,28376,19,1940,142,21,22,30520
2022-08-06,26622,11,990,194,8,22,27847
2022-08-07,26651,13,599,186,6,25,27480
2022-08-08,23119,12,2040,140,8,35,25354
2022-08-09,22845,17,2336,135,8,19,25360
2022-08-10,23663,12,2159,133,5,19,25991
2022-08-11,23796,29,2609,118,12,23,26587
2022-08-12,27127,15,2252,140,9,38,29581
2022-08-13,26528,18,1120,141,8,27,27842
2022-08-14,23773,13,470,187,11,22,24476
2022-08-15,25907,12,916,139,11,21,27006
2022-08-16,24665,6,2200,126,8,25,27030
2022-08-17,22743,19,2064,108,7,31,24972
2022-08-18,21263,17,2464,116,10,20,23890
2022-08-19,23157,14,2353,132,15,20,25691
2022-08-20,22280,21,1166,158,12,22,23659
2022-08-21,22288,19,543,161,8,45,23064
2022-08-22,22213,20,2233,138,8,22,24634
2022-08-23,19261,24,2242,136,12,19,21694
2022-08-24,18820,14,2411,120,5,18,21388
2022-08-25,21505,23,2191,133,9,41,23902
2022-08-26,22503,31,2961,135,10,38,25678
2022-08-27,22798,21,991,168,6,21,24005
2022-08-28,21303,15,556,188,9,18,22089
2022-08-29,19417,24,2163,127,5,33,21769
2022-08-30,18661,22,2323,125,7,18,21156
2022-08-31,19092,18,2834,119,12,11,22086
2022-09-01,21749,9,2484,118,12,21,24393
2022-09-02,23708,22,2683,110,10,43,26576
2022-09-03,25096,20,1177,172,4,33,26502
2022-09-04,21985,14,625,207,9,24,22864
2022-09-05,18678,23,2259,133,8,25,21126
2022-09-06,18868,15,2141,141,14,40,21219
2022-09-07,17524,16,2538,143,11,34,20266
2022-09-08,21564,17,2474,153,10,37,24255
2022-09-09,21049,13,2529,143,12,25,23771
2022-09-10,23065,16,1327,139,9,22,24578
2022-09-11,22228,18,585,208,5,21,23065
2022-09-12,19444,12,2092,169,6,20,21743
2022-09-13,17056,14,2447,159,10,35,19721
2022-09-14,17352,14,2352,146,9,20,19893
2022-09-15,20498,19,3072,161,9,20,23779
2022-09-16,21947,14,2718,174,9,23,24885
2022-09-17,23446,19,1360,161,1,24,25011
2022-09-18,20589,18,663,197,9,20,21496
2022-09-19,19842,19,2339,179,4,21,22404
2022-09-20,18556,14,2621,160,9,19,21379
2022-09-21,18124,17,2511,133,0,31,20816
2022-09-22,19518,17,2207,146,16,18,21922
2022-09-23,21026,21,2952,156,10,22,24187
2022-09-24,24139,16,1464,164,4,7,25794
2022-09-25,20542,11,548,256,1,20,21378
2022-09-26,19519,14,2456,173,11,39,22212
2022-09-27,17315,19,2830,144,3,13,20324
2022-09-28,18429,21,2704,142,9,15,21320
2022-09-29,19431,20,2948,137,1,25,22562
2022-09-30,22711,13,3417,142,2,19,26304
2022-10-01,22189,22,1473,180,5,19,23888
2022-10-02,22308,12,646,223,3,17,23209
2022-10-03,18424,15,2288,133,2,13,20875
2022-10-04,17623,19,2611,118,4,32,20407
2022-10-05,17867,22,2685,124,7,13,20718
2022-10-06,18500,15,3139,128,7,13,21802
2022-10-07,20977,23,3311,148,6,40,24505
2022-10-08,23958,16,1718,187,8,18,25905
2022-10-09,22345,19,853,225,11,17,23470
2022-10-10,17772,15,2558,158,13,16,20532
2022-10-11,17437,15,2704,126,6,32,20320
2022-10-12,18201,20,2863,122,6,16,21228
2022-10-13,19641,12,3607,136,8,12,23416
2022-10-14,22360,18,3002,141,5,15,25541
2022-10-15,23543,15,1553,196,5,41,25353
2022-10-16,22583,23,624,212,4,13,23459
2022-10-17,18367,19,2645,155,3,13,21202
2022-10-18,16679,16,2519,116,3,10,19343
2022-10-19,17611,15,2469,106,9,15,20225
2022-10-20,19092,18,2834,119,12,11,22086
2022-10-21,20611,19,3306,143,4,15,24098
2022-10-22,21907,7,1276,184,1,15,23390
2022-10-23,21384,12,619,252,6,34,22307
2022-10-24,18366,17,2469,128,3,13,20996
2022-10-25,18774,16,2312,110,3,31,21246
2022-10-26,19050,18,2343,98,5,12,21526
2022-10-27,19260,16,2683,111,3,30,22103
2022-10-28,26624,22,3535,126,4,16,30327
2022-10-29,25299,22,1562,167,5,12,27067
2022-10-30,24144,8,533,133,2,9,24829
2022-10-31,23409,18,1419,117,3,29,24995
2022-11-01,26768,23,1063,93,3,8,27958
2022-11-02,20210,22,2304,88,6,13,22643
2022-11-03,18888,13,2459,88,6,10,21464
2022-11-04,20030,27,3011,93,1,13,23175
