,Cestovni,Željeznički,Riječni,Pomorski,Zračni,UKUPNO
2013-01-01,23581,334,0,27,590,24532
2013-01-02,46762,687,0,26,1291,48766
2013-01-03,52199,694,0,63,973,53929
2013-01-04,55030,604,0,65,987,56686
2013-01-05,81207,636,0,1,1005,82849
2013-01-06,51806,664,0,119,1464,54053
2013-01-07,42417,525,0,0,1555,44497
2013-01-08,39574,514,0,4,1120,41212
2013-01-09,42015,410,0,8,1246,43679
2013-01-10,48294,342,0,88,990,49714
2013-01-11,48729,364,0,1,874,49968
2013-01-12,53323,318,0,3,816,54460
2013-01-13,38382,366,0,60,1125,39933
2013-01-14,33271,328,0,0,1184,34783
2013-01-15,36315,300,0,0,951,37566
2013-01-16,39406,314,0,0,1033,40753
2013-01-17,35126,307,0,86,778,36297
2013-01-18,38579,317,0,0,903,39799
2013-01-19,47190,329,0,6,719,48244
2013-01-20,35888,355,0,60,895,37198
2013-01-21,40266,340,0,0,1090,41696
2013-01-22,37813,332,0,0,1015,39160
2013-01-23,39106,336,0,44,968,40454
2013-01-24,37881,373,0,55,836,39145
2013-01-25,41377,332,0,1,1073,42783
2013-01-26,45961,408,0,0,840,47209
2013-01-27,38081,388,0,48,1030,39547
2013-01-28,39423,357,0,8,1020,40808
2013-01-29,37240,345,0,3,859,38447
2013-01-30,40261,381,0,11,901,41554
2013-01-31,44407,319,0,42,578,45346
2013-02-01,47797,374,0,0,757,48928
2013-02-02,52707,377,0,1,615,53700
2013-02-03,39579,421,0,48,1023,41071
2013-02-04,42258,369,0,12,1239,43878
2013-02-05,39331,372,0,1,916,40620
2013-02-06,36014,373,0,31,941,37359
2013-02-07,41303,303,0,93,770,42469
2013-02-08,1394692,365,0,1,780,1395838
2013-02-09,54102,357,0,0,556,55015
2013-02-10,36651,447,0,55,848,38001
2013-02-11,44582,288,0,2,1126,45998
2013-02-12,35796,357,0,0,1142,37295
2013-02-13,35591,306,0,4,966,36867
2013-02-14,37341,414,0,47,985,38787
2013-02-15,44310,350,0,29,924,45613
2013-02-16,55885,317,0,0,750,56952
2013-02-17,37792,304,0,75,1091,39262
2013-02-18,39808,290,0,10,1200,41308
2013-02-19,40576,322,0,21,1024,41943
2013-02-20,38394,312,0,40,953,39699
2013-02-21,38127,374,0,61,903,39465
2013-02-22,41568,409,0,0,1045,43022
2013-02-23,43265,346,0,7,696,44314
2013-02-24,37654,420,0,78,1077,39229
2013-02-25,40603,386,0,13,1167,42169
2013-02-26,38493,360,0,7,1034,39894
2013-02-27,39720,362,0,9,1008,41099
2013-02-28,43209,307,0,128,1146,44790
2013-03-01,49637,357,0,4,1166,51164
2013-03-02,57288,360,0,0,735,58383
2013-03-03,44256,340,0,40,1113,45749
2013-03-04,46845,267,0,6,1318,48436
2013-03-05,42235,296,0,4,1337,43872
2013-03-06,43212,234,0,15,1087,44548
2013-03-07,44609,325,0,53,997,45984
2013-03-08,53013,354,0,4,957,54328
2013-03-09,61104,286,0,1,777,62168
2013-03-10,39942,378,0,46,1134,41500
2013-03-11,44523,274,0,6,1185,45988
2013-03-12,43119,334,0,52,1144,44649
2013-03-13,41763,279,0,6,1202,43250
2013-03-14,39051,309,0,45,1081,40486
2013-03-15,47131,319,0,2,1096,48548
2013-03-16,62159,278,0,2,754,63193
2013-03-17,42880,407,0,85,979,44351
2013-03-18,43504,282,0,0,1387,45173
2013-03-19,42866,278,0,31,198,43373
2013-03-20,43589,285,0,45,1171,45090
2013-03-21,47246,453,0,174,45,47918
2013-03-22,49647,525,0,9,1246,51427
2013-03-23,65927,398,0,22,1275,67622
2013-03-24,46769,380,0,203,1635,48987
2013-03-25,41692,367,0,0,1360,43419
2013-03-26,41950,328,0,53,1043,43374
2013-03-27,54756,439,0,20,1154,56369
2013-03-28,56729,479,0,44,1975,59227
2013-03-29,58048,551,0,175,1375,60149
2013-03-30,54466,442,0,137,685,55730
2013-03-31,36004,231,0,125,734,37094
2013-04-01,52355,456,0,33,1375,54219
2013-04-02,47674,409,0,112,1976,50171
2013-04-03,42580,341,0,40,1420,44381
2013-04-04,48394,332,0,63,1434,50223
2013-04-05,53303,336,0,53,1220,54912
2013-04-06,62234,462,0,11,1143,63850
2013-04-07,49022,441,0,85,1707,51255
2013-04-08,43596,296,0,32,1604,45528
2013-04-09,47029,389,0,62,1382,48862
2013-04-10,46336,400,0,39,1324,48099
2013-04-11,47110,462,0,68,1342,48982
2013-04-12,53811,477,0,47,302,54637
2013-04-13,62969,402,0,12,1059,64442
2013-04-14,47242,638,0,56,1456,49392
2013-04-15,50562,451,15,33,1525,52586
2013-04-16,44054,317,0,68,1324,45763
2013-04-17,48122,352,2,80,1292,49848
2013-04-18,53634,363,0,62,1508,55567
2013-04-19,57352,418,1,51,1087,58909
2013-04-20,66144,307,0,57,1333,67841
2013-04-21,53144,433,0,98,1295,54970
2013-04-22,49631,371,0,47,1190,51239
2013-04-23,47837,338,0,43,1464,49682
2013-04-24,51119,266,0,18,1119,52522
2013-04-25,51124,445,0,42,1287,52898
2013-04-26,61038,480,0,54,1201,62773
2013-04-27,66477,633,0,10,1119,68239
2013-04-28,51438,398,0,86,1098,53020
2013-04-29,56852,421,0,29,1026,58328
2013-04-30,64412,492,0,32,1194,66130
2013-05-01,51570,472,0,61,1365,53468
2013-05-02,48102,382,0,53,980,49517
2013-05-03,58539,461,0,41,1037,60078
2013-05-04,68504,521,0,23,792,69840
2013-05-05,49321,431,0,107,1102,50961
2013-05-06,52982,425,0,16,1322,54745
2013-05-07,51974,361,30,63,1206,53634
2013-05-08,48012,367,2,34,921,49336
2013-05-09,57887,375,0,48,1066,59376
2013-05-10,58332,421,0,47,1064,59864
2013-05-11,71239,423,0,72,838,72572
2013-05-12,54956,440,0,67,1100,56563
2013-05-13,47162,450,0,41,1696,49349
2013-05-14,49945,396,0,65,1293,51699
2013-05-15,49961,393,0,75,1217,51646
2013-05-16,54756,408,0,33,1292,56489
2013-05-17,58509,431,0,44,857,59841
2013-05-18,68380,437,0,44,815,69676
2013-05-19,54852,549,0,78,1119,56598
2013-05-20,62816,548,0,73,1348,64785
2013-05-21,49022,484,0,73,1284,50863
2013-05-22,54000,581,0,63,1201,55845
2013-05-23,52524,495,0,43,1116,54178
2013-05-24,62575,542,0,131,937,64185
2013-05-25,66800,427,0,32,855,68114
2013-05-26,49833,411,0,80,1160,51484
2013-05-27,51520,411,0,46,1347,53324
2013-05-28,53442,483,0,87,1144,55156
2013-05-29,56839,434,0,94,1020,58387
2013-05-30,70931,301,0,25,1519,72776
2013-05-31,63377,393,0,81,983,64834
2013-06-01,64861,422,0,87,820,66190
2013-06-02,51038,498,0,69,1081,52686
2013-06-03,52072,419,0,79,1574,54144
2013-06-04,49489,458,0,83,1254,51284
2013-06-05,52208,419,0,53,1115,53795
2013-06-06,49587,475,0,61,290,50413
2013-06-07,61239,383,0,107,1192,62921
2013-06-08,67607,421,0,27,772,68827
2013-06-09,55126,433,0,86,1002,56647
2013-06-10,51021,460,0,48,1285,52814
2013-06-11,51063,439,0,56,1150,52708
2013-06-12,51815,444,0,138,1150,53547
2013-06-13,59147,479,0,57,878,60561
2013-06-14,65583,570,0,81,1017,67251
2013-06-15,69797,510,0,44,853,71204
2013-06-16,55853,411,0,118,1349,57731
2013-06-17,57006,460,0,49,1241,58756
2013-06-18,53095,540,0,75,1355,55065
2013-06-19,53696,542,0,94,1187,55519
2013-06-20,54503,447,0,83,1452,56485
2013-06-21,68790,607,0,167,1017,70581
2013-06-22,86671,648,0,61,1195,88575
2013-06-23,61115,566,0,199,938,62818
2013-06-24,65511,602,0,69,1420,67602
2013-06-25,69730,512,0,83,1245,71570
2013-06-26,54183,533,0,107,1045,55868
2013-06-27,56504,416,0,54,632,57606
2013-06-28,61638,480,0,141,860,63119
2013-06-29,71060,554,0,43,4000595,4072252
2013-06-30,56961,748,0,113,1120,58942
2013-07-01,53478,667,0,65,1473,55683
2013-07-02,52400,361,0,85,1702,54548
2013-07-03,53451,244,0,86,672,54453
2013-07-04,56126,323,0,74,783,57306
2013-07-05,63805,395,0,103,947,65250
2013-07-06,74630,265,0,48,700,75643
2013-07-07,58745,253,0,464,1361,60823
2013-07-08,62035,398,0,78,1070,63581
2013-07-09,53847,420,0,117,1038,55422
2013-07-10,56146,408,0,122,867,57543
2013-07-11,61533,342,0,105,893,62873
2013-07-12,64485,187,0,51,779,65502
2013-07-13,68762,378,0,79,832,70051
2013-07-14,61080,515,0,117,886,62598
2013-07-15,62031,320,0,57,1077,63485
2013-07-16,52968,346,0,95,1034,54443
2013-07-17,57005,349,0,118,987,58459
2013-07-18,65018,285,0,79,1047,66429
2013-07-19,66604,336,0,77,836,67853
2013-07-20,74459,443,0,87,906,75895
2013-07-21,58620,574,0,163,1100,60457
2013-07-22,65432,358,0,96,946,66832
2013-07-23,54150,232,0,102,904,55388
2013-07-24,56702,358,0,151,894,58105
2013-07-25,62537,466,0,111,1073,64187
2013-07-26,69241,616,0,96,1348,71301
2013-07-27,65837,452,0,64,792,67145
2013-07-28,60737,375,0,218,978,62308
2013-07-29,59945,417,0,108,1110,61580
2013-07-30,59917,464,0,136,1179,61696
2013-07-31,56066,369,0,77,807,57319
2013-08-01,66118,500,0,121,864,67603
2013-08-02,72407,438,0,135,1038,74018
2013-08-03,77196,583,0,103,752,78634
2013-08-04,63628,303,0,194,864,64989
2013-08-05,72806,446,0,107,832,74191
2013-08-06,59076,406,0,108,1027,60617
2013-08-07,61145,378,0,147,1066,62736
2013-08-08,62178,399,0,106,938,63621
2013-08-09,63917,423,0,51,631,65022
2013-08-10,78874,574,0,84,958,80490
2013-08-11,63497,652,0,165,927,65241
2013-08-12,61542,523,0,91,897,63053
2013-08-13,62944,365,0,86,780,64175
2013-08-14,74006,577,0,74,1045,75702
2013-08-15,70299,669,0,86,1627,72681
2013-08-16,71323,397,0,103,793,72616
2013-08-17,77671,527,0,102,725,79025
2013-08-18,75581,393,0,609,1123,77706
2013-08-19,61355,397,0,67,1109,62928
2013-08-20,64010,406,0,84,775,65275
2013-08-21,61521,338,0,125,1033,63017
2013-08-22,63464,383,0,284,1120,65251
2013-08-23,66331,425,0,99,846,67701
2013-08-24,69668,364,0,121,665,70818
2013-08-25,59266,275,0,202,1021,60764
2013-08-26,62758,328,0,73,1428,64587
2013-08-27,58615,594,0,142,1270,60621
2013-08-28,58955,320,0,75,914,60264
2013-08-29,61298,423,1,105,1111,62938
2013-08-30,63627,562,0,127,1146,65462
2013-08-31,75172,485,0,101,725,76483
2013-09-01,54500,391,0,193,851,55935
2013-09-02,60695,339,0,73,1144,62251
2013-09-03,59027,335,1,109,1026,60498
2013-09-04,54218,365,0,95,837,55515
2013-09-05,62955,268,0,130,843,64196
2013-09-06,62014,318,0,127,977,63436
2013-09-07,81790,457,0,66,1269,83582
2013-09-08,56243,514,0,119,1134,58010
2013-09-09,55463,355,0,76,1401,57295
2013-09-10,54780,288,0,112,877,56057
2013-09-11,57081,321,0,83,818,58303
2013-09-12,57228,298,0,74,1193,58793
2013-09-13,66103,529,0,68,955,67655
2013-09-14,77530,406,0,100,676,78712
2013-09-15,63872,363,0,99,673,65007
2013-09-16,56082,287,0,65,1199,57633
2013-09-17,56158,322,0,65,978,57523
2013-09-18,54313,318,0,111,1318,56060
2013-09-19,64208,334,0,105,738,65385
2013-09-20,65293,272,0,89,1264,66918
2013-09-21,74045,375,0,72,1205,75697
2013-09-22,59320,416,0,120,1056,60912
2013-09-23,61086,399,0,134,1174,62793
2013-09-24,50166,398,0,145,884,51593
2013-09-25,51451,354,0,148,283,52236
2013-09-26,62237,324,0,65,751,63377
2013-09-27,64006,380,0,98,910,65394
2013-09-28,67878,218,0,156,1112,69364
2013-09-29,60104,304,0,108,764,61280
2013-09-30,54032,283,0,38,870,55223
2013-10-01,56651,292,0,74,1346,58363
2013-10-02,54472,263,0,109,256,55100
2013-10-03,60863,274,0,117,1369,62623
2013-10-04,65555,372,0,66,1096,67089
2013-10-05,78650,296,0,146,1256,80348
2013-10-06,60661,296,0,1177,965,63099
2013-10-07,61381,284,0,133,929,62727
2013-10-08,77242,286,0,31,869,78428
2013-10-09,53062,293,0,88,1062,54505
2013-10-10,57627,306,0,138,1137,59208
2013-10-11,67870,277,0,84,902,69133
2013-10-12,75204,372,0,181,765,76522
2013-10-13,59284,411,0,123,1114,60932
2013-10-14,54756,334,0,75,959,56124
2013-10-15,53860,250,0,120,1503,55733
2013-10-16,57210,309,0,44,829,58392
2013-10-17,58844,331,0,114,1101,60390
2013-10-18,62961,282,0,68,787,64098
2013-10-19,71391,340,0,19,923,72673
2013-10-20,56468,359,0,112,794,57733
2013-10-21,53234,253,0,14,1251,54752
2013-10-22,53000,212,0,69,920,54201
2013-10-23,50591,267,0,36,1100,51994
2013-10-24,53067,239,0,103,1054,54463
2013-10-25,63601,316,0,29,1245,65191
2013-10-26,67578,352,0,44,717,68691
2013-10-27,57158,443,0,138,667,58406
2013-10-28,52879,258,0,19,837,53993
2013-10-29,55917,348,0,49,834,57148
2013-10-30,64286,373,0,10,791,65460
2013-10-31,77168,565,0,134,847,78714
2013-11-01,87390,555,0,27,1131,89103
2013-11-02,74517,294,0,5,593,75409
2013-11-03,55373,395,0,140,880,56788
2013-11-04,55399,293,0,4,928,56624
2013-11-05,49828,297,0,3,1027,51155
2013-11-06,51334,234,0,27,621,52216
2013-11-07,54830,218,0,82,626,55756
2013-11-08,66016,303,0,11,745,67075
2013-11-09,60321,233,0,1,529,61084
2013-11-10,51999,320,0,79,748,53146
2013-11-11,47560,281,0,0,912,48753
2013-11-12,48625,177,0,33,776,49611
2013-11-13,51554,275,0,0,735,52564
2013-11-14,54777,230,0,80,696,55783
2013-11-15,58763,214,0,2,929,59908
2013-11-16,62390,243,0,29,469,63131
2013-11-17,49521,267,0,153,868,50809
2013-11-18,50103,302,0,5,1217,51627
2013-11-19,52095,261,0,0,630,52986
2013-11-20,48197,259,0,42,46,48544
2013-11-21,50565,243,0,32,135,50975
2013-11-22,58081,342,0,4,260,58687
2013-11-23,59733,267,0,5,1020,61025
2013-11-24,49154,275,0,163,1041,50633
2013-11-25,49262,265,0,0,933,50460
2013-11-26,48247,267,0,0,852,49366
2013-11-27,45797,179,0,2,1121,47099
2013-11-28,48679,213,0,147,630,49669
2013-11-29,56952,366,0,17,734,58069
2013-11-30,59422,322,0,1,780,60525
2013-12-01,43629,316,0,101,623,44669
2013-12-02,47892,271,0,0,696,48859
2013-12-03,47207,216,0,10,480,47913
2013-12-04,44001,209,3396,53,548,48207
2013-12-05,1101408,272,0,63,507,1102250
2013-12-06,54854,281,0,0,395,55530
2013-12-07,60418,252,0,0,549,61219
2013-12-08,48428,442,0,103,828,49801
2013-12-09,48879,157,0,0,823,49859
2013-12-10,47186,292,0,74,1040,48592
2013-12-11,51594,222,0,12,893,52721
2013-12-12,54253,286,0,73,492,55104
2013-12-13,54690,254,0,0,1133,56077
2013-12-14,69231,200,0,5,626,70062
2013-12-15,47287,282,0,126,644,48339
2013-12-16,47934,225,0,11,537,48707
2013-12-17,50847,198,0,8,248,51301
2013-12-18,50254,264,0,72,613,51203
2013-12-19,57309,302,0,59,777,58447
2013-12-20,60256,337,0,2,472,61067
2013-12-21,72864,278,0,1,662,73805
2013-12-22,47375,299,0,63,871,48608
2013-12-23,61106,375,0,4,812,62297
2013-12-24,52671,281,0,2,374,53328
2013-12-25,31730,141,0,0,191,32062
2013-12-26,48175,292,0,33,68,48568
2013-12-27,60963,587,0,0,865,62415
2013-12-28,60023,504,0,119,1116,61762
2013-12-29,46818,675,0,55,893,48441
2013-12-30,67095,918,0,155,551,68719
2013-12-31,49155,443,0,0,394,49992
2014-01-01,28845,428,0,0,424,29697
2014-01-02,55749,260,0,61,522,56592
2014-01-03,60378,528,0,41,958,61905
2014-01-04,89908,459,0,1,902,91270
2014-01-05,54470,525,0,121,1060,56176
2014-01-06,52547,229,0,3,1215,53994
2014-01-07,45110,182,0,2,951,46245
2014-01-08,52924,235,0,15,907,54081
2014-01-09,49598,250,0,106,283,50237
2014-01-10,55454,180,0,4,795,56433
2014-01-11,62872,325,0,0,754,63951
2014-01-12,45543,452,0,92,895,46982
2014-01-13,46285,173,0,2,707,47167
2014-01-14,48029,179,0,0,684,48892
2014-01-15,45585,281,0,13,924,46803
2014-01-16,49674,279,0,55,464,50472
2014-01-17,51353,290,0,2,537,52182
2014-01-18,61219,256,0,0,568,62043
2014-01-19,41573,303,0,57,822,42755
2014-01-20,47937,235,0,7,620,48799
2014-01-21,48436,187,0,18,765,49406
2014-01-22,48216,240,0,7,559,49022
2014-01-23,45986,207,0,34,491,46718
2014-01-24,47939,231,0,0,408,48578
2014-01-25,44631,221,0,0,613,45465
2014-01-26,37241,250,0,91,729,38311
2014-01-27,42743,254,0,11,319,43327
2014-01-28,40382,147,0,0,713,41242
2014-01-29,39008,170,0,30,885,40093
2014-01-30,43253,202,0,50,448,43953
2014-01-31,45787,357,0,2,568,46714
2014-02-01,49104,268,0,0,691,50063
2014-02-02,33614,119,0,52,735,34520
2014-02-03,43328,197,0,0,767,44292
2014-02-04,39747,200,0,0,674,40621
2014-02-05,45334,279,0,23,750,46386
2014-02-06,44546,171,0,88,472,45277
2014-02-07,49989,139,0,0,637,50765
2014-02-08,50643,219,0,0,737,51599
2014-02-09,42464,223,0,99,892,43678
2014-02-10,47169,200,0,1,655,48025
2014-02-11,48636,190,0,1,566,49393
2014-02-12,48488,264,0,54,784,49590
2014-02-13,50179,188,0,61,893,51321
2014-02-14,54197,304,0,2,715,55218
2014-02-15,62808,254,0,1,504,63567
2014-02-16,47872,195,0,92,510,48669
2014-02-17,47144,240,0,0,785,48169
2014-02-18,47123,212,0,5,575,47915
2014-02-19,49100,179,0,4,781,50064
2014-02-20,50774,264,0,79,603,51720
2014-02-21,52285,274,0,57,695,53311
2014-02-22,60745,311,0,1,511,61568
2014-02-23,49968,178,0,49,770,50965
2014-02-24,48468,211,0,1,880,49560
2014-02-25,44246,286,0,20,755,45307
2014-02-26,46505,222,0,34,598,47359
2014-02-27,47321,227,0,74,937,48559
2014-02-28,56875,263,0,5,622,57765
2014-03-01,75184,267,0,0,639,76090
2014-03-02,50063,359,0,50,981,51453
2014-03-03,53552,254,0,9,704,54519
2014-03-04,43158,193,0,0,844,44195
2014-03-05,46462,238,0,10,1141,47851
2014-03-06,51961,264,0,41,739,53005
2014-03-07,58291,174,0,35,709,59209
2014-03-08,65513,283,0,0,727,66523
2014-03-09,49879,225,0,59,1041,51204
2014-03-10,50829,168,0,0,1134,52131
2014-03-11,48851,172,0,0,1205,50228
2014-03-12,48404,258,0,42,941,49645
2014-03-13,51515,321,0,75,51,51962
2014-03-14,57912,304,0,9,810,59035
2014-03-15,66552,171,0,1,531,67255
2014-03-16,56601,203,0,46,612,57462
2014-03-17,50609,268,0,0,1189,52066
2014-03-18,49990,234,0,50,694,50968
2014-03-19,53206,199,0,13,974,54392
2014-03-20,53555,218,0,176,626,54575
2014-03-21,57920,262,0,4,652,58838
2014-03-22,64631,242,0,2,599,65474
2014-03-23,52953,307,0,171,987,54418
2014-03-24,51686,296,0,1,983,52966
2014-03-25,49926,255,0,48,976,51205
2014-03-26,52373,168,0,32,722,53295
2014-03-27,48186,200,0,49,913,49348
2014-03-28,57708,184,0,9,506,58407
2014-03-29,64997,173,0,8,790,65968
2014-03-30,55284,315,0,55,777,56431
2014-03-31,51867,186,0,16,778,52847
2014-04-01,52133,218,0,58,1156,53565
2014-04-02,49165,255,0,15,836,50271
2014-04-03,60073,314,0,81,695,61163
2014-04-04,57953,243,0,2,680,58878
2014-04-05,68092,193,1,2,1033,69321
2014-04-06,53540,254,0,54,874,54722
2014-04-07,56032,243,0,8,1197,57480
2014-04-08,51175,232,0,34,1070,52511
2014-04-09,56260,215,0,45,655,57175
2014-04-10,55272,290,0,104,872,56538
2014-04-11,64175,342,0,29,1020,65566
2014-04-12,75417,284,0,12,1229,76942
2014-04-13,60985,275,0,374,535,62169
2014-04-14,56882,247,0,34,1188,58351
2014-04-15,63632,177,0,72,1077,64958
2014-04-16,64656,322,0,5,192,65175
2014-04-17,71022,213,0,83,1613,72931
2014-04-18,67311,338,0,96,840,68585
2014-04-19,69356,302,0,73,924,70655
2014-04-20,43933,301,0,141,563,44938
2014-04-21,59961,335,0,14,1252,61562
2014-04-22,59499,266,0,134,1754,61653
2014-04-23,58382,340,0,39,810,59571
2014-04-24,62188,236,0,135,1264,63823
2014-04-25,68666,307,0,54,1064,70091
2014-04-26,86070,299,0,22,1040,87431
2014-04-27,100803,315,0,133,1087,102338
2014-04-28,60205,289,0,30,990,61514
2014-04-29,60594,283,0,118,1227,62222
2014-04-30,65480,385,0,48,511,66424
2014-05-01,56505,389,0,74,2274,59242
2014-05-02,66941,334,0,29,1149,68453
2014-05-03,70226,325,0,33,1080,71664
2014-05-04,59692,295,0,97,874,60958
2014-05-05,57635,225,0,33,1211,59104
2014-05-06,55079,195,0,65,1571,56910
2014-05-07,57849,247,0,70,1062,59228
2014-05-08,56263,306,0,31,368,56968
2014-05-09,66003,211,0,66,891,67171
2014-05-10,72260,274,0,4,1361,73899
2014-05-11,56802,263,0,76,1181,58322
2014-05-12,55971,209,0,15,332,56527
2014-05-13,59199,297,0,66,1265,60827
2014-05-14,57493,329,0,30,832,58684
2014-05-15,55019,222,0,57,1165,56463
2014-05-16,56540,294,0,93,1235,58162
2014-05-17,69269,275,0,42,710,70296
2014-05-18,50224,244,0,58,790,51316
2014-05-19,51748,252,0,50,1098,53148
2014-05-20,46352,232,0,44,1108,47736
2014-05-21,52558,196,0,74,896,53724
2014-05-22,52361,317,0,44,810,53532
2014-05-23,58601,220,0,68,901,59790
2014-05-24,63405,318,0,16,873,64612
2014-05-25,59236,186,0,112,982,60516
2014-05-26,54845,170,0,10,1033,56058
2014-05-27,53443,189,0,72,1443,55147
2014-05-28,51150,195,0,71,672,52088
2014-05-29,53891,196,0,56,904,55047
2014-05-30,61929,204,0,70,857,63060
2014-05-31,67509,217,0,56,916,68698
2014-06-01,57427,350,0,37,959,58773
2014-06-02,60290,291,0,80,810,61471
2014-06-03,52897,294,0,73,369,53633
2014-06-04,56595,251,0,73,842,57761
2014-06-05,55349,344,0,155,781,56629
2014-06-06,65457,309,0,43,868,66677
2014-06-07,68996,227,2,16,1297,70538
2014-06-08,56984,283,0,70,859,58196
2014-06-09,56319,323,0,51,717,57410
2014-06-10,57712,236,0,66,1427,59441
2014-06-11,53614,344,0,75,830,54863
2014-06-12,56458,252,0,87,819,57616
2014-06-13,56637,339,0,39,1136,58151
2014-06-14,72698,279,0,36,1221,74234
2014-06-15,59208,515,0,94,1116,60933
2014-06-16,64134,328,0,33,1272,65767
2014-06-17,54351,453,0,96,861,55761
2014-06-18,63071,247,0,122,933,64373
2014-06-19,74810,334,0,96,1042,76282
2014-06-20,64912,295,0,94,1061,66362
2014-06-21,72568,350,0,51,1629,74598
2014-06-22,64849,424,0,104,1068,66445
2014-06-23,58286,256,0,30,1244,59816
2014-06-24,62797,349,0,103,1158,64407
2014-06-25,65691,290,0,63,1445,67489
2014-06-26,65300,458,0,93,1204,67055
2014-06-27,66291,439,0,59,1234,68023
2014-06-28,71694,352,0,63,1544,73653
2014-06-29,60782,279,0,106,976,62143
2014-06-30,61786,274,0,31,1404,63495
2014-07-01,56934,349,0,80,1093,58456
2014-07-02,59596,449,0,93,1039,61177
2014-07-03,64792,281,0,66,1139,66278
2014-07-04,68671,460,0,67,947,70145
2014-07-05,75870,360,0,30,1087,77347
2014-07-06,65738,397,0,118,1201,67454
2014-07-07,67888,286,0,61,992,69227
2014-07-08,66834,354,0,86,1135,68409
2014-07-09,63578,290,0,91,1258,65217
2014-07-10,68929,473,0,71,1173,70646
2014-07-11,69395,376,0,60,1015,70846
2014-07-12,76653,563,0,52,944,78212
2014-07-13,59080,392,0,227,1062,60761
2014-07-14,62820,347,1,47,1236,64451
2014-07-15,66202,332,2,72,1545,68153
2014-07-16,67980,461,0,121,1270,69832
2014-07-17,66855,356,4,65,1347,68627
2014-07-18,73844,415,0,135,1197,75591
2014-07-19,81381,421,0,51,1398,83251
2014-07-20,70659,483,0,92,1075,72309
2014-07-21,72559,431,0,51,1042,74083
2014-07-22,58971,389,0,62,1036,60458
2014-07-23,61816,366,0,128,1159,63469
2014-07-24,67763,382,0,157,1061,69363
2014-07-25,74817,334,0,85,827,76063
2014-07-26,74700,432,0,64,944,76140
2014-07-27,65369,560,0,103,1058,67090
2014-07-28,66187,297,0,66,979,67529
2014-07-29,66759,381,0,59,1053,68252
2014-07-30,62968,369,0,86,1164,64587
2014-07-31,69958,498,0,108,1329,71893
2014-08-01,76875,497,0,129,1333,78834
2014-08-02,132959,419,0,77,965,134420
2014-08-03,66262,537,0,126,1272,68197
2014-08-04,65677,491,0,37,978,67183
2014-08-05,74027,430,0,113,1059,75629
2014-08-06,69743,311,0,120,1121,71295
2014-08-07,63348,354,0,147,980,64829
2014-08-08,71889,344,0,125,862,73220
2014-08-09,81753,421,0,75,1196,83445
2014-08-10,70274,329,0,109,1195,71907
2014-08-11,72913,412,0,53,1230,74608
2014-08-12,63847,353,0,108,1166,65474
2014-08-13,70128,475,0,143,1053,71799
2014-08-14,85751,446,0,55,1529,87781
2014-08-15,82927,387,0,105,985,84404
2014-08-16,77458,411,0,51,1135,79055
2014-08-17,72238,579,0,159,1109,74085
2014-08-18,74114,281,0,77,1282,75754
2014-08-19,63841,374,0,89,874,65178
2014-08-20,64063,370,0,162,1467,66062
2014-08-21,77166,449,0,69,954,78638
2014-08-22,67203,283,0,141,1050,68677
2014-08-23,78924,522,0,54,1058,80558
2014-08-24,64844,544,0,250,1167,66805
2014-08-25,69350,413,0,82,1359,71204
2014-08-26,62374,335,0,180,1405,64294
2014-08-27,62264,375,0,100,1255,63994
2014-08-28,68152,379,0,179,1877,70587
2014-08-29,73905,396,0,86,1004,75391
2014-08-30,75054,451,0,66,1044,76615
2014-08-31,63366,451,0,85,1287,65189
2014-09-01,59766,444,0,86,1744,62040
2014-09-02,69540,333,0,74,1085,71032
2014-09-03,65275,354,0,60,1058,66747
2014-09-04,63265,294,0,85,1012,64656
2014-09-05,69022,296,0,143,950,70411
2014-09-06,82312,336,0,58,1187,83893
2014-09-07,61208,407,0,62,943,62620
2014-09-08,60974,338,0,67,1248,62627
2014-09-09,57480,286,0,78,1060,58904
2014-09-10,61746,336,0,135,830,63047
2014-09-11,67195,325,0,49,969,68538
2014-09-12,65768,397,0,90,1050,67305
2014-09-13,72758,347,0,41,883,74029
2014-09-14,70135,339,0,88,913,71475
2014-09-15,62572,333,0,50,1003,63958
2014-09-16,55661,281,0,78,988,57008
2014-09-17,56156,295,0,148,805,57404
2014-09-18,63531,288,0,45,711,64575
2014-09-19,67123,317,0,95,1112,68647
2014-09-20,76928,316,0,70,1481,78795
2014-09-21,58206,358,0,91,1092,59747
2014-09-22,60821,289,0,60,1065,62235
2014-09-23,56477,277,0,71,1065,57890
2014-09-24,63308,254,0,118,1273,64953
2014-09-25,59177,279,0,67,646,60169
2014-09-26,64588,329,0,252,1066,66235
2014-09-27,77877,321,0,66,1332,79596
2014-09-28,64286,354,0,143,1077,65860
2014-09-29,57493,237,0,10,1062,58802
2014-09-30,57388,261,0,75,607,58331
2014-10-01,58036,465,0,122,518,59141
2014-10-02,62438,219,0,134,934,63725
2014-10-03,64916,396,0,43,931,66286
2014-10-04,77108,302,0,264,1194,78868
2014-10-05,58847,271,0,86,1118,60322
2014-10-06,60533,306,0,32,1362,62233
2014-10-07,59465,219,0,73,789,60546
2014-10-08,79789,288,0,56,1204,81337
2014-10-09,60058,293,1,115,1501,61968
2014-10-10,69995,309,0,28,1072,71404
2014-10-11,75496,234,0,195,1191,77116
2014-10-12,67452,298,0,84,940,68774
2014-10-13,58454,261,0,14,1315,60044
2014-10-14,57889,199,0,94,922,59104
2014-10-15,58027,223,0,24,1016,59290
2014-10-16,60438,218,0,98,1040,61794
2014-10-17,67457,363,0,9,1059,68888
2014-10-18,77941,541,0,25,1042,79549
2014-10-19,56846,319,0,153,932,58250
2014-10-20,57286,251,0,23,967,58527
2014-10-21,57272,341,0,53,1315,58981
2014-10-22,54457,309,0,28,1224,56018
2014-10-23,54141,222,0,147,1050,55560
2014-10-24,62412,231,0,27,1022,63692
2014-10-25,72702,306,0,3,1098,74109
2014-10-26,56904,366,0,91,886,58247
2014-10-27,54795,237,1,24,862,55919
2014-10-28,57058,250,0,93,1087,58488
2014-10-29,59844,291,1,29,628,60793
2014-10-30,64242,321,0,72,337,64972
2014-10-31,76439,270,0,7,611,77327
2014-11-01,84197,286,0,28,468,84979
2014-11-02,67165,513,0,79,573,68330
2014-11-03,58094,222,0,20,811,59147
2014-11-04,52817,310,0,0,1106,54233
2014-11-05,53408,303,0,0,1014,54725
2014-11-06,58091,254,0,42,508,58895
2014-11-07,64493,244,0,49,590,65376
2014-11-08,67467,221,0,29,683,68400
2014-11-09,49697,243,0,71,718,50729
2014-11-10,54622,181,0,7,706,55516
2014-11-11,55725,248,0,0,1138,57111
2014-11-12,53449,209,0,0,821,54479
2014-11-13,50899,259,0,113,633,51904
2014-11-14,68746,320,0,10,570,69646
2014-11-15,70076,263,0,0,952,71291
2014-11-16,55984,274,0,58,1012,57328
2014-11-17,53947,190,0,2,943,55082
2014-11-18,53313,179,0,0,843,54335
2014-11-19,54178,200,0,54,636,55068
2014-11-20,53882,178,0,69,728,54857
2014-11-21,61280,346,0,12,518,62156
2014-11-22,64257,275,0,6,652,65190
2014-11-23,49725,216,0,64,775,50780
2014-11-24,53341,132,0,17,570,54060
2014-11-25,49440,202,0,9,611,50262
2014-11-26,55822,153,0,12,609,56596
2014-11-27,53780,200,0,68,590,54638
2014-11-28,61061,256,0,8,712,62037
2014-11-29,62231,253,0,0,536,63020
2014-11-30,50363,267,0,82,859,51571
2014-12-01,51229,148,0,0,985,52362
2014-12-02,50841,311,0,5,686,51843
2014-12-03,51655,262,0,0,735,52652
2014-12-04,51119,225,0,39,696,52079
2014-12-05,56801,217,0,18,648,57684
2014-12-06,65426,267,0,4,455,66152
2014-12-07,44905,288,0,50,758,46001
2014-12-08,56844,232,0,4,833,57913
2014-12-09,50899,238,0,0,168,51305
2014-12-10,51696,191,0,35,155,52077
2014-12-11,57113,245,0,69,574,58001
2014-12-12,59362,245,0,4,481,60092
2014-12-13,79291,283,0,2,491,80067
2014-12-14,52320,477,0,58,1177,54032
2014-12-15,55923,287,0,13,640,56863
2014-12-16,56229,240,0,0,712,57181
2014-12-17,57676,293,0,4,669,58642
2014-12-18,61034,264,0,85,640,62023
2014-12-19,68175,330,0,8,693,69206
2014-12-20,77045,494,0,0,770,78309
2014-12-21,56607,451,0,68,751,57877
2014-12-22,67376,337,0,4,306,68023
2014-12-23,73461,292,0,6,769,74528
2014-12-24,62266,420,0,0,816,63502
2014-12-25,35947,158,0,0,142,36247
2014-12-26,58484,596,0,0,943,60023
2014-12-27,69227,618,0,4,949,70798
2014-12-28,34343,743,0,91,1165,36342
2014-12-29,50050,608,0,26,798,51482
2014-12-30,66175,1012,0,0,802,67989
2014-12-31,51723,565,0,0,450,52738
2015-01-01,28720,194,0,42,513,29469
2015-01-02,73909,230,0,0,869,75008
2015-01-03,91773,442,0,5,644,92864
2015-01-04,62004,478,0,119,1318,63919
2015-01-05,62853,409,0,0,688,63950
2015-01-06,63760,255,0,2,813,64830
2015-01-07,50254,367,0,0,728,51349
2015-01-08,57271,317,0,63,446,58097
2015-01-09,64472,258,0,6,966,65702
2015-01-10,83146,233,0,0,335,83714
2015-01-11,53725,163,0,54,922,54864
2015-01-12,52568,159,0,9,714,53450
2015-01-13,56202,245,0,34,1149,57630
2015-01-14,48845,220,0,5,708,49778
2015-01-15,53593,169,0,76,259,54097
2015-01-16,52655,255,0,0,732,53642
2015-01-17,60251,221,0,0,387,60859
2015-01-18,43234,175,0,56,910,44375
2015-01-19,45802,173,0,10,740,46725
2015-01-20,45078,120,0,5,758,45961
2015-01-21,43465,133,0,7,665,44270
2015-01-22,46388,141,0,45,613,47187
2015-01-23,49270,182,0,0,766,50218
2015-01-24,55385,165,0,0,533,56083
2015-01-25,37378,204,0,43,790,38415
2015-01-26,43028,145,0,3,766,43942
2015-01-27,44128,174,0,14,943,45259
2015-01-28,44730,244,0,19,767,45760
2015-01-29,44112,171,0,33,586,44902
2015-01-30,47018,173,0,0,770,47961
2015-01-31,53894,167,0,0,287,54348
2015-02-01,37364,163,0,53,727,38307
2015-02-02,45381,212,0,10,963,46566
2015-02-03,46399,137,0,5,623,47164
2015-02-04,42883,183,0,0,505,43571
2015-02-05,41953,231,0,36,596,42816
2015-02-06,37275,174,0,1,609,38059
2015-02-07,41803,134,0,0,431,42368
2015-02-08,38223,180,0,1,1037,39441
2015-02-09,43596,164,0,89,636,44485
2015-02-10,45018,225,0,22,615,45880
2015-02-11,45949,139,0,42,699,46829
2015-02-12,50288,251,0,68,650,51257
2015-02-13,58627,253,0,2,765,59647
2015-02-14,61389,242,0,2,553,62186
2015-02-15,47055,161,0,78,974,48268
2015-02-16,50831,161,0,0,754,51746
2015-02-17,49112,148,0,0,720,49980
2015-02-18,46748,210,0,11,772,47741
2015-02-19,49194,180,0,60,557,49991
2015-02-20,55580,248,0,11,703,56542
2015-02-21,59540,197,0,0,475,60212
2015-02-22,44085,284,0,101,713,45183
2015-02-23,49723,201,0,9,1103,51036
2015-02-24,47375,138,0,8,670,48191
2015-02-25,47518,188,1,18,762,48487
2015-02-26,48704,200,0,64,666,49634
2015-02-27,53940,212,0,7,761,54920
2015-02-28,62201,248,0,4,612,63065
2015-03-01,48555,260,0,78,1010,49903
2015-03-02,50879,228,0,13,612,51732
2015-03-03,46555,110,0,4,901,47570
2015-03-04,49054,187,0,10,796,50047
2015-03-05,45966,246,0,0,800,47012
2015-03-06,51757,766,0,0,600,53123
2015-03-07,62029,219,0,0,685,62933
2015-03-08,52130,303,0,68,954,53455
2015-03-09,49211,133,0,1,769,50114
2015-03-10,48616,116,0,10,794,49536
2015-03-11,49347,85,0,46,824,50302
2015-03-12,54389,206,0,47,572,55214
2015-03-13,58133,213,0,33,537,58916
2015-03-14,69970,185,0,3,652,70810
2015-03-15,55884,179,0,48,717,56828
2015-03-16,52208,158,0,0,784,53150
2015-03-17,50267,85,0,31,1352,51735
2015-03-18,51398,119,0,30,760,52307
2015-03-19,57856,208,0,46,707,58817
2015-03-20,58446,273,0,0,751,59470
2015-03-21,65236,255,0,0,609,66100
2015-03-22,51533,143,0,56,1030,52762
2015-03-23,52629,199,0,91,902,53821
2015-03-24,52137,195,0,44,833,53209
2015-03-25,51657,164,0,3,961,52785
2015-03-26,56585,259,0,133,903,57880
2015-03-27,57111,305,0,43,902,58361
2015-03-28,69737,250,0,10,989,70986
2015-03-29,53950,222,0,350,887,55409
2015-03-30,59241,230,0,43,979,60493
2015-03-31,55060,176,0,41,915,56192
2015-04-01,64012,208,0,96,1165,65481
2015-04-02,68627,219,0,61,1132,70039
2015-04-03,88622,273,0,24,1513,90432
2015-04-04,79654,229,0,0,522,80405
2015-04-05,50321,211,0,51,1017,51600
2015-04-06,80347,337,0,250,1027,81961
2015-04-07,67808,253,0,80,1741,69882
2015-04-08,58674,168,0,54,763,59659
2015-04-09,53973,232,0,85,1150,55440
2015-04-10,68201,295,0,6,1050,69552
2015-04-11,66341,256,0,16,1613,68226
2015-04-12,52736,209,0,76,1018,54039
2015-04-13,53977,294,0,43,1049,55363
2015-04-14,55023,187,0,42,1089,56341
2015-04-15,54794,193,0,44,1414,56445
2015-04-16,57797,186,0,61,993,59037
2015-04-17,65789,242,0,11,538,66580
2015-04-18,71109,186,0,19,1058,72372
2015-04-19,64297,217,0,67,1866,66447
2015-04-20,55666,209,0,28,1036,56939
2015-04-21,54950,198,0,62,1204,56414
2015-04-22,56400,240,0,62,1003,57705
2015-04-23,57964,158,0,30,1639,59791
2015-04-24,65849,257,0,15,497,66618
2015-04-25,75292,215,0,35,793,76335
2015-04-26,56346,282,0,94,865,57587
2015-04-27,56740,225,0,39,1614,58618
2015-04-28,59288,260,0,24,705,60277
2015-04-29,61084,219,0,65,945,62313
2015-04-30,78502,539,0,33,1255,80329
2015-05-01,63860,340,0,37,1349,65586
2015-05-02,72191,249,0,23,985,73448
2015-05-03,70434,424,0,102,1185,72145
2015-05-04,62004,303,0,35,1687,64029
2015-05-05,54421,188,0,57,1591,56257
2015-05-06,63233,263,0,43,1343,64882
2015-05-07,60844,247,0,48,426,61565
2015-05-08,66841,237,0,56,891,68025
2015-05-09,73410,221,0,53,1993,75677
2015-05-10,59291,295,0,60,1082,60728
2015-05-11,62901,225,0,56,1389,64571
2015-05-12,57424,211,0,49,1130,58814
2015-05-13,58327,317,0,61,1509,60214
2015-05-14,65160,220,0,44,1014,66438
2015-05-15,72312,231,0,37,1322,73902
2015-05-16,93530,307,0,28,1206,95071
2015-05-17,61767,314,0,84,1962,64127
2015-05-18,89395,163,0,26,1539,91123
2015-05-19,57293,166,0,98,1203,58760
2015-05-20,55539,209,0,21,1243,57012
2015-05-21,55471,143,0,36,1283,56933
2015-05-22,71008,156,0,27,1600,72791
2015-05-23,74870,228,0,43,930,76071
2015-05-24,54384,173,0,73,1303,55933
2015-05-25,68724,148,0,45,1525,70442
2015-05-26,62726,118,0,59,1099,64002
2015-05-27,60126,116,0,66,899,61207
2015-05-28,59603,166,0,78,1064,60911
2015-05-29,63040,286,0,68,1597,64991
2015-05-30,69393,146,0,18,1293,70850
2015-05-31,60457,134,0,63,1538,62192
2015-06-01,63123,262,0,49,1560,64994
2015-06-02,66418,154,0,140,1783,68495
2015-06-03,66939,189,1,122,1277,68528
2015-06-04,89997,337,0,76,1018,91428
2015-06-05,77414,244,0,56,1434,79148
2015-06-06,87009,129,0,29,1343,88510
2015-06-07,91894,238,0,70,1157,93359
2015-06-08,69354,196,0,32,1222,70804
2015-06-09,66017,176,2,59,1417,67671
2015-06-10,67639,120,0,75,1652,69486
2015-06-11,66864,178,0,49,871,67962
2015-06-12,81041,258,0,38,796,82133
2015-06-13,91185,334,0,19,1288,92826
2015-06-14,73798,116,0,46,2154,76114
2015-06-15,73437,71,0,65,1821,75394
2015-06-16,69485,94,0,45,1513,71137
2015-06-17,74746,97,0,79,1365,76287
2015-06-18,67220,247,0,46,1226,68739
2015-06-19,81231,155,0,141,1555,83082
2015-06-20,87835,193,0,80,1197,89305
2015-06-21,75451,393,0,176,1503,77523
2015-06-22,81437,209,25,43,1478,83192
2015-06-23,68550,279,0,60,1343,70232
2015-06-24,85288,258,0,118,1265,86929
2015-06-25,87470,500,0,106,1608,89684
2015-06-26,79522,338,0,147,1694,81701
2015-06-27,79784,243,0,90,1142,81259
2015-06-28,78731,333,0,82,925,80071
2015-06-29,73713,286,0,74,1299,75372
2015-06-30,70487,276,0,53,1355,72171
2015-07-01,72860,304,0,166,1419,74749
2015-07-02,73286,248,0,62,823,74419
2015-07-03,75052,403,0,49,1647,77151
2015-07-04,76107,315,0,38,1628,78088
2015-07-05,77341,271,0,82,1120,78814
2015-07-06,76807,318,0,91,1181,78397
2015-07-07,70358,269,1,36,1542,72206
2015-07-08,67583,265,0,71,1287,69206
2015-07-09,80413,281,0,25,1365,82084
2015-07-10,87373,160,1,40,909,88483
2015-07-11,85625,250,0,40,453,86368
2015-07-12,76812,204,0,58,2443,79517
2015-07-13,78951,289,0,76,1407,80723
2015-07-14,81903,255,0,109,1028,83295
2015-07-15,78415,283,0,91,1156,79945
2015-07-16,83454,408,0,79,1741,85682
2015-07-17,83470,246,0,62,1178,84956
2015-07-18,94032,373,0,67,980,95452
2015-07-19,84442,201,0,98,1058,85799
2015-07-20,73489,202,0,47,1442,75180
2015-07-21,80735,310,0,99,2074,83218
2015-07-22,80327,284,0,83,874,81568
2015-07-23,75271,246,0,61,1239,76817
2015-07-24,79008,150,0,72,1785,81015
2015-07-25,102557,274,1,65,1672,104569
2015-07-26,81558,303,5,87,793,82746
2015-07-27,79636,296,0,97,959,80988
2015-07-28,71081,352,0,79,2100,73612
2015-07-29,74152,268,1,115,1812,76348
2015-07-30,86001,324,0,90,813,87228
2015-07-31,85661,282,0,71,1471,87485
2015-08-01,95671,298,0,103,1505,97577
2015-08-02,82697,273,0,125,1693,84788
2015-08-03,88984,338,0,67,935,90324
2015-08-04,82940,361,0,88,1595,84984
2015-08-05,87902,345,0,73,1220,89540
2015-08-06,112564,365,0,48,1603,114580
2015-08-07,98539,437,0,74,1511,100561
2015-08-08,103828,357,0,132,1075,105392
2015-08-09,82219,522,0,66,2319,85126
2015-08-10,93629,285,0,55,1069,95038
2015-08-11,84856,394,0,101,1899,87250
2015-08-12,86852,416,0,49,1101,88418
2015-08-13,91690,463,0,65,2382,94600
2015-08-14,100638,377,0,61,1793,102869
2015-08-15,116845,355,1,54,1488,118743
2015-08-16,87851,391,0,81,980,89303
2015-08-17,79066,382,0,51,2127,81626
2015-08-18,87878,369,0,104,1069,89420
2015-08-19,80708,213,0,63,1437,82421
2015-08-20,78509,350,0,75,1052,79986
2015-08-21,85508,352,0,121,1220,87201
2015-08-22,101379,281,0,63,803,102526
2015-08-23,84323,333,0,108,828,85592
2015-08-24,79175,282,1,40,1482,80980
2015-08-25,71779,248,0,86,1348,73461
2015-08-26,83273,291,0,275,1026,84865
2015-08-27,80785,273,0,65,1475,82598
2015-08-28,85431,242,0,189,1355,87217
2015-08-29,91098,226,0,93,1974,93391
2015-08-30,92468,347,0,179,1013,94007
2015-08-31,82638,254,0,121,959,83972
2015-09-01,66831,260,0,58,1981,69130
2015-09-02,66733,216,12,214,2351,69526
2015-09-03,72726,244,1,86,1346,74403
2015-09-04,76707,271,0,76,1092,78146
2015-09-05,79097,279,0,27,940,80343
2015-09-06,70105,391,0,100,1318,71914
2015-09-07,66026,256,0,46,1141,67469
2015-09-08,65820,251,0,92,1459,67622
2015-09-09,68982,389,0,69,881,70321
2015-09-10,68361,328,0,95,1419,70203
2015-09-11,77492,320,0,177,1180,79169
2015-09-12,82997,269,0,76,923,84265
2015-09-13,70839,232,0,85,1112,72268
2015-09-14,62314,279,0,46,2175,64814
2015-09-15,67075,216,0,85,1107,68483
2015-09-16,63088,237,0,51,1150,64526
2015-09-17,61927,170,0,65,1224,63386
2015-09-18,65006,74,0,69,2126,67275
2015-09-19,73770,21,0,55,965,74811
2015-09-20,59613,15,0,90,1176,60894
2015-09-21,62861,14,0,77,1144,64096
2015-09-22,55172,18,0,62,1427,56679
2015-09-23,58357,23,0,163,1460,60003
2015-09-24,60092,11,0,35,834,60972
2015-09-25,68161,19,0,78,892,69150
2015-09-26,74386,17,0,103,855,75361
2015-09-27,62678,7,0,114,1349,64148
2015-09-28,60933,25,0,57,927,61942
2015-09-29,61695,13,0,63,1302,63073
2015-09-30,57129,10,0,58,2035,59232
2015-10-01,61092,11,0,50,1160,62313
2015-10-02,67276,18,0,47,865,68206
2015-10-03,71538,15,0,95,859,72507
2015-10-04,62644,77,0,180,1231,64132
2015-10-05,63428,77,0,98,1242,64845
2015-10-06,55616,97,0,189,979,56881
2015-10-07,63947,110,0,108,1245,65410
2015-10-08,86835,152,0,128,1312,88427
2015-10-09,71095,146,0,24,1141,72406
2015-10-10,66726,80,0,17,931,67754
2015-10-11,59258,129,0,75,991,60453
2015-10-12,61984,180,0,86,1076,63326
2015-10-13,54591,167,0,41,1117,55916
2015-10-14,57700,87,0,33,1030,58850
2015-10-15,58749,152,0,82,1126,60109
2015-10-16,66010,124,0,28,982,67144
2015-10-17,73717,45,0,38,737,74537
2015-10-18,58775,39,0,76,1534,60424
2015-10-19,57240,24,0,58,970,58292
2015-10-20,58444,20,0,48,1000,59512
2015-10-21,57202,36,0,126,1151,58515
2015-10-22,60138,38,0,36,1423,61635
2015-10-23,64291,329,0,63,1409,66092
2015-10-24,70729,32,0,18,1141,71920
2015-10-25,61860,13,0,92,850,62815
2015-10-26,60618,26,0,34,811,61489
2015-10-27,56384,24,0,74,892,57374
2015-10-28,60600,33,0,10,1072,61715
2015-10-29,58728,22,0,49,623,59422
2015-10-30,75080,78,0,0,677,75835
2015-10-31,94143,71,0,12,741,94967
2015-11-01,76147,107,0,50,1053,77357
2015-11-02,62330,87,0,56,877,63350
2015-11-03,56481,98,0,41,771,57391
2015-11-04,54005,129,0,42,766,54942
2015-11-05,56954,92,0,33,662,57741
2015-11-06,64944,135,0,14,667,65760
2015-11-07,70659,77,0,10,429,71175
2015-11-08,58831,87,0,120,976,60014
2015-11-09,53460,104,0,1,899,54464
2015-11-10,58640,81,0,1,799,59521
2015-11-11,56639,120,0,22,634,57415
2015-11-12,55753,82,0,36,881,56752
2015-11-13,58610,103,0,28,1447,60188
2015-11-14,66122,102,0,57,738,67019
2015-11-15,59343,131,0,78,696,60248
2015-11-16,52807,72,0,1,771,53651
2015-11-17,58972,78,0,0,646,59696
2015-11-18,56302,126,0,45,985,57458
2015-11-19,60242,101,0,66,639,61048
2015-11-20,62637,99,0,30,782,63548
2015-11-21,64660,75,0,21,577,65333
2015-11-22,53221,108,0,120,1423,54872
2015-11-23,52972,159,0,6,1464,54601
2015-11-24,47565,106,0,0,1102,48773
2015-11-25,48695,82,0,4,1446,50227
2015-11-26,50338,78,0,64,1017,51497
2015-11-27,56190,97,0,10,1086,57383
2015-11-28,56688,106,0,2,699,57495
2015-11-29,49769,71,0,82,1555,51477
2015-11-30,48930,101,0,12,1315,50358
2015-12-01,50838,111,0,0,1262,52211
2015-12-02,50259,130,0,0,1289,51678
2015-12-03,51644,174,4,35,940,52797
2015-12-04,55196,94,0,3,964,56257
2015-12-05,63035,129,0,0,848,64012
2015-12-06,46841,104,0,57,1418,48420
2015-12-07,47974,92,0,4,1369,49439
2015-12-08,50002,82,0,0,1262,51346
2015-12-09,48046,78,0,9,1252,49385
2015-12-10,51661,90,0,28,1085,52864
2015-12-11,56550,123,0,6,1059,57738
2015-12-12,69072,101,0,6,687,69866
2015-12-13,52813,109,0,66,1384,54372
2015-12-14,50043,152,4,3,1304,51506
2015-12-15,57205,106,0,3,1078,58392
2015-12-16,58120,138,0,0,1460,59718
2015-12-17,60054,115,0,42,733,60944
2015-12-18,69339,181,0,3,1121,70644
2015-12-19,81109,201,0,4,1020,82334
2015-12-20,61506,183,0,69,969,62727
2015-12-21,69887,136,0,0,903,70926
2015-12-22,69778,110,0,6,1392,71286
2015-12-23,75295,166,0,4,1281,76746
2015-12-24,59906,183,0,1,786,60876
2015-12-25,39232,127,0,1,209,39569
2015-12-26,63978,219,0,0,712,64909
2015-12-27,60711,224,0,80,855,61870
2015-12-28,62040,197,0,33,760,63030
2015-12-29,64717,204,0,54,883,65858
2015-12-30,84114,357,0,1,1644,86116
2015-12-31,59994,350,12,4,867,61227
2016-01-01,35967,162,0,2,615,36746
2016-01-02,94421,173,0,0,734,95328
2016-01-03,56006,182,0,93,1734,58015
2016-01-04,50148,330,0,0,1653,52131
2016-01-05,53576,270,0,4,937,54787
2016-01-06,52331,258,0,1,1771,54361
2016-01-07,49771,113,0,61,965,50910
2016-01-08,56275,186,0,9,1117,57587
2016-01-09,73018,166,0,2,597,73783
2016-01-10,59702,232,0,68,1652,61654
2016-01-11,59125,159,0,2,1208,60494
2016-01-12,52681,145,0,8,1313,54147
2016-01-13,53953,205,0,0,717,54875
2016-01-14,51723,145,0,85,736,52689
2016-01-15,57501,148,0,0,1106,58755
2016-01-16,60674,192,0,0,791,61657
2016-01-17,44817,150,0,63,1289,46319
2016-01-18,41326,126,0,1,1226,42679
2016-01-19,44388,212,4,3,1241,45848
2016-01-20,42832,195,0,3,1144,44174
2016-01-21,48609,148,0,40,952,49749
2016-01-22,47882,162,0,2,779,48825
2016-01-23,55841,146,0,0,469,56456
2016-01-24,41351,127,0,58,1504,43040
2016-01-25,45836,109,0,1,1340,47286
2016-01-26,38360,172,0,1,1200,39733
2016-01-27,43292,134,0,4,1303,44733
2016-01-28,43747,126,0,65,1160,45098
2016-01-29,49852,159,4,6,990,51011
2016-01-30,54835,140,0,0,620,55595
2016-01-31,44944,132,0,50,1246,46372
2016-02-01,46573,156,0,3,1128,47860
2016-02-02,44632,111,0,4,1111,45858
2016-02-03,42224,114,0,3,879,43220
2016-02-04,47527,153,0,42,787,48509
2016-02-05,49832,140,0,29,935,50936
2016-02-06,58552,141,0,2,709,59404
2016-02-07,45763,141,0,77,1077,47058
2016-02-08,47929,62,0,0,1399,49390
2016-02-09,45752,128,0,0,1061,46941
2016-02-10,46272,139,0,0,1033,47444
2016-02-11,50831,111,0,45,781,51768
2016-02-12,53911,251,0,0,1135,55297
2016-02-13,59167,132,0,0,1030,60329
2016-02-14,47328,124,0,47,1473,48972
2016-02-15,51335,115,0,5,1324,52779
2016-02-16,47496,205,0,0,1146,48847
2016-02-17,46489,157,0,2,1338,47986
2016-02-18,49364,147,0,42,937,50490
2016-02-19,56055,149,0,0,842,57046
2016-02-20,61735,150,0,4,806,62695
2016-02-21,49861,154,0,82,1606,51703
2016-02-22,47758,125,0,3,1198,49084
2016-02-23,49144,138,0,5,1289,50576
2016-02-24,48485,118,4,3,1420,50030
2016-02-25,47682,191,0,86,1186,49145
2016-02-26,53210,153,0,0,917,54280
2016-02-27,61037,148,0,6,617,61808
2016-02-28,46475,161,0,0,1466,48102
2016-02-29,47010,123,0,59,1236,48428
2016-03-01,50021,149,0,0,953,51123
2016-03-02,50865,124,0,2,1009,52000
2016-03-03,50162,134,0,34,763,51093
2016-03-04,52160,690,0,1,1176,54027
2016-03-05,65067,148,0,0,559,65774
2016-03-06,50268,98,0,50,1030,51446
2016-03-07,51564,116,0,0,787,52467
2016-03-08,48415,201,0,13,1183,49812
2016-03-09,51147,96,0,7,894,52144
2016-03-10,59116,187,0,52,1017,60372
2016-03-11,60446,178,0,2,976,61602
2016-03-12,65201,165,0,2,985,66353
2016-03-13,53222,135,0,82,879,54318
2016-03-14,52151,102,0,0,1146,53399
2016-03-15,55673,125,0,15,907,56720
2016-03-16,52192,122,0,0,1508,53822
2016-03-17,56864,137,0,154,612,57767
2016-03-18,61774,154,0,2,1015,62945
2016-03-19,74988,140,0,12,1072,76212
2016-03-20,57291,128,0,277,937,58633
2016-03-21,56194,197,0,0,828,57219
2016-03-22,59693,172,0,52,1099,61016
2016-03-23,59375,178,0,25,1372,60950
2016-03-24,70132,236,0,82,1477,71927
2016-03-25,70272,220,0,4,1084,71580
2016-03-26,71276,170,0,12,853,72311
2016-03-27,46876,149,0,28,690,47743
2016-03-28,71197,170,0,17,1616,73000
2016-03-29,57017,147,0,178,1708,59050
2016-03-30,55011,184,0,9,1407,56611
2016-03-31,52372,168,0,33,1380,53953
2016-04-01,65944,154,0,13,1572,67683
2016-04-02,63292,173,0,11,1470,64946
2016-04-03,56894,95,0,118,1805,58912
2016-04-04,52306,171,0,8,2187,54672
2016-04-05,54636,110,0,75,1909,56730
2016-04-06,47094,166,0,41,1365,48666
2016-04-07,52825,198,0,43,1568,54634
2016-04-08,59187,178,0,19,1276,60660
2016-04-09,71526,165,0,18,1425,73134
2016-04-10,52073,113,0,58,1409,53653
2016-04-11,57366,185,0,24,1699,59274
2016-04-12,51953,147,0,38,1608,53746
2016-04-13,51095,153,0,50,1608,52906
2016-04-14,56737,173,0,104,1439,58453
2016-04-15,62839,247,0,22,1302,64410
2016-04-16,69600,133,0,5,1196,70934
2016-04-17,59608,254,0,103,1598,61563
2016-04-18,55154,201,0,30,1785,57170
2016-04-19,5861,0,0,4,0,5865
2016-04-20,41381,119,0,51,163,41714
2016-04-21,47452,185,0,56,1650,49343
2016-04-22,59277,231,0,37,1206,60751
2016-04-23,56984,180,0,21,677,57862
2016-04-24,53121,146,0,46,1640,54953
2016-04-25,58324,138,0,47,1776,60285
2016-04-26,54726,149,0,38,1272,56185
2016-04-27,53483,150,0,27,1457,55117
2016-04-28,58389,170,0,109,1825,60493
2016-04-29,63367,202,0,33,1346,64948
2016-04-30,67008,209,0,27,1091,68335
2016-05-01,50543,131,0,46,1278,51998
2016-05-02,53911,179,0,22,1842,55954
2016-05-03,57327,179,0,43,1461,59010
2016-05-04,56305,165,0,94,1241,57805
2016-05-05,65046,196,0,63,1042,66347
2016-05-06,68654,206,0,36,1444,70340
2016-05-07,69487,189,0,15,1405,71096
2016-05-08,63665,111,0,67,1139,64982
2016-05-09,58617,158,0,25,1963,60763
2016-05-10,59058,153,0,47,1868,61126
2016-05-11,59073,182,0,36,1601,60892
2016-05-12,60606,196,0,69,1346,62217
2016-05-13,68152,174,0,31,1000,69357
2016-05-14,86034,145,0,8,1048,87235
2016-05-15,61726,145,0,66,1361,63298
2016-05-16,69504,189,0,39,1222,70954
2016-05-17,60505,194,0,87,916,61702
2016-05-18,63411,159,0,50,1436,65056
2016-05-19,64791,235,0,88,852,65966
2016-05-20,69523,224,0,47,938,70732
2016-05-21,72873,197,0,15,989,74074
2016-05-22,62864,223,0,91,1303,64481
2016-05-23,64296,134,0,49,899,65378
2016-05-24,59932,149,0,123,1382,61586
2016-05-25,64596,175,0,97,1307,66175
2016-05-26,82211,197,0,71,1024,83503
2016-05-27,66594,216,0,170,352,67332
2016-05-28,71899,177,0,11,901,72988
2016-05-29,66115,248,0,3493,1065,70921
2016-05-30,62571,166,0,22,1401,64160
2016-05-31,57465,177,2,46,1207,58897
2016-06-01,67852,343,0,23,1154,69372
2016-06-02,68432,173,0,40,1329,69974
2016-06-03,79170,150,0,39,1222,80581
2016-06-04,88978,165,0,6,817,89966
2016-06-05,71079,167,0,75,1108,72429
2016-06-06,64243,186,0,55,964,65448
2016-06-07,68938,213,0,56,410,69617
2016-06-08,69283,204,0,75,753,70315
2016-06-09,72480,160,0,44,1865,74549
2016-06-10,79307,172,0,47,1141,80667
2016-06-11,88315,226,0,14,1053,89608
2016-06-12,65012,183,0,132,1043,66370
2016-06-13,73642,151,0,55,712,74560
2016-06-14,64982,328,0,156,972,66438
2016-06-15,74382,177,0,89,1179,75827
2016-06-16,76285,241,0,20,1260,77806
2016-06-17,74513,202,0,158,1662,76535
2016-06-18,84342,174,0,35,1015,85566
2016-06-19,76830,181,0,106,1280,78397
2016-06-20,79006,169,0,57,1156,80388
2016-06-21,70724,210,0,71,1296,72301
2016-06-22,86670,283,0,103,1128,88184
2016-06-23,76784,164,0,72,1434,78454
2016-06-24,86617,212,0,127,1218,88174
2016-06-25,83313,213,0,66,841,84433
2016-06-26,70346,225,0,89,1043,71703
2016-06-27,77911,214,0,129,1344,79598
2016-06-28,72688,183,0,94,1355,74320
2016-06-29,70941,193,0,67,1159,72360
2016-06-30,77718,280,0,57,755,78810
2016-07-01,82994,190,0,1327,1701,86212
2016-07-02,89168,239,0,38,1412,90857
2016-07-03,80895,369,0,96,832,82192
2016-07-04,80003,308,0,35,1187,81533
2016-07-05,73488,249,0,78,1282,75097
2016-07-06,68977,235,0,85,1163,70460
2016-07-07,77990,346,0,54,908,79298
2016-07-08,86481,330,0,55,1064,87930
2016-07-09,88403,368,0,36,838,89645
2016-07-10,76470,316,0,80,2080,78946
2016-07-11,82459,300,0,49,801,83609
2016-07-12,75118,362,0,56,1095,76631
2016-07-13,75126,303,0,125,1068,76622
2016-07-14,92491,212,0,66,2149,94918
2016-07-15,88977,323,0,60,1187,90547
2016-07-16,94944,297,0,42,932,96215
2016-07-17,81099,314,0,85,1572,83070
2016-07-18,80561,360,0,91,531,81543
2016-07-19,79135,393,0,81,1007,80616
2016-07-20,84322,317,0,119,1019,85777
2016-07-21,85522,357,0,79,1146,87104
2016-07-22,89087,332,0,93,1466,90978
2016-07-23,87086,401,0,91,804,88382
2016-07-24,87703,334,0,95,1357,89489
2016-07-25,82816,300,0,110,1728,84954
2016-07-26,78410,350,0,118,1635,80513
2016-07-27,77876,388,0,82,861,79207
2016-07-28,85807,381,0,103,972,87263
2016-07-29,81110,322,0,78,1149,82659
2016-07-30,89031,486,0,86,1078,90681
2016-07-31,82590,322,0,96,1048,84056
2016-08-01,91431,353,0,92,1223,93099
2016-08-02,80836,238,0,138,1403,82615
2016-08-03,79117,243,0,121,1345,80826
2016-08-04,92143,239,0,89,1651,94122
2016-08-05,107082,288,0,72,1047,108489
2016-08-06,89929,273,0,132,849,91183
2016-08-07,88723,230,0,92,1802,90847
2016-08-08,86006,286,0,104,797,87193
2016-08-09,87505,351,0,91,1182,89129
2016-08-10,86981,252,0,53,1241,88527
2016-08-11,97962,232,0,85,2078,100357
2016-08-12,102422,392,0,93,936,103843
2016-08-13,118686,407,0,61,1236,120390
2016-08-14,103447,289,0,59,1362,105157
2016-08-15,97783,254,0,61,1198,99296
2016-08-16,98334,244,0,90,1122,99790
2016-08-17,90528,395,0,55,1236,92214
2016-08-18,87277,244,0,100,896,88517
2016-08-19,99594,313,0,109,2466,102482
2016-08-20,100213,307,0,81,1086,101687
2016-08-21,92405,381,0,104,1218,94108
2016-08-22,93114,252,0,109,1286,94761
2016-08-23,86525,348,49,99,1734,88755
2016-08-24,78117,384,0,110,1140,79751
2016-08-25,87253,372,0,106,858,88589
2016-08-26,95288,298,0,134,1386,97106
2016-08-27,102461,210,0,124,824,103619
2016-08-28,91425,318,0,66,1224,93033
2016-08-29,85682,287,0,78,1179,87226
2016-08-30,84580,222,0,90,1352,86244
2016-08-31,80121,252,0,117,673,81163
2016-09-01,77347,281,0,156,823,78607
2016-09-02,83037,257,0,68,1500,84862
2016-09-03,104703,236,0,43,1158,106140
2016-09-04,72492,184,0,71,2196,74943
2016-09-05,72869,176,8,51,1172,74276
2016-09-06,73244,184,0,58,1510,74996
2016-09-07,72702,166,0,76,1292,74236
2016-09-08,74044,197,0,84,1419,75744
2016-09-09,70851,195,0,147,936,72129
2016-09-10,88218,207,0,58,1060,89543
2016-09-11,75849,189,0,417,1663,78118
2016-09-12,69840,200,0,62,1172,71274
2016-09-13,64438,234,0,84,1095,65851
2016-09-14,72395,207,0,55,1002,73659
2016-09-15,75447,262,0,69,1210,76988
2016-09-16,75287,261,0,45,1350,76943
2016-09-17,84300,243,0,72,686,85301
2016-09-18,69207,178,0,85,1781,71251
2016-09-19,72805,217,0,95,1302,74419
2016-09-20,66554,186,0,60,2207,69007
2016-09-21,65667,218,0,80,536,66501
2016-09-22,69631,183,0,113,1187,71114
2016-09-23,68987,262,0,120,1114,70483
2016-09-24,83126,228,0,52,981,84387
2016-09-25,63522,214,0,109,989,64834
2016-09-26,65620,200,1,60,1047,66928
2016-09-27,65747,149,0,61,1162,67119
2016-09-28,64624,143,0,112,1046,65925
2016-09-29,68713,179,0,123,926,69941
2016-09-30,73065,190,0,80,1044,74379
2016-10-01,91770,165,0,154,817,92906
2016-10-02,65071,165,0,127,973,66336
2016-10-03,71334,128,0,35,1122,72619
2016-10-04,62453,106,0,56,983,63598
2016-10-05,68722,167,0,98,1225,70212
2016-10-06,66786,187,0,181,1617,68771
2016-10-07,76346,163,0,27,964,77500
2016-10-08,92710,141,0,220,994,94065
2016-10-09,64468,147,0,72,1204,65891
2016-10-10,63262,158,0,49,1968,65437
2016-10-11,64847,188,0,47,1076,66158
2016-10-12,65292,186,0,21,890,66389
2016-10-13,66038,150,22,67,1230,67507
2016-10-14,69847,209,0,8,1877,71941
2016-10-15,79758,191,0,18,603,80570
2016-10-16,68013,137,0,394,1004,69548
2016-10-17,63247,322,0,167,1209,64945
2016-10-18,59765,223,0,46,603,60637
2016-10-19,60237,197,0,39,681,61154
2016-10-20,62152,162,0,32,1067,63413
2016-10-21,65927,455,0,21,1315,67718
2016-10-22,76081,199,0,25,814,77119
2016-10-23,60024,187,0,233,673,61117
2016-10-24,60038,120,0,29,1020,61207
2016-10-25,42598,175,0,3,419,43195
2016-10-26,55390,202,0,137,198,55927
2016-10-27,56200,188,0,107,194,56689
2016-10-28,64651,84,0,1,717,65453
2016-10-29,81994,175,0,27,293,82489
2016-10-30,73832,226,0,52,139,74249
2016-10-31,69053,185,0,1,890,70129
2016-11-01,79297,187,0,50,307,79841
2016-11-02,63232,194,8,0,222,63656
2016-11-03,58765,168,0,49,157,59139
2016-11-04,59213,240,0,38,688,60179
2016-11-05,65589,171,0,26,111,65897
2016-11-06,52623,173,0,116,182,53094
2016-11-07,49897,119,0,3,271,50290
2016-11-08,52248,104,0,1,152,52505
2016-11-09,53351,176,0,0,140,53667
2016-11-10,52888,117,0,76,136,53217
2016-11-11,59612,189,0,3,111,59915
2016-11-12,57983,172,0,29,711,58895
2016-11-13,54013,120,0,117,680,54930
2016-11-14,50658,67,0,4,121,50850
2016-11-15,53326,193,0,2,799,54320
2016-11-16,50194,140,0,6,719,51059
2016-11-17,55710,167,0,138,787,56802
2016-11-18,54750,179,0,4,47,54980
2016-11-19,62811,171,0,32,656,63670
2016-11-20,50022,157,0,68,938,51185
2016-11-21,50983,158,0,2,718,51861
2016-11-22,47453,122,0,0,546,48121
2016-11-23,50437,166,0,0,902,51505
2016-11-24,50967,143,0,86,618,51814
2016-11-25,57948,147,0,0,655,58750
2016-11-26,62011,171,0,20,465,62667
2016-11-27,49853,158,0,80,772,50863
2016-11-28,55178,158,0,0,1125,56461
2016-11-29,50474,118,0,4,540,51136
2016-11-30,50608,178,0,1,756,51543
2016-12-01,53008,163,0,124,904,54199
2016-12-02,55691,156,0,0,588,56435
2016-12-03,71056,147,0,0,468,71671
2016-12-04,53196,79,0,64,723,54062
2016-12-05,50619,241,0,0,802,51662
2016-12-06,50779,148,0,4,893,51824
2016-12-07,47389,168,0,0,528,48085
2016-12-08,53724,146,0,38,827,54735
2016-12-09,56682,265,0,0,701,57648
2016-12-10,79966,234,0,32,347,80579
2016-12-11,56914,154,0,51,911,58030
2016-12-12,53894,100,0,5,586,54585
2016-12-13,50836,146,0,10,1190,52182
2016-12-14,49827,131,0,8,720,50686
2016-12-15,63681,115,0,57,596,64449
2016-12-16,69911,133,0,2,662,70708
2016-12-17,85245,144,0,14,1364,86767
2016-12-18,59888,144,0,100,579,60711
2016-12-19,65752,143,0,3,770,66668
2016-12-20,61344,143,0,2,691,62180
2016-12-21,62802,115,0,0,1019,63936
2016-12-22,70609,222,0,51,1066,71948
2016-12-23,79037,190,0,0,1358,80585
2016-12-24,58572,236,0,0,376,59184
2016-12-25,36816,143,0,0,509,37468
2016-12-26,68990,205,0,0,1429,70624
2016-12-27,70996,212,0,44,1899,73151
2016-12-28,69578,511,0,0,1615,71704
2016-12-29,70834,1024,0,46,2142,74046
2016-12-30,85465,686,0,0,1561,87712
2016-12-31,61427,247,0,0,803,62477
2017-01-01,41033,227,0,45,1177,42482
2017-01-02,68529,558,0,1,1289,70377
2017-01-03,68069,172,0,0,1070,69311
2017-01-04,67560,156,0,119,827,68662
2017-01-05,73641,171,0,0,1097,74909
2017-01-06,64280,212,0,0,1018,65510
2017-01-07,84444,171,0,5,1056,85676
2017-01-08,64186,163,0,81,2030,66460
2017-01-09,60369,215,0,1,1593,62178
2017-01-10,58746,116,0,2,1486,60350
2017-01-11,55823,118,0,57,699,56697
2017-01-12,63241,255,0,3,1007,64506
2017-01-13,53281,145,0,0,877,54303
2017-01-14,56689,126,0,4,760,57579
2017-01-15,48192,147,0,48,1736,50123
2017-01-16,46920,141,0,0,1474,48535
2017-01-17,36373,105,0,0,1487,37965
2017-01-18,36961,128,0,0,1036,38125
2017-01-19,44487,123,0,35,566,45211
2017-01-20,49865,132,0,3,641,50641
2017-01-21,56176,124,0,0,561,56861
2017-01-22,46153,158,0,71,1061,47443
2017-01-23,47051,112,0,3,881,48047
2017-01-24,44280,112,0,0,780,45172
2017-01-25,47084,120,0,48,1184,48436
2017-01-26,46485,96,0,0,520,47101
2017-01-27,51764,93,0,18,1062,52937
2017-01-28,55511,72,0,0,351,55934
2017-01-29,43125,130,0,40,1110,44405
2017-01-30,46831,128,0,0,931,47890
2017-01-31,46373,104,0,0,976,47453
2017-02-01,43859,82,0,38,1071,45050
2017-02-02,50108,108,0,18,864,51098
2017-02-03,52122,148,0,0,817,53087
2017-02-04,57664,102,0,0,417,58183
2017-02-05,44880,94,0,52,902,45928
2017-02-06,51219,95,0,2,775,52091
2017-02-07,45361,91,0,2,865,46319
2017-02-08,48584,156,0,51,729,49520
2017-02-09,52217,92,0,0,584,52893
2017-02-10,57493,114,0,1,587,58195
2017-02-11,63891,111,0,5,939,64946
2017-02-12,50688,100,0,48,645,51481
2017-02-13,54639,142,0,6,549,55336
2017-02-14,50502,121,0,9,918,51550
2017-02-15,50316,134,0,65,1243,51758
2017-02-16,53537,124,0,0,622,54283
2017-02-17,55966,103,0,2,761,56832
2017-02-18,63334,127,0,1,798,64260
2017-02-19,52508,167,0,58,1040,53773
2017-02-20,53988,145,0,9,833,54975
2017-02-21,49693,152,0,0,836,50681
2017-02-22,50498,107,0,40,636,51281
2017-02-23,51020,154,0,5,976,52155
2017-02-24,54582,148,0,0,969,55699
2017-02-25,61362,126,0,1,509,61998
2017-02-26,51898,182,0,57,968,53105
2017-02-27,50124,142,0,0,1297,51563
2017-02-28,47367,164,0,0,941,48472
2017-03-01,55301,89,0,37,671,56098
2017-03-02,51874,118,0,1,719,52712
2017-03-03,59322,694,0,7,1186,61209
2017-03-04,64959,108,0,0,467,65534
2017-03-05,57504,104,0,0,1103,58711
2017-03-06,51897,109,0,1,684,52691
2017-03-07,50176,127,0,1,1363,51667
2017-03-08,51271,120,0,43,541,51975
2017-03-09,52468,102,0,2,671,53243
2017-03-10,56286,130,0,11,932,57359
2017-03-11,68695,126,0,3,1569,70393
2017-03-12,54486,152,0,45,756,55439
2017-03-13,52320,75,0,3,698,53096
2017-03-14,48908,110,0,0,733,49751
2017-03-15,53568,124,0,77,766,54535
2017-03-16,56062,126,0,2,565,56755
2017-03-17,61494,145,0,40,619,62298
2017-03-18,63319,143,0,0,762,64224
2017-03-19,58744,185,0,60,992,59981
2017-03-20,54148,177,0,0,593,54918
2017-03-21,53691,119,0,0,521,54331
2017-03-22,51674,103,0,63,798,52638
2017-03-23,55926,111,0,20,589,56646
2017-03-24,53948,145,0,0,612,54705
2017-03-25,67676,87,0,0,669,68432
2017-03-26,53624,109,0,88,323,54144
2017-03-27,53561,154,0,20,2221,55956
2017-03-28,50041,122,0,0,590,50753
2017-03-29,54600,121,0,32,225,54978
2017-03-30,56006,121,0,0,277,56404
2017-03-31,60178,176,0,5,270,60629
2017-04-01,69783,86,0,5,1103,70977
2017-04-02,58053,68,0,72,206,58399
2017-04-03,57107,151,0,1,317,57576
2017-04-04,54379,104,0,54,596,55133
2017-04-05,56342,171,0,0,875,57388
2017-04-06,58360,131,0,149,707,59347
2017-04-07,61980,79,0,1,1120,63180
2017-04-08,70423,193,0,7,1458,72081
2017-04-09,62390,100,0,66,1532,64088
2017-04-10,56895,80,0,20,1938,58933
2017-04-11,59878,111,0,44,1695,61728
2017-04-12,66651,128,0,31,1818,68628
2017-04-13,70640,112,0,68,2497,73317
2017-04-14,77313,113,0,11,2106,79543
2017-04-15,71858,107,0,9,1599,73573
2017-04-16,50918,100,0,217,1167,52402
2017-04-17,80133,119,1,19,2394,82666
2017-04-18,78180,173,0,406,3062,81821
2017-04-19,68902,172,0,22,1466,70562
2017-04-20,63934,169,0,41,2414,66558
2017-04-21,75383,148,0,12,1792,77335
2017-04-22,73723,107,0,43,1974,75847
2017-04-23,63645,121,0,71,2370,66207
2017-04-24,66390,76,0,10,1729,68205
2017-04-25,64938,121,0,73,2288,67420
2017-04-26,60051,103,0,95,2312,62561
2017-04-27,60467,122,0,125,2248,62962
2017-04-28,67878,171,0,3,2346,70398
2017-04-29,74927,219,0,24,1822,76992
2017-04-30,66464,149,0,131,1396,68140
2017-05-01,61380,125,0,12,1978,63495
2017-05-02,55833,132,0,68,2401,58434
2017-05-03,65141,134,0,112,2156,67543
2017-05-04,66580,111,0,56,2028,68775
2017-05-05,69302,111,0,41,1722,71176
2017-05-06,71466,119,0,16,1609,73210
2017-05-07,58456,123,0,78,2143,60800
2017-05-08,62826,80,0,6,2273,65185
2017-05-09,59068,86,0,40,2222,61416
2017-05-10,57570,79,0,11,2095,59755
2017-05-11,61232,100,0,50,1971,63353
2017-05-12,58541,77,0,38,1499,60155
2017-05-13,73669,115,0,25,1330,75139
2017-05-14,60435,159,0,60,2138,62792
2017-05-15,64008,100,0,31,2472,66611
2017-05-16,55978,70,0,66,2011,58125
2017-05-17,61222,91,0,23,1913,63249
2017-05-18,59738,83,0,82,3277,63180
2017-05-19,66086,135,0,46,3321,69588
2017-05-20,74028,139,0,12,1370,75549
2017-05-21,62657,107,0,62,2064,64890
2017-05-22,59194,124,0,64,2164,61546
2017-05-23,61692,103,0,111,1716,63622
2017-05-24,60087,101,0,54,1558,61800
2017-05-25,68182,119,0,114,1618,70033
2017-05-26,67594,135,0,21,1585,69335
2017-05-27,81957,153,0,29,1218,83357
2017-05-28,69350,108,0,178,1822,71458
2017-05-29,64370,84,0,43,2192,66689
2017-05-30,57750,105,0,54,1932,59841
2017-05-31,58961,120,0,42,1790,60913
2017-06-01,66355,107,0,62,1700,68224
2017-06-02,68985,96,0,59,1767,70907
2017-06-03,71490,129,0,41,1279,72939
2017-06-04,71547,201,0,115,1717,73580
2017-06-05,82105,195,0,66,2103,84469
2017-06-06,64280,79,0,103,2106,66568
2017-06-07,67759,130,0,32,2027,69948
2017-06-08,69804,126,2,31,1660,71623
2017-06-09,70923,162,0,72,1586,72743
2017-06-10,80630,112,0,71,1398,82211
2017-06-11,69722,120,0,97,1988,71927
2017-06-12,72234,127,0,61,2329,74751
2017-06-13,67139,119,0,111,1805,69174
2017-06-14,71700,123,0,44,2023,73890
2017-06-15,89840,143,0,131,2467,92581
2017-06-16,80989,147,0,53,1846,83035
2017-06-17,84125,153,0,43,1307,85628
2017-06-18,83098,178,0,90,1902,85268
2017-06-19,79316,136,0,58,2527,82037
2017-06-20,71314,96,0,149,2171,73730
2017-06-21,76079,127,0,70,2271,78547
2017-06-22,93188,139,0,134,2148,95609
2017-06-23,75336,179,0,80,1517,77112
2017-06-24,85035,124,0,68,1109,86336
2017-06-25,70735,153,0,126,2013,73027
2017-06-26,72440,122,0,39,2247,74848
2017-06-27,66282,150,0,87,2269,68788
2017-06-28,69912,134,0,51,1949,72046
2017-06-29,73311,134,0,47,1771,75263
2017-06-30,73667,184,16,90,1471,75428
2017-07-01,78483,197,0,34,1196,79910
2017-07-02,73989,194,0,77,1853,76113
2017-07-03,74413,160,0,68,2067,76708
2017-07-04,71134,147,0,96,1740,73117
2017-07-05,68776,165,2,64,1924,70931
2017-07-06,78789,165,0,85,1529,80568
2017-07-07,76701,134,0,110,1351,78296
2017-07-08,84143,154,0,40,1196,85533
2017-07-09,77607,227,0,112,2073,80019
2017-07-10,78251,171,0,84,2073,80579
2017-07-11,71137,221,0,95,1812,73265
2017-07-12,74159,163,0,100,1738,76160
2017-07-13,77758,163,0,80,1618,79619
2017-07-14,82718,225,0,81,1480,84504
2017-07-15,85644,163,0,58,1306,87171
2017-07-16,75217,183,0,100,1667,77167
2017-07-17,74283,171,0,73,2042,76569
2017-07-18,75530,200,0,98,1860,77688
2017-07-19,72417,211,0,110,1613,74351
2017-07-20,88308,195,15,84,1513,90115
2017-07-21,76678,218,0,114,1638,78648
2017-07-22,90277,205,0,113,1473,92068
2017-07-23,82844,203,0,110,1824,84981
2017-07-24,71947,175,0,70,2092,74284
2017-07-25,67976,187,0,122,1085,69370
2017-07-26,77044,177,0,56,1598,78875
2017-07-27,79987,215,0,92,1475,81769
2017-07-28,75876,173,4,99,1585,77737
2017-07-29,82359,184,2,76,1560,84181
2017-07-30,90601,182,0,115,1606,92504
2017-07-31,79381,234,0,54,1782,81451
2017-08-01,80414,211,0,117,1921,82663
2017-08-02,73254,250,0,107,2049,75660
2017-08-03,83019,176,0,94,1530,84819
2017-08-04,91246,230,0,49,1571,93096
2017-08-05,93742,191,0,133,1502,95568
2017-08-06,74630,223,0,87,1764,76704
2017-08-07,85178,189,0,30,1959,87356
2017-08-08,80379,214,0,125,1691,82409
2017-08-09,82068,208,0,87,1666,84029
2017-08-10,76467,239,0,67,1542,78315
2017-08-11,86337,194,0,34,1721,88286
2017-08-12,99133,220,0,60,1501,100914
2017-08-13,93957,209,0,55,1786,96007
2017-08-14,86518,199,0,36,1859,88612
2017-08-15,98763,163,0,77,1896,100899
2017-08-16,88180,181,0,84,2226,90671
2017-08-17,89130,252,0,74,1888,91344
2017-08-18,79745,245,0,78,1859,81927
2017-08-19,97063,194,0,79,1273,98609
2017-08-20,87363,210,0,59,1925,89557
2017-08-21,86352,218,0,78,2346,88994
2017-08-22,74102,270,0,159,1874,76405
2017-08-23,88788,156,0,122,1944,91010
2017-08-24,75787,175,0,215,1658,77835
2017-08-25,90089,208,0,69,1661,92027
2017-08-26,85184,161,0,100,1351,86796
2017-08-27,81755,178,0,85,1750,83768
2017-08-28,76806,165,0,70,2118,79159
2017-08-29,79609,166,0,67,2121,81963
2017-08-30,73099,190,0,140,1980,75409
2017-08-31,82039,219,0,127,1700,84085
2017-09-01,73514,124,0,33,2457,76128
2017-09-02,78330,114,0,28,1492,79964
2017-09-03,66528,125,1,90,2492,69236
2017-09-04,69597,123,0,93,2593,72406
2017-09-05,64276,97,0,99,2144,66616
2017-09-06,63427,121,0,94,2199,65841
2017-09-07,67304,106,12,96,2007,69525
2017-09-08,79059,125,0,166,1864,81214
2017-09-09,83748,170,4,72,1552,85546
2017-09-10,72104,192,12,31,1913,74252
2017-09-11,62968,130,0,31,2382,65511
2017-09-12,68545,103,0,104,1704,70456
2017-09-13,60870,84,0,92,2079,63125
2017-09-14,64031,136,0,80,1886,66133
2017-09-15,70878,191,0,56,1789,72914
2017-09-16,84451,107,0,48,1355,85961
2017-09-17,74188,137,0,74,1884,76283
2017-09-18,64432,116,4,17,2496,67065
2017-09-19,61721,104,0,48,2048,63921
2017-09-20,66222,118,0,51,2137,68528
2017-09-21,73770,114,1,219,1852,75956
2017-09-22,68989,149,1,189,1860,71188
2017-09-23,76072,128,0,84,1485,77769
2017-09-24,69593,106,0,125,1781,71605
2017-09-25,64685,137,0,58,2481,67361
2017-09-26,60212,131,0,84,2069,62496
2017-09-27,59529,118,0,82,2324,62053
2017-09-28,70510,112,0,105,1855,72582
2017-09-29,68923,137,0,81,1996,71137
2017-09-30,82603,90,0,79,1354,84126
2017-10-01,69026,135,0,190,1865,71216
2017-10-02,63427,126,0,241,2371,66165
2017-10-03,60184,154,0,58,2172,62568
2017-10-04,62046,87,0,70,2415,64618
2017-10-05,60533,113,0,204,2412,63262
2017-10-06,72026,118,0,16,2039,74199
2017-10-07,80177,108,0,122,1695,82102
2017-10-08,68378,135,0,71,2432,71016
2017-10-09,56041,99,0,26,2515,58681
2017-10-10,61188,88,0,77,2316,63669
2017-10-11,60038,108,0,122,2167,62435
2017-10-12,60925,83,8,228,2299,63543
2017-10-13,64627,548,8,26,2395,67604
2017-10-14,76741,102,12,12,1623,78490
2017-10-15,68974,102,0,38,2403,71517
2017-10-16,59792,65,0,35,2765,62657
2017-10-17,55300,97,0,54,2722,58173
2017-10-18,58865,94,0,107,2696,61762
2017-10-19,61580,121,0,97,2444,64242
2017-10-20,65266,140,0,25,2211,67642
2017-10-21,70365,77,0,8,2013,72463
2017-10-22,63368,92,0,70,2383,65913
2017-10-23,61007,104,0,0,2680,63791
2017-10-24,56401,63,0,44,2670,59178
2017-10-25,54227,82,0,22,2242,56573
2017-10-26,62124,110,0,134,2192,64560
2017-10-27,70662,174,0,29,1782,72647
2017-10-28,76169,84,0,18,1878,78149
2017-10-29,68012,81,0,62,1606,69761
2017-10-30,66559,96,0,6,1705,68366
2017-10-31,72766,147,0,22,1406,74341
2017-11-01,75813,204,0,41,1633,77691
2017-11-02,65001,100,0,11,1870,66982
2017-11-03,70172,128,0,78,1647,72025
2017-11-04,71994,110,4,14,1339,73461
2017-11-05,62290,109,0,119,2136,64654
2017-11-06,53999,132,0,0,2312,56443
2017-11-07,57550,64,0,0,2265,59879
2017-11-08,57159,91,0,116,1644,59010
2017-11-09,55894,63,0,40,1552,57549
2017-11-10,61191,126,0,94,1695,63106
2017-11-11,71547,86,0,13,1545,73191
2017-11-12,57107,81,0,54,1922,59164
2017-11-13,56101,91,0,0,2172,58364
2017-11-14,54631,125,0,0,2348,57104
2017-11-15,57225,78,0,0,1586,58889
2017-11-16,62074,96,0,33,1611,63814
2017-11-17,61786,80,0,60,1428,63354
2017-11-18,64479,89,0,86,1421,66075
2017-11-19,60195,75,0,121,1730,62121
2017-11-20,56256,99,0,15,2031,58401
2017-11-21,55426,78,0,2,2119,57625
2017-11-22,54459,86,0,52,1814,56411
2017-11-23,59185,66,0,18,1689,60958
2017-11-24,64416,128,0,67,1309,65920
2017-11-25,63738,81,0,0,1374,65193
2017-11-26,51478,103,0,48,1885,53514
2017-11-27,58039,97,0,33,2069,60238
2017-11-28,54753,61,0,7,1863,56684
2017-11-29,51605,86,0,39,1440,53170
2017-11-30,53674,92,0,0,2056,55822
2017-12-01,62419,152,0,11,1603,64185
2017-12-02,65585,129,0,2,1343,67059
2017-12-03,49887,126,0,45,1855,51913
2017-12-04,52803,71,0,16,1925,54815
2017-12-05,53193,77,0,24,1687,54981
2017-12-06,51254,93,0,54,1321,52722
2017-12-07,55602,83,0,6,1559,57250
2017-12-08,60179,126,0,33,1309,61647
2017-12-09,67379,107,0,16,1108,68610
2017-12-10,58777,328,0,67,1464,60636
2017-12-11,57028,72,0,0,1529,58629
2017-12-12,54573,90,0,0,1572,56235
2017-12-13,56767,86,0,72,1337,58262
2017-12-14,57866,162,0,1,1369,59398
2017-12-15,69201,152,0,42,1319,70714
2017-12-16,82577,522,0,19,1095,84213
2017-12-17,61587,142,0,71,1348,63148
2017-12-18,63206,167,0,4,1161,64538
2017-12-19,66031,119,0,7,1084,67241
2017-12-20,66065,132,0,46,1259,67502
2017-12-21,71892,120,0,9,1442,73463
2017-12-22,72269,352,0,21,1785,74427
2017-12-23,77977,250,0,2,1609,79838
2017-12-24,47290,112,0,0,1235,48637
2017-12-25,43983,98,0,18,374,44473
2017-12-26,65757,240,0,0,2072,68069
2017-12-27,75205,389,0,0,1923,77517
2017-12-28,70534,265,0,11,2707,73517
2017-12-29,80197,317,0,61,2897,83472
2017-12-30,84828,730,0,3,1994,87555
2017-12-31,48398,169,0,0,1234,49801
2018-01-01,41395,296,0,31,1417,43139
2018-01-02,70397,196,0,0,2031,72624
2018-01-03,75199,177,5,53,1894,77328
2018-01-04,74582,194,0,0,2078,76854
2018-01-05,84505,214,0,21,2164,86904
2018-01-06,90648,192,0,6,1973,92819
2018-01-07,71297,164,0,109,2561,74131
2018-01-08,69935,117,0,0,2032,72084
2018-01-09,56514,143,0,2,2278,58937
2018-01-10,59668,79,0,77,1862,61686
2018-01-11,61824,118,0,10,1484,63436
2018-01-12,63543,122,0,0,1217,64882
2018-01-13,68401,125,0,1,1327,69854
2018-01-14,53050,192,0,51,1883,55176
2018-01-15,38058,33,4,29,1687,39811
2018-01-16,37366,53,0,0,1651,39070
2018-01-17,41662,112,0,31,1415,43220
2018-01-18,43271,114,0,3,1089,44477
2018-01-19,46556,139,0,3,1230,47928
2018-01-20,53038,57,0,13,1151,54259
2018-01-21,39153,73,0,77,1600,40903
2018-01-22,43737,68,0,34,1787,45626
2018-01-23,35150,55,0,7,1512,36724
2018-01-24,36659,127,0,74,1392,38252
2018-01-25,40980,64,0,9,1168,42221
2018-01-26,46460,92,0,2,1324,47878
2018-01-27,52376,84,0,8,1014,53482
2018-01-28,40022,112,0,57,1773,41964
2018-01-29,39337,72,0,0,1058,40467
2018-01-30,41222,100,0,8,1551,42881
2018-01-31,38240,85,0,40,1321,39686
2018-02-01,42245,109,0,0,1200,43554
2018-02-02,46018,94,0,0,1328,47440
2018-02-03,42567,154,0,1,1025,43747
2018-02-04,38802,79,0,74,1630,40585
2018-02-05,40425,51,0,9,1786,42271
2018-02-06,38615,64,0,7,1733,40419
2018-02-07,33104,91,0,64,1359,34618
2018-02-08,36846,76,0,25,1377,38324
2018-02-09,45787,88,0,0,1522,47397
2018-02-10,54704,84,0,2,1201,55991
2018-02-11,42855,124,0,59,1594,44632
2018-02-12,39060,85,0,6,1568,40719
2018-02-13,32620,45,0,0,1670,34335
2018-02-14,40505,99,0,56,1483,42143
2018-02-15,44649,109,0,8,1551,46317
2018-02-16,48136,93,0,0,1349,49578
2018-02-17,59245,78,0,2,1058,60383
2018-02-18,40211,117,0,48,1667,42043
2018-02-19,44325,76,0,3,1867,46271
2018-02-20,41288,62,0,39,1630,43019
2018-02-21,40492,73,0,104,1504,42173
2018-02-22,35669,78,0,0,1514,37261
2018-02-23,41153,107,0,0,1514,42774
2018-02-24,46237,86,0,25,1204,47552
2018-02-25,33983,59,0,0,1674,35716
2018-02-26,33321,77,0,1,1671,35070
2018-02-27,25734,22,0,6,1708,27470
2018-02-28,31030,65,0,85,1374,32554
2018-03-01,33949,57,0,10,1518,35534
2018-03-02,37480,98,0,0,1331,38909
2018-03-03,45313,31,0,4,1241,46589
2018-03-04,38230,158,0,79,1899,40366
2018-03-05,39942,51,0,15,1862,41870
2018-03-06,38964,56,0,30,1967,41017
2018-03-07,41379,57,0,46,1645,43127
2018-03-08,45889,76,0,7,1392,47364
2018-03-09,51919,318,0,1,1489,53727
2018-03-10,63588,95,0,1,1252,64936
2018-03-11,49086,88,0,43,1610,50827
2018-03-12,43761,111,0,1,1597,45470
2018-03-13,40429,87,0,22,1637,42175
2018-03-14,43086,81,0,49,1494,44710
2018-03-15,48583,68,0,3,1392,50046
2018-03-16,53179,91,0,0,1265,54535
2018-03-17,60055,80,0,14,1101,61250
2018-03-18,46237,92,0,41,1660,48030
2018-03-19,44859,76,0,0,2007,46942
2018-03-20,41790,57,0,23,1599,43469
2018-03-21,42826,74,0,88,1514,44502
2018-03-22,44669,74,0,1,1299,46043
2018-03-23,49346,99,0,1,1234,50680
2018-03-24,61887,119,0,20,1365,63391
2018-03-25,49246,94,0,105,2106,51551
2018-03-26,48479,75,0,0,1955,50509
2018-03-27,49551,77,0,20,1935,51583
2018-03-28,52678,155,0,95,2280,55208
2018-03-29,65102,123,0,17,2813,68055
2018-03-30,67758,153,0,3,2908,70822
2018-03-31,60835,93,0,1,2583,63512
2018-04-01,44388,78,0,157,1325,45948
2018-04-02,78616,134,0,103,2802,81655
2018-04-03,61326,131,0,275,3130,64862
2018-04-04,62274,103,0,20,2719,65116
2018-04-05,57442,117,0,62,2293,59914
2018-04-06,57804,76,0,12,1856,59748
2018-04-07,67359,123,0,18,2000,69500
2018-04-08,60388,139,0,51,2339,62917
2018-04-09,54592,134,0,10,2481,57217
2018-04-10,51305,69,0,44,3268,54686
2018-04-11,47535,106,0,43,2500,50184
2018-04-12,53053,93,0,107,1938,55191
2018-04-13,55814,135,0,31,2148,58128
2018-04-14,64355,73,0,0,2006,66434
2018-04-15,57419,73,0,88,2116,59696
2018-04-16,52577,111,0,26,2561,55275
2018-04-17,47733,80,3,42,2339,50197
2018-04-18,48955,58,0,52,2110,51175
2018-04-19,51159,125,0,92,1962,53338
2018-04-20,60487,147,0,14,2367,63015
2018-04-21,66972,100,2,28,1600,68702
2018-04-22,62687,133,0,254,2220,65294
2018-04-23,52399,69,0,66,2266,54800
2018-04-24,51659,82,0,48,2187,53976
2018-04-25,54414,73,0,41,2110,56638
2018-04-26,54112,67,0,197,2165,56541
2018-04-27,63148,244,0,12,2696,66100
2018-04-28,73422,128,0,3,2985,76538
2018-04-29,63307,87,0,36,1763,65193
2018-04-30,65904,126,0,77,1583,67690
2018-05-01,59909,170,3,93,1860,62035
2018-05-02,55049,162,0,29,2318,57558
2018-05-03,58416,117,0,259,1881,60673
2018-05-04,62108,162,0,13,2021,64304
2018-05-05,70945,115,0,11,1706,72777
2018-05-06,61713,89,0,149,1871,63822
2018-05-07,54666,132,0,21,2055,56874
2018-05-08,51560,142,0,94,2118,53914
2018-05-09,49882,96,0,32,1959,51969
2018-05-10,63879,85,0,64,1951,65979
2018-05-11,61018,264,0,53,1713,63048
2018-05-12,78333,145,0,15,1441,79934
2018-05-13,65078,144,0,70,1910,67202
2018-05-14,55451,91,45,20,2579,58186
2018-05-15,51428,94,0,70,2542,54134
2018-05-16,53144,138,0,44,2136,55462
2018-05-17,57672,101,0,214,1994,59981
2018-05-18,59919,158,0,44,1943,62064
2018-05-19,69721,99,0,15,1642,71477
2018-05-20,59566,156,0,106,1694,61522
2018-05-21,62013,110,0,34,2617,64774
2018-05-22,55314,95,0,85,2205,57699
2018-05-23,49454,93,0,32,2066,51645
2018-05-24,56797,123,0,88,2068,59076
2018-05-25,58459,116,0,62,2065,60702
2018-05-26,63422,128,0,18,1598,65166
2018-05-27,60641,79,0,106,2460,63286
2018-05-28,56070,77,0,23,2211,58381
2018-05-29,49118,78,0,75,2118,51389
2018-05-30,58709,127,0,7,2508,61351
2018-05-31,74135,154,1,161,2386,76837
2018-06-01,68176,97,0,119,1798,70190
2018-06-02,79115,154,0,18,1220,80507
2018-06-03,64043,169,0,65,2758,67035
2018-06-04,60642,101,0,27,2209,62979
2018-06-05,54221,60,0,121,2008,56410
2018-06-06,55519,118,0,40,2060,57737
2018-06-07,59004,82,0,69,1707,60862
2018-06-08,61947,145,0,30,1574,63696
2018-06-09,68301,101,0,29,1388,69819
2018-06-10,67111,112,0,72,2079,69374
2018-06-11,62808,99,0,43,2190,65140
2018-06-12,56612,79,0,61,1734,58486
2018-06-13,57489,89,1,15,1963,59557
2018-06-14,62404,126,0,43,2143,64716
2018-06-15,72209,137,0,42,2221,74609
2018-06-16,65752,152,0,37,2396,68337
2018-06-17,73760,159,0,81,2289,76289
2018-06-18,66790,136,0,55,2673,69654
2018-06-19,56396,74,0,136,2473,59079
2018-06-20,58957,139,0,52,2723,61871
2018-06-21,68662,230,0,460,3207,72559
2018-06-22,86756,183,0,50,2829,89818
2018-06-23,77501,177,39,59,1701,79477
2018-06-24,70429,68,0,111,2344,72952
2018-06-25,70442,116,9,45,2340,72952
2018-06-26,65842,119,0,79,2328,68368
2018-06-27,61260,103,0,36,2158,63557
2018-06-28,62733,150,0,69,1951,64903
2018-06-29,71766,118,0,179,1587,73650
2018-06-30,80023,162,0,35,1380,81600
2018-07-01,80982,217,0,80,2324,83603
2018-07-02,63513,133,0,73,2242,65961
2018-07-03,60704,111,4,108,1814,62741
2018-07-04,60770,166,0,62,1883,62881
2018-07-05,64118,120,0,102,1855,66195
2018-07-06,64424,169,0,47,1994,66634
2018-07-07,70950,156,0,42,1850,72998
2018-07-08,70797,184,0,85,1994,73060
2018-07-09,68069,151,0,64,2023,70307
2018-07-10,62430,192,0,68,2379,65069
2018-07-11,62441,149,0,30,2346,64966
2018-07-12,65277,235,0,61,1472,67045
2018-07-13,70388,162,22,77,1828,72477
2018-07-14,81855,178,0,52,2037,84122
2018-07-15,69641,407,0,73,3157,73278
2018-07-16,65792,337,0,66,2309,68504
2018-07-17,68615,232,0,99,2157,71103
2018-07-18,68124,192,0,77,1931,70324
2018-07-19,72943,243,0,109,1571,74866
2018-07-20,81004,261,0,70,1594,82929
2018-07-21,86790,309,0,67,1627,88793
2018-07-22,76204,322,0,100,1950,78576
2018-07-23,77352,285,0,96,2071,79804
2018-07-24,70436,318,0,110,1611,72475
2018-07-25,67476,267,0,104,1893,69740
2018-07-26,73334,328,0,139,1764,75565
2018-07-27,79934,375,0,52,2529,82890
2018-07-28,84162,218,0,73,1314,85767
2018-07-29,81176,158,0,228,1781,83343
2018-07-30,84651,262,0,39,1877,86829
2018-07-31,77596,230,0,80,1842,79748
2018-08-01,74967,222,0,60,2231,77480
2018-08-02,77080,170,30,112,1935,79327
2018-08-03,54994,190,0,48,1636,56868
2018-08-04,85013,298,0,112,1794,87217
2018-08-05,77338,352,0,103,2101,79894
2018-08-06,78286,265,0,73,2175,80799
2018-08-07,72412,240,0,129,2082,74863
2018-08-08,68849,195,0,74,1756,70874
2018-08-09,73666,266,0,93,1605,75630
2018-08-10,78142,235,0,66,1765,80208
2018-08-11,80406,261,0,80,1655,82402
2018-08-12,75618,262,0,94,1926,77900
2018-08-13,77197,356,0,47,1687,79287
2018-08-14,81745,201,0,2049,1936,85931
2018-08-15,93127,133,0,63,2081,95404
2018-08-16,82599,122,0,95,1995,84811
2018-08-17,74842,169,0,62,1763,76836
2018-08-18,91802,238,0,93,1718,93851
2018-08-19,122541,83,0,139,1865,124628
2018-08-20,76708,275,0,87,2315,79385
2018-08-21,74091,271,0,116,2030,76508
2018-08-22,82711,301,0,168,2112,85292
2018-08-23,83196,87,0,66,2110,85459
2018-08-24,79346,248,0,76,1732,81402
2018-08-25,89972,202,0,60,1829,92063
2018-08-26,91993,222,0,101,2505,94821
2018-08-27,81293,204,0,96,2236,83829
2018-08-28,68612,106,0,147,2351,71216
2018-08-29,70318,212,0,64,2243,72837
2018-08-30,72693,150,0,86,2257,75186
2018-08-31,89069,170,0,65,2063,91367
2018-09-01,83868,134,0,129,1819,85950
2018-09-02,74090,248,0,134,2310,76782
2018-09-03,69074,158,0,65,2711,72008
2018-09-04,66208,121,0,129,2556,69014
2018-09-05,64425,141,0,100,2402,67068
2018-09-06,65040,157,0,136,2165,67498
2018-09-07,69310,138,0,56,1830,71334
2018-09-08,94220,190,0,73,1369,95852
2018-09-09,72321,204,0,111,2050,74686
2018-09-10,60173,112,0,48,2421,62754
2018-09-11,60621,109,0,94,2291,63115
2018-09-12,55886,246,0,40,2112,58284
2018-09-13,63705,123,1,44,2048,65921
2018-09-14,67902,126,0,103,1893,70024
2018-09-15,81805,121,0,69,1578,83573
2018-09-16,86782,235,0,123,1995,89135
2018-09-17,62358,163,0,77,2335,64933
2018-09-18,58656,100,0,128,2337,61221
2018-09-19,63092,155,0,44,2428,65719
2018-09-20,71161,151,0,161,2277,73750
2018-09-21,81742,131,0,152,2300,84325
2018-09-22,79247,144,0,113,1556,81060
2018-09-23,77268,176,0,109,2063,79616
2018-09-24,95441,216,0,55,9940,105652
2018-09-25,58145,104,0,106,2707,61062
2018-09-26,53656,211,0,18,2823,56708
2018-09-27,62535,135,0,77,2447,65194
2018-09-28,66800,129,0,82,1870,68881
2018-09-29,77813,77,0,69,1548,79507
2018-09-30,69630,92,0,309,2198,72229
2018-10-01,61863,101,0,49,2514,64527
2018-10-02,52045,140,0,69,1950,54204
2018-10-03,56920,88,0,26,2585,59619
2018-10-04,61203,114,0,211,3208,64736
2018-10-05,74787,306,0,61,3666,78820
2018-10-06,77460,87,0,142,1931,79620
2018-10-07,67257,115,0,85,2224,69681
2018-10-08,78791,126,0,66,2578,81561
2018-10-09,51303,72,0,57,2732,54164
2018-10-10,57660,68,0,19,2103,59850
2018-10-11,56866,93,0,151,2510,59620
2018-10-12,62841,208,0,43,2455,65547
2018-10-13,70293,79,0,37,1667,72076
2018-10-14,68362,70,0,130,2035,70597
2018-10-15,52678,94,0,41,3065,55878
2018-10-16,43312,86,0,178,2849,46425
2018-10-17,50484,69,0,21,2628,53202
2018-10-18,57422,74,0,175,2694,60365
2018-10-19,58755,648,0,21,2877,62301
2018-10-20,66992,65,0,19,2446,69522
2018-10-21,58548,52,0,126,2859,61585
2018-10-22,53011,87,0,62,2792,55952
2018-10-23,48963,92,0,31,2991,52077
2018-10-24,46775,93,0,18,2214,49100
2018-10-25,53348,78,0,171,2480,56077
2018-10-26,63630,107,0,26,1591,65354
2018-10-27,66206,57,0,2,1985,68250
2018-10-28,53504,65,0,33,1572,55174
2018-10-29,51292,73,0,0,1892,53257
2018-10-30,54926,73,0,6,1482,56487
2018-10-31,69706,121,0,80,1962,71869
2018-11-01,72066,182,0,8,2368,74624
2018-11-02,68035,130,0,10,1693,69868
2018-11-03,66735,106,0,64,1391,68296
2018-11-04,64014,155,0,121,1957,66247
2018-11-05,52656,101,0,0,2560,55317
2018-11-06,46431,103,0,10,2420,48964
2018-11-07,45508,75,0,68,1941,47592
2018-11-08,48669,84,0,9,1899,50661
2018-11-09,54783,143,0,3,2073,57002
2018-11-10,63491,99,0,19,1364,64973
2018-11-11,55040,102,0,142,1819,57103
2018-11-12,50886,61,0,3,2215,53165
2018-11-13,48039,101,0,7,2394,50541
2018-11-14,49700,91,0,59,1940,51790
2018-11-15,50332,102,0,0,2044,52478
2018-11-16,58176,87,0,1,1971,60235
2018-11-17,60276,95,0,29,1478,61878
2018-11-18,54068,31,0,106,1836,56041
2018-11-19,52474,69,0,0,2094,54637
2018-11-20,40756,64,0,1,1890,42711
2018-11-21,41797,83,0,86,1874,43840
2018-11-22,51809,60,0,14,2018,53901
2018-11-23,55642,71,0,11,1704,57428
2018-11-24,57670,61,0,4,1231,58966
2018-11-25,45614,65,0,88,1815,47582
2018-11-26,50311,45,0,11,2270,52637
2018-11-27,42828,46,0,0,1736,44610
2018-11-28,42410,50,0,40,1743,44243
2018-11-29,42876,54,0,0,1847,44777
2018-11-30,52542,139,0,48,1768,54497
2018-12-01,55203,497,0,4,1233,56937
2018-12-02,47361,555,0,428,1943,50287
2018-12-03,44314,61,0,22,1969,46366
2018-12-04,47641,88,0,39,1741,49509
2018-12-05,44515,87,0,47,1600,46249
2018-12-06,46357,91,0,4,1515,47967
2018-12-07,52724,112,0,6,1637,54479
2018-12-08,63133,399,0,0,1155,64687
2018-12-09,48325,626,0,59,1489,50499
2018-12-10,50962,81,0,28,1854,52925
2018-12-11,47585,88,0,13,1611,49297
2018-12-12,46959,70,0,50,1424,48503
2018-12-13,50896,113,0,0,1389,52398
2018-12-14,49223,176,0,10,1422,50831
2018-12-15,57283,588,0,11,1204,59086
2018-12-16,49779,205,0,73,1407,51464
2018-12-17,50896,80,0,7,1321,52304
2018-12-18,53022,129,0,16,1520,54687
2018-12-19,54043,92,0,84,1340,55559
2018-12-20,57166,116,0,2,1462,58746
2018-12-21,65897,268,0,16,1759,67940
2018-12-22,78936,281,0,1,1782,81000
2018-12-23,58724,728,0,44,1577,61073
2018-12-24,49437,118,0,3,1096,50654
2018-12-25,32673,184,0,0,520,33377
2018-12-26,60063,185,0,61,2241,62550
2018-12-27,72640,841,0,6,2555,76042
2018-12-28,70463,239,4,38,2573,73317
2018-12-29,79396,800,0,1,2689,82886
2018-12-30,70510,809,0,31,2320,73670
2018-12-31,50578,146,0,0,1340,52064
2019-01-01,28507,37,0,7,1432,29983
2019-01-02,70099,792,0,128,1979,72998
2019-01-03,69954,219,0,0,2073,72246
2019-01-04,74580,178,0,0,2438,77196
2019-01-05,96600,154,0,0,2160,98914
2019-01-06,69964,162,0,108,2851,73085
2019-01-07,51997,92,0,27,2758,54874
2019-01-08,52878,119,0,0,2219,55216
2019-01-09,46749,85,0,41,2047,48922
2019-01-10,54963,63,0,0,1698,56724
2019-01-11,54066,115,0,1,1674,55856
2019-01-12,65603,113,0,7,1426,67149
2019-01-13,47244,109,0,62,2154,49569
2019-01-14,45245,52,0,0,1973,47270
2019-01-15,45993,78,0,0,1897,47968
2019-01-16,44094,95,0,36,1607,45832
2019-01-17,47529,57,0,0,1543,49129
2019-01-18,49671,66,0,10,1540,51287
2019-01-19,53796,93,0,9,1274,55172
2019-01-20,43184,62,0,66,1814,45126
2019-01-21,43983,62,0,0,1851,45896
2019-01-22,41349,75,0,88,3178,44690
2019-01-23,34850,41,0,68,1533,36492
2019-01-24,37862,41,0,0,1402,39305
2019-01-25,43114,80,0,2,1317,44513
2019-01-26,51861,40,0,0,1169,53070
2019-01-27,40161,55,0,41,1913,42170
2019-01-28,41996,56,0,8,1816,43876
2019-01-29,39017,57,0,7,1577,40658
2019-01-30,41946,62,0,35,1348,43391
2019-01-31,45580,59,0,1,1281,46921
2019-02-01,49561,75,0,0,1494,51130
2019-02-02,54398,62,0,1,1241,55702
2019-02-03,44159,69,0,53,1846,46127
2019-02-04,45377,55,0,0,2079,47511
2019-02-05,42617,85,0,55,1726,44483
2019-02-06,43116,84,0,31,1460,44691
2019-02-07,45988,80,0,28,1232,47328
2019-02-08,50278,75,0,7,1416,51776
2019-02-09,61281,55,0,2,1357,62695
2019-02-10,49555,84,0,56,1808,51503
2019-02-11,47586,58,0,0,1937,49581
2019-02-12,42041,65,0,4,1734,43844
2019-02-13,44998,58,0,43,1535,46634
2019-02-14,52055,97,0,3,1643,53798
2019-02-15,55099,98,0,14,1286,56497
2019-02-16,64120,116,0,4,1292,65532
2019-02-17,50057,84,0,62,1909,52112
2019-02-18,51614,89,0,53,2263,54019
2019-02-19,43337,81,0,29,1870,45317
2019-02-20,46802,64,0,48,1715,48629
2019-02-21,47792,71,0,7,1552,49422
2019-02-22,45126,94,0,6,961,46187
2019-02-23,55594,97,0,0,1120,56811
2019-02-24,47888,95,0,46,1837,49866
2019-02-25,45528,76,0,1,2077,47682
2019-02-26,44088,55,0,8,1803,45954
2019-02-27,44888,84,0,71,1575,46618
2019-02-28,53143,80,0,65,1567,54855
2019-03-01,57651,112,0,3,1795,59561
2019-03-02,65826,81,0,6,1336,67249
2019-03-03,53894,95,0,70,2027,56086
2019-03-04,50842,69,0,33,2103,53047
2019-03-05,49152,58,0,9,2157,51376
2019-03-06,46617,80,0,59,1665,48421
2019-03-07,50776,102,0,75,1497,52450
2019-03-08,60706,753,0,1,1586,63046
2019-03-09,68914,68,0,14,1394,70390
2019-03-10,55786,108,0,64,1768,57726
2019-03-11,49310,87,0,25,2184,51606
2019-03-12,48061,63,0,1,2473,50598
2019-03-13,47508,69,0,150,2097,49824
2019-03-14,49985,69,0,16,1660,51730
2019-03-15,57360,84,0,3,1535,58982
2019-03-16,66388,88,0,1,1302,67779
2019-03-17,54932,97,0,92,1762,56883
2019-03-18,51298,74,0,18,2140,53530
2019-03-19,45719,72,0,0,1901,47692
2019-03-20,47581,64,0,62,1654,49361
2019-03-21,51169,71,0,6,1381,52627
2019-03-22,57292,82,0,17,1517,58908
2019-03-23,63472,77,0,0,1195,64744
2019-03-24,58034,89,0,61,1768,59952
2019-03-25,50497,87,0,0,2252,52836
2019-03-26,45803,79,0,7,1912,47801
2019-03-27,46885,65,0,66,1326,48342
2019-03-28,49883,69,0,9,1610,51571
2019-03-29,55953,87,0,0,1433,57473
2019-03-30,61102,81,0,15,1141,62339
2019-03-31,56475,182,0,107,2615,59379
2019-04-01,51855,71,1,43,3145,55115
2019-04-02,46524,86,0,51,2801,49462
2019-04-03,50635,77,12,21,2326,53071
2019-04-04,50348,83,0,50,1977,52458
2019-04-05,59383,113,0,1,2012,61509
2019-04-06,65519,83,0,11,2000,67613
2019-04-07,58399,61,1,68,2105,60634
2019-04-08,50510,109,0,12,2456,53087
2019-04-09,46675,125,1,71,2087,48959
2019-04-10,52081,117,0,28,2119,54345
2019-04-11,55256,80,3,172,2064,57575
2019-04-12,59560,115,0,0,1932,61607
2019-04-13,67797,50,0,2,1909,69758
2019-04-14,56548,105,0,84,1994,58731
2019-04-15,58616,75,0,114,2295,61100
2019-04-16,54418,84,0,133,2331,56966
2019-04-17,60419,80,0,22,2599,63120
2019-04-18,74068,101,0,161,3635,77965
2019-04-19,85951,101,0,14,3236,89302
2019-04-20,65480,121,0,19,2402,68022
2019-04-21,51067,79,0,393,1752,53291
2019-04-22,99339,132,0,28,3357,102856
2019-04-23,68000,146,0,501,3887,72534
2019-04-24,59012,129,0,55,3221,62417
2019-04-25,62620,168,0,66,3266,66120
2019-04-26,67300,119,0,76,2295,69790
2019-04-27,76940,91,0,12,2733,79776
2019-04-28,60052,153,0,95,2432,62732
2019-04-29,55936,75,0,39,2682,58732
2019-04-30,66572,98,0,164,2513,69347
2019-05-01,54336,122,0,19,3339,57816
2019-05-02,55451,142,0,110,2824,58527
2019-05-03,66583,126,1,20,2299,69029
2019-05-04,77331,110,0,7,2349,79797
2019-05-05,67190,104,0,72,2721,70087
2019-05-06,57702,82,0,31,2778,60593
2019-05-07,50894,79,24,63,2969,54029
2019-05-08,54125,92,0,12,2335,56564
2019-05-09,57062,66,1,54,4382,61565
2019-05-10,62000,260,0,39,2156,64455
2019-05-11,65717,75,0,9,1896,67697
2019-05-12,58316,69,0,123,2611,61119
2019-05-13,55598,67,0,8,3034,58707
2019-05-14,48857,68,0,88,2721,51734
2019-05-15,53624,65,0,52,2471,56212
2019-05-16,54267,74,0,66,2667,57074
2019-05-17,60622,101,0,33,2701,63457
2019-05-18,67848,168,0,3,1708,69727
2019-05-19,56317,123,0,68,2463,58971
2019-05-20,56331,103,0,18,2990,59442
2019-05-21,53272,54,0,69,2453,55848
2019-05-22,54907,83,0,25,1874,56889
2019-05-23,53981,100,0,116,2271,56468
2019-05-24,63207,138,0,103,1876,65324
2019-05-25,64885,86,0,21,1491,66483
2019-05-26,51040,80,0,63,2097,53280
2019-05-27,56153,82,13,15,2304,58567
2019-05-28,52035,56,1,106,2184,54382
2019-05-29,52611,131,0,3,1622,54367
2019-05-30,59145,82,4,72,1860,61163
2019-05-31,62526,113,0,44,1926,64609
2019-06-01,69832,72,1,21,1598,71524
2019-06-02,64299,126,0,69,1933,66427
2019-06-03,60662,69,0,31,2594,63356
2019-06-04,57762,103,0,84,2603,60552
2019-06-05,57677,76,0,39,2185,59977
2019-06-06,61609,109,1,49,2093,63861
2019-06-07,63546,98,0,57,2088,65789
2019-06-08,73942,67,0,28,1391,75428
2019-06-09,66939,145,0,95,1813,68992
2019-06-10,65919,126,0,80,2590,68715
2019-06-11,64557,80,0,70,2479,67186
2019-06-12,64815,91,8,28,2142,67084
2019-06-13,63794,116,0,94,1892,65896
2019-06-14,67986,103,0,79,2093,70261
2019-06-15,81150,164,0,62,1882,83258
2019-06-16,69433,85,44,79,2559,72200
2019-06-17,66422,139,0,106,2453,69120
2019-06-18,66257,136,0,205,2678,69276
2019-06-19,72866,110,0,16,3227,76219
2019-06-20,95383,203,0,190,4015,99791
2019-06-21,74298,180,0,173,2625,77276
2019-06-22,91616,151,0,64,1882,93713
2019-06-23,86119,176,0,78,2359,88732
2019-06-24,78068,165,1,81,2498,80813
2019-06-25,70103,194,1,51,2735,73084
2019-06-26,61440,126,0,40,2160,63766
2019-06-27,68691,181,1,69,2300,71242
2019-06-28,71750,147,0,35,1950,73882
2019-06-29,93714,185,1,48,1465,95413
2019-06-30,70910,169,0,86,2674,73839
2019-07-01,72384,160,0,97,2468,75109
2019-07-02,65858,116,1,80,2159,68214
2019-07-03,63991,121,0,55,1861,66028
2019-07-04,65828,281,0,149,1957,68215
2019-07-05,74784,146,0,107,1552,76589
2019-07-06,83568,147,24,47,1289,85075
2019-07-07,71769,118,0,148,2197,74232
2019-07-08,67083,211,0,88,2483,69865
2019-07-09,66814,254,0,79,2064,69211
2019-07-10,69752,111,1,5,1916,71785
2019-07-11,63834,201,0,59,1899,65993
2019-07-12,73136,190,0,79,1788,75193
2019-07-13,81719,183,0,63,1433,83398
2019-07-14,82064,153,0,96,2427,84740
2019-07-15,70886,215,0,93,1961,73155
2019-07-16,65437,168,1,136,2233,67975
2019-07-17,71020,156,0,94,1722,72992
2019-07-18,75035,246,0,89,1916,77286
2019-07-19,77026,236,0,45,1807,79114
2019-07-20,91546,224,1,43,1524,93338
2019-07-21,96911,233,0,127,2170,99441
2019-07-22,78797,337,0,91,2243,81468
2019-07-23,65536,173,0,115,2277,68101
2019-07-24,67783,153,0,66,1832,69834
2019-07-25,74724,218,0,69,1896,76907
2019-07-26,81167,311,32,32,1682,83224
2019-07-27,81354,171,0,44,711,82280
2019-07-28,77277,301,0,76,2052,79706
2019-07-29,82730,125,0,106,1994,84955
2019-07-30,74533,204,0,80,2086,76903
2019-07-31,73306,183,1,58,1880,75428
2019-08-01,74181,213,0,100,2510,77004
2019-08-02,89760,189,1,91,2374,92415
2019-08-03,113304,224,0,69,1986,115583
2019-08-04,100234,213,0,75,2370,102892
2019-08-05,87115,217,1,67,2267,89667
2019-08-06,61853,195,0,62,2420,64530
2019-08-07,80531,190,0,72,1952,82745
2019-08-08,86949,179,0,65,2140,89333
2019-08-09,80055,179,0,81,1850,82165
2019-08-10,115116,204,0,79,1572,116971
2019-08-11,93209,220,0,79,2485,95993
2019-08-12,101060,213,0,82,1912,103267
2019-08-13,80026,230,0,69,2213,82538
2019-08-14,99961,201,2,52,1955,102171
2019-08-15,91064,228,0,107,2616,94015
2019-08-16,96967,301,0,84,1955,99307
2019-08-17,104986,185,0,64,1875,107110
2019-08-18,117117,240,0,98,2615,120070
2019-08-19,82802,186,0,120,2591,85699
2019-08-20,74990,168,0,245,1337,76740
2019-08-21,78940,157,0,145,2269,81511
2019-08-22,85499,121,0,67,2458,88145
2019-08-23,91323,131,0,61,2095,93610
2019-08-24,88498,194,0,219,914,89825
2019-08-25,87478,170,0,153,2871,90672
2019-08-26,71559,122,1,198,3423,75303
2019-08-27,73286,125,0,147,3051,76609
2019-08-28,79227,142,0,97,2658,82124
2019-08-29,72962,143,0,106,2708,75919
2019-08-30,87677,163,0,102,2003,89945
2019-08-31,89874,156,2,59,2001,92092
2019-09-01,83285,158,0,128,3291,86862
2019-09-02,66651,190,0,71,2684,69596
2019-09-03,68193,96,0,76,2826,71191
2019-09-04,64960,125,0,52,2279,67416
2019-09-05,66720,133,0,102,2594,69549
2019-09-06,78969,158,0,24,2210,81361
2019-09-07,86355,154,0,101,1588,88198
2019-09-08,69764,105,1,54,2445,72369
2019-09-09,59699,156,0,82,2571,62508
2019-09-10,60731,109,0,107,2575,63522
2019-09-11,55974,106,1,57,2397,58535
2019-09-12,60463,95,0,150,2518,63226
2019-09-13,70325,166,0,100,2127,72718
2019-09-14,77080,129,0,76,1741,79026
2019-09-15,72633,173,0,91,2371,75268
2019-09-16,61721,127,0,41,2586,64475
2019-09-17,58060,118,0,143,2779,61100
2019-09-18,60609,103,1,21,2553,63287
2019-09-19,63438,148,0,205,2696,66487
2019-09-20,68456,105,0,59,2195,70815
2019-09-21,81193,124,0,200,1615,83132
2019-09-22,64745,134,0,118,2579,67576
2019-09-23,55910,125,0,29,2512,58576
2019-09-24,55849,98,0,170,2584,58701
2019-09-25,58600,99,1,41,2559,61300
2019-09-26,62808,114,2,260,2616,65800
2019-09-27,67500,158,0,30,937,68625
2019-09-28,73047,98,0,88,1518,74751
2019-09-29,65885,144,0,179,2557,68765
2019-09-30,59573,91,0,15,3047,62726
2019-10-01,59406,48,0,185,3128,62767
2019-10-02,54329,99,0,5,2700,57133
2019-10-03,63147,73,0,136,3264,66620
2019-10-04,67636,122,0,69,3683,71510
2019-10-05,81991,142,2,214,3280,85629
2019-10-06,72104,76,0,194,2881,75255
2019-10-07,63045,105,0,36,2729,65915
2019-10-08,73024,102,0,86,3307,76519
2019-10-09,47583,66,0,81,2954,50684
2019-10-10,59011,105,0,146,2892,62154
2019-10-11,65283,408,0,87,2711,68489
2019-10-12,73016,129,0,100,2711,75956
2019-10-13,66442,126,0,99,3195,69862
2019-10-14,56010,87,2,93,3088,59280
2019-10-15,54692,107,0,120,3266,58185
2019-10-16,52501,128,0,7,2940,55576
2019-10-17,55485,87,436,249,3104,59361
2019-10-18,61319,299,0,137,2599,64354
2019-10-19,70978,146,0,6,2771,73901
2019-10-20,61375,137,0,67,3092,64671
2019-10-21,55321,69,0,82,3447,58919
2019-10-22,51013,71,2,160,4192,55438
2019-10-23,49144,74,0,43,2459,51720
2019-10-24,52857,106,0,98,2650,55711
2019-10-25,68333,96,0,38,3121,71588
2019-10-26,72317,110,0,20,2459,74906
2019-10-27,63778,153,11,60,1941,65943
2019-10-28,55822,112,1,16,1957,57908
2019-10-29,56194,91,0,67,1943,58295
2019-10-30,59574,85,0,10,1652,61321
2019-10-31,80234,155,0,32,422,80843
2019-11-01,83733,99,0,11,1842,85685
2019-11-02,76458,73,0,6,1681,78218
2019-11-03,68670,162,0,120,2363,71315
2019-11-04,60756,95,0,37,2693,63581
2019-11-05,48218,129,0,66,2729,51142
2019-11-06,51329,65,0,130,1970,53494
2019-11-07,53191,73,0,33,2034,55331
2019-11-08,60591,96,0,38,1460,62185
2019-11-09,63605,190,0,20,1356,65171
2019-11-10,56847,82,0,121,2089,59139
2019-11-11,52721,73,0,49,2283,55126
2019-11-12,48174,112,0,4,2264,50554
2019-11-13,50973,121,0,0,1680,52774
2019-11-14,53542,82,0,32,2079,55735
2019-11-15,59349,95,0,7,1838,61289
2019-11-16,64651,88,0,3,1396,66138
2019-11-17,55492,144,0,147,2327,58110
2019-11-18,52765,66,0,2,2563,55396
2019-11-19,50453,60,0,5,2318,52836
2019-11-20,51207,60,0,179,1854,53300
2019-11-21,54544,93,0,4,1649,56290
2019-11-22,58611,99,0,4,1719,60433
2019-11-23,61924,56,0,9,1457,63446
2019-11-24,54290,88,0,63,2105,56546
2019-11-25,53139,129,0,50,2583,55901
2019-11-26,48845,64,0,18,1770,50697
2019-11-27,46627,44,0,67,1808,48546
2019-11-28,51206,79,0,13,1799,53097
2019-11-29,58603,159,0,0,1624,60386
2019-11-30,61503,206,0,28,1323,63060
2019-12-01,50070,100,0,73,2061,52304
2019-12-02,48826,73,0,0,2250,51149
2019-12-03,46670,111,0,5,1878,48664
2019-12-04,51521,67,0,94,1649,53331
2019-12-05,49462,72,0,65,1895,51494
2019-12-06,56105,115,0,0,1464,57684
2019-12-07,69495,136,0,12,1259,70902
2019-12-08,54572,340,0,51,1980,56943
2019-12-09,51030,190,0,3,2027,53250
2019-12-10,45094,160,0,0,1534,46788
2019-12-11,48445,69,0,54,1586,50154
2019-12-12,51769,135,0,5,1517,53426
2019-12-13,53862,159,0,0,1404,55425
2019-12-14,76491,625,0,1,1284,78401
2019-12-15,60863,359,0,45,1850,63117
2019-12-16,56900,121,0,44,1532,58597
2019-12-17,56661,140,0,6,1517,58324
2019-12-18,57373,145,0,64,1303,58885
2019-12-19,67952,104,0,0,1580,69636
2019-12-20,72603,272,0,13,1683,74571
2019-12-21,83532,305,0,6,1524,85367
2019-12-22,62246,188,0,56,2079,64569
2019-12-23,73573,135,0,10,1340,75058
2019-12-24,52445,102,0,4,1123,53674
2019-12-25,36057,83,0,0,498,36638
2019-12-26,62278,169,0,72,2477,64996
2019-12-27,77953,316,0,2,2704,80975
2019-12-28,77380,506,0,23,2505,80414
2019-12-29,67535,376,0,90,3178,71179
2019-12-30,80504,693,0,5,2462,83664
2019-12-31,50312,100,0,0,1800,52212
2020-01-01,34575,18,0,0,1606,36199
2020-01-02,64508,244,0,46,2341,67139
2020-01-03,86886,222,0,1,2154,89263
2020-01-04,105179,271,0,0,2041,107491
2020-01-05,81056,248,0,96,2636,84036
2020-01-06,59242,130,0,7,2410,61789
2020-01-07,45997,91,0,28,2751,48867
2020-01-08,53198,78,0,49,1929,55254
2020-01-09,54976,119,0,0,2032,57127
2020-01-10,59054,118,0,0,1642,60814
2020-01-11,62847,71,0,7,1577,64502
2020-01-12,54311,86,0,44,2543,56984
2020-01-13,48464,67,0,13,2000,50544
2020-01-14,44299,58,0,8,1701,46066
2020-01-15,45775,54,0,55,1864,47748
2020-01-16,49693,99,0,11,1636,51439
2020-01-17,51950,76,0,6,1546,53578
2020-01-18,59231,90,0,0,1291,60612
2020-01-19,43798,72,0,66,2069,46005
2020-01-20,49178,55,0,1,1936,51170
2020-01-21,44152,51,0,6,1729,45938
2020-01-22,44470,56,0,45,1744,46315
2020-01-23,47927,60,0,0,1365,49352
2020-01-24,51843,61,0,8,1684,53596
2020-01-25,56603,49,0,4,1293,57949
2020-01-26,42378,69,0,38,2314,44799
2020-01-27,41909,64,0,1,1736,43710
2020-01-28,44380,50,0,2,1591,46023
2020-01-29,42718,53,0,44,1489,44304
2020-01-30,46007,62,0,0,1285,47354
2020-01-31,50121,91,0,6,209,50427
2020-02-01,58511,71,0,6,1316,59904
2020-02-02,44409,61,0,61,1894,46425
2020-02-03,48485,95,0,30,1949,50559
2020-02-04,41813,80,0,8,1528,43429
2020-02-05,42486,60,0,26,1516,44088
2020-02-06,44184,46,0,18,1287,45535
2020-02-07,49602,57,0,3,228,49890
2020-02-08,59274,64,0,11,1291,60640
2020-02-09,49006,67,0,56,1856,50985
2020-02-10,46004,81,0,0,1700,47785
2020-02-11,45983,61,0,4,1789,47837
2020-02-12,45739,75,0,81,1411,47306
2020-02-13,49193,72,0,4,1528,50797
2020-02-14,56063,93,0,12,1527,57695
2020-02-15,64830,90,0,0,1404,66324
2020-02-16,52437,122,0,98,2100,54757
2020-02-17,51080,134,0,36,2133,53383
2020-02-18,44990,54,0,17,2056,47117
2020-02-19,50301,83,0,46,1576,52006
2020-02-20,50502,76,0,41,1474,52093
2020-02-21,56850,92,0,5,1357,58304
2020-02-22,59181,78,0,1,1390,60650
2020-02-23,54795,96,0,45,1963,56899
2020-02-24,48177,76,0,0,1843,50096
2020-02-25,44935,63,0,0,1845,46843
2020-02-26,40199,52,0,27,1491,41769
2020-02-27,46105,77,0,2,1445,47629
2020-02-28,49307,87,0,0,1327,50721
2020-02-29,54952,56,0,0,1246,56254
2020-03-01,44375,64,0,55,1872,46366
2020-03-02,44862,81,0,0,2121,47064
2020-03-03,39875,30,0,0,1649,41554
2020-03-04,45690,57,0,63,1347,47157
2020-03-05,44994,39,0,12,1238,46283
2020-03-06,51300,96,0,0,1272,52668
2020-03-07,55390,43,0,3,1127,56563
2020-03-08,51604,66,0,35,1555,53260
2020-03-09,43519,37,0,13,1517,45086
2020-03-10,41901,32,0,3,1309,43245
2020-03-11,41203,63,0,6,984,42256
2020-03-12,42470,65,0,12,876,43423
2020-03-13,36749,46,0,15,608,37418
2020-03-14,29531,70,0,0,564,30165
2020-03-15,10981,26,0,6,732,11745
2020-03-16,10166,0,0,4,420,10590
2020-03-17,8003,0,0,2,472,8477
2020-03-18,6749,5,0,4,267,7025
2020-03-19,5165,9,0,3,215,5392
2020-03-20,4849,0,0,0,152,5001
2020-03-21,2278,0,0,6,154,2438
2020-03-22,1991,0,0,0,99,2090
2020-03-23,4094,0,0,0,109,4203
2020-03-24,3607,0,0,0,75,3682
2020-03-25,3175,0,0,1,74,3250
2020-03-26,3812,10,0,0,32,3854
2020-03-27,2976,0,0,0,85,3061
2020-03-28,1754,0,0,0,59,1813
2020-03-29,1464,0,0,47,75,1586
2020-03-30,4811,0,0,0,59,4870
2020-03-31,3797,0,0,0,25,3822
2020-04-01,4508,0,0,3,34,4545
2020-04-02,3747,0,0,16,28,3791
2020-04-03,3990,4,0,0,82,4076
2020-04-04,1539,0,0,6,57,1602
2020-04-05,1545,0,0,0,22,1567
2020-04-06,4788,0,0,13,55,4856
2020-04-07,4720,0,0,0,15,4735
2020-04-08,4265,0,0,6,39,4310
2020-04-09,4773,23,0,0,25,4821
2020-04-10,3469,2,0,0,24,3495
2020-04-11,830,0,0,0,18,848
2020-04-12,271,0,0,0,14,285
2020-04-13,2256,0,0,0,171,2427
2020-04-14,5920,0,0,0,123,6043
2020-04-15,5212,0,0,0,147,5359
2020-04-16,4774,0,0,0,23,4797
2020-04-17,5143,0,0,1,34,5178
2020-04-18,1884,0,0,1,42,1927
2020-04-19,2444,0,0,0,66,2510
2020-04-20,7101,0,0,0,61,7162
2020-04-21,5506,0,0,0,34,5540
2020-04-22,6041,0,0,0,46,6087
2020-04-23,5635,0,0,0,36,5671
2020-04-24,5736,0,0,3,31,5770
2020-04-25,2622,19,0,0,55,2696
2020-04-26,3058,0,0,5,72,3135
2020-04-27,6794,0,0,27,229,7050
2020-04-28,6379,0,0,7,55,6441
2020-04-29,6411,22,0,12,65,6510
2020-04-30,6153,0,0,0,78,6231
2020-05-01,1947,0,0,0,59,2006
2020-05-02,2697,0,0,0,71,2768
2020-05-03,7248,0,0,5,76,7329
2020-05-04,9661,0,0,23,85,9769
2020-05-05,8421,0,0,7,48,8476
2020-05-06,8091,0,0,23,60,8174
2020-05-07,7895,0,0,0,66,7961
2020-05-08,7422,0,0,6,41,7469
2020-05-09,4297,0,0,12,69,4378
2020-05-10,5474,20,0,11,63,5568
2020-05-11,11055,39,0,0,67,11161
2020-05-12,9614,0,0,5,79,9698
2020-05-13,10949,0,0,11,112,11072
2020-05-14,10277,0,0,6,91,10374
2020-05-15,10813,0,0,0,159,10972
2020-05-16,8067,0,0,0,115,8182
2020-05-17,13217,0,0,16,77,13310
2020-05-18,17257,0,0,1,90,17348
2020-05-19,14686,2,0,1,110,14799
2020-05-20,14940,0,0,8,106,15054
2020-05-21,18230,0,0,13,109,18352
2020-05-22,20718,0,0,23,115,20856
2020-05-23,17437,10,0,0,109,17556
2020-05-24,23362,0,0,41,105,23508
2020-05-25,27068,0,1,34,185,27288
2020-05-26,23459,0,0,3,165,23627
2020-05-27,22651,0,0,14,148,22813
2020-05-28,23740,0,4,4,128,23876
2020-05-29,30908,0,0,0,234,31142
2020-05-30,33403,0,0,32,150,33585
2020-05-31,30407,0,0,12,229,30648
2020-06-01,47104,0,0,24,248,47376
2020-06-02,42420,0,0,0,197,42617
2020-06-03,40107,0,0,18,206,40331
2020-06-04,39443,0,0,15,172,39630
2020-06-05,43502,0,0,0,131,43633
2020-06-06,51136,0,0,6,237,51379
2020-06-07,42321,0,0,24,315,42660
2020-06-08,44539,0,0,35,323,44897
2020-06-09,41662,0,0,33,183,41878
2020-06-10,52950,0,0,13,177,53140
2020-06-11,62887,0,0,4,206,63097
2020-06-12,50841,0,0,0,138,50979
2020-06-13,54408,18,0,5,210,54641
2020-06-14,47588,0,0,29,421,48038
2020-06-15,44729,0,0,0,411,45140
2020-06-16,40301,0,0,2,369,40672
2020-06-17,43104,0,0,47,307,43458
2020-06-18,45211,0,0,9,296,45516
2020-06-19,52432,0,0,4,305,52741
2020-06-20,48440,0,0,2,457,48899
2020-06-21,35581,0,0,28,547,36156
2020-06-22,47869,6,0,33,441,48349
2020-06-23,39853,32,0,18,337,40240
2020-06-24,43327,21,0,6,304,43658
2020-06-25,21506,27,0,17,412,21962
2020-06-26,27143,17,0,15,285,27460
2020-06-27,23542,27,0,23,408,24000
2020-06-28,28460,42,0,48,681,29231
2020-06-29,25927,67,0,16,555,26565
2020-06-30,26542,33,0,43,386,27004
2020-07-01,35450,40,0,0,594,36084
2020-07-02,42627,54,0,16,455,43152
2020-07-03,51420,42,0,14,509,51985
2020-07-04,43536,46,0,9,623,44214
2020-07-05,51186,70,0,41,1030,52327
2020-07-06,39770,61,0,32,773,40636
2020-07-07,36524,31,0,67,427,37049
2020-07-08,39688,31,0,19,466,40204
2020-07-09,39519,40,0,21,450,40030
2020-07-10,40628,41,0,1,511,41181
2020-07-11,40101,54,0,15,596,40766
2020-07-12,43613,70,0,38,964,44685
2020-07-13,35252,59,0,19,632,35962
2020-07-14,31492,75,0,47,499,32113
2020-07-15,36241,59,0,31,537,36868
2020-07-16,34473,45,0,32,567,35117
2020-07-17,38453,37,0,9,562,39061
2020-07-18,36613,44,0,0,714,37371
2020-07-19,38687,74,0,58,1115,39934
2020-07-20,39418,51,5,43,783,40300
2020-07-21,35319,48,0,64,654,36085
2020-07-22,35934,75,0,11,561,36581
2020-07-23,40861,66,0,26,534,41487
2020-07-24,42797,32,0,3,661,43493
2020-07-25,43537,64,0,9,825,44435
2020-07-26,45094,53,0,56,1189,46392
2020-07-27,41901,54,0,14,766,42735
2020-07-28,38334,49,0,33,638,39054
2020-07-29,40792,67,0,13,529,41401
2020-07-30,42962,18,0,38,616,43634
2020-07-31,48852,73,0,16,653,49594
2020-08-01,53423,79,0,28,1201,54731
2020-08-02,50259,77,0,40,1601,51977
2020-08-03,43425,50,0,11,932,44418
2020-08-04,47013,67,0,38,875,47993
2020-08-05,53751,64,0,5,732,54552
2020-08-06,45013,66,0,20,774,45873
2020-08-07,46679,34,0,38,925,47676
2020-08-08,54055,83,0,13,1160,55311
2020-08-09,56460,141,0,35,1683,58319
2020-08-10,53042,29,0,9,966,54046
2020-08-11,45303,474,0,46,891,46714
2020-08-12,47438,65,0,16,851,48370
2020-08-13,51566,43,0,74,853,52536
2020-08-14,59498,78,0,16,1022,60614
2020-08-15,51754,64,0,20,1385,53223
2020-08-16,55226,98,0,42,2036,57402
2020-08-17,43873,60,0,30,1322,45285
2020-08-18,37536,45,0,27,1043,38651
2020-08-19,40041,34,0,14,899,40988
2020-08-20,41267,67,0,23,972,42329
2020-08-21,45448,48,0,5,1125,46626
2020-08-22,42573,75,0,29,1371,44048
2020-08-23,56828,56,0,31,1802,58717
2020-08-24,36191,57,0,10,904,37162
2020-08-25,35242,44,0,38,1023,36347
2020-08-26,36522,87,0,10,989,37608
2020-08-27,37937,92,0,34,854,38917
2020-08-28,40676,73,0,9,1049,41807
2020-08-29,40601,69,0,7,1430,42107
2020-08-30,42124,88,0,35,1830,44077
2020-08-31,34910,33,0,16,967,35926
2020-09-01,33741,32,0,39,943,34755
2020-09-02,36120,25,0,17,742,36904
2020-09-03,33937,38,0,25,768,34768
2020-09-04,34250,34,2,8,930,35224
2020-09-05,36509,37,0,0,1178,37724
2020-09-06,36890,45,0,43,1456,38434
2020-09-07,32527,25,0,14,809,33375
2020-09-08,30421,27,0,35,671,31154
2020-09-09,31372,38,0,6,615,32031
2020-09-10,33662,48,0,28,633,34371
2020-09-11,35351,44,0,8,754,36157
2020-09-12,35440,40,0,12,792,36284
2020-09-13,34846,32,0,35,1311,36224
2020-09-14,33377,37,0,37,719,34170
2020-09-15,31906,54,0,19,711,32690
2020-09-16,31633,34,0,29,581,32277
2020-09-17,33590,17,0,15,562,34184
2020-09-18,36163,20,0,0,533,36716
2020-09-19,35433,19,0,7,854,36313
2020-09-20,35040,40,0,35,1135,36250
2020-09-21,34974,33,0,21,798,35826
2020-09-22,31176,49,0,9,559,31793
2020-09-23,31427,55,0,19,650,32151
2020-09-24,31437,36,0,55,532,32060
2020-09-25,35088,22,0,0,576,35686
2020-09-26,35397,46,0,23,828,36294
2020-09-27,32435,31,0,21,1117,33604
2020-09-28,30801,14,0,15,735,31565
2020-09-29,32640,53,0,4,461,33158
2020-09-30,33741,41,0,34,615,34431
2020-10-01,36167,41,0,39,556,36803
2020-10-02,39059,50,0,1,579,39689
2020-10-03,40384,50,0,0,718,41152
2020-10-04,35276,37,0,26,852,36191
2020-10-05,37719,29,0,5,680,38433
2020-10-06,32903,21,0,13,417,33354
2020-10-07,33420,57,0,22,545,34044
2020-10-08,34795,32,0,62,391,35280
2020-10-09,39833,25,0,8,592,40458
2020-10-10,42402,26,0,14,736,43178
2020-10-11,33777,49,0,33,751,34610
2020-10-12,38225,32,0,5,717,38979
2020-10-13,34476,19,0,42,502,35039
2020-10-14,34123,35,0,54,535,34747
2020-10-15,33793,31,0,32,495,34351
2020-10-16,35882,37,0,9,594,36522
2020-10-17,37192,35,0,18,754,37999
2020-10-18,33247,27,0,36,648,33958
2020-10-19,34824,27,0,9,557,35417
2020-10-20,32736,24,0,21,464,33245
2020-10-21,30896,21,0,31,419,31367
2020-10-22,32125,18,0,41,399,32583
2020-10-23,36200,16,0,0,450,36666
2020-10-24,35991,23,0,3,844,36861
2020-10-25,30125,25,0,35,477,30662
2020-10-26,32894,30,0,4,430,33358
2020-10-27,29033,20,0,0,239,29292
2020-10-28,29119,12,0,62,438,29631
2020-10-29,32108,20,0,1,328,32457
2020-10-30,40611,32,0,25,516,41184
2020-10-31,40609,26,0,3,366,41004
2020-11-01,33082,49,0,36,517,33684
2020-11-02,33560,24,0,1,495,34080
2020-11-03,27463,24,0,6,249,27742
2020-11-04,27855,35,0,29,366,28285
2020-11-05,28558,30,0,0,248,28836
2020-11-06,32442,28,0,0,475,32945
2020-11-07,29139,11,0,2,247,29399
2020-11-08,27035,18,0,33,600,27686
2020-11-09,29985,22,0,8,345,30360
2020-11-10,27698,15,0,2,246,27961
2020-11-11,27947,8,0,58,393,28406
2020-11-12,28229,18,0,13,182,28442
2020-11-13,32056,20,0,15,387,32478
2020-11-14,30113,19,0,21,283,30436
2020-11-15,24745,14,0,34,406,25199
2020-11-16,29072,11,0,0,339,29422
2020-11-17,28358,12,0,0,178,28548
2020-11-18,29449,21,0,20,371,29861
2020-11-19,26732,21,0,13,191,26957
2020-11-20,29500,22,0,0,380,29902
2020-11-21,26623,15,0,1,226,26865
2020-11-22,22565,19,0,50,431,23065
2020-11-23,28349,17,0,2,321,28689
2020-11-24,25918,14,0,22,148,26102
2020-11-25,28727,15,0,63,314,29119
2020-11-26,25833,19,0,0,151,26003
2020-11-27,31271,20,0,15,373,31679
2020-11-28,26638,26,0,3,261,26928
2020-11-29,23695,26,0,31,426,24178
2020-11-30,31335,13,0,23,371,31742
2020-12-01,16234,43,0,0,161,16438
2020-12-02,14191,14,0,26,472,14703
2020-12-03,13299,26,0,31,174,13530
2020-12-04,14141,12,0,6,389,14548
2020-12-05,9014,11,10,0,198,9233
2020-12-06,7294,13,0,24,388,7719
2020-12-07,15058,11,0,0,299,15368
2020-12-08,13212,13,0,0,210,13435
2020-12-09,14539,13,0,20,339,14911
2020-12-10,13690,14,0,16,155,13875
2020-12-11,15306,11,0,6,346,15669
2020-12-12,10362,23,0,0,246,10631
2020-12-13,10338,20,0,34,406,10798
2020-12-14,14908,8,0,0,255,15171
2020-12-15,16497,11,0,6,189,16703
2020-12-16,16752,12,0,30,306,17100
2020-12-17,17709,22,0,42,211,17984
2020-12-18,20506,19,0,20,370,20915
2020-12-19,18714,15,0,6,306,19041
2020-12-20,12140,8,0,27,430,12605
2020-12-21,18627,10,0,6,238,18881
2020-12-22,17469,7,0,7,229,17712
2020-12-23,14645,9,0,11,489,15154
2020-12-24,10401,12,0,0,115,10528
2020-12-25,4352,7,0,0,70,4429
2020-12-26,5300,21,0,0,227,5548
2020-12-27,6562,15,0,28,569,7174
2020-12-28,10299,23,0,2,384,10708
2020-12-29,11136,21,0,0,202,11359
2020-12-30,13527,32,0,25,467,14051
2020-12-31,9206,21,0,4,124,9355
2021-01-01,6314,5,0,0,257,6576
2021-01-02,8864,14,0,0,580,9458
2021-01-03,12214,41,0,24,1115,13394
2021-01-04,14086,35,0,1,612,14734
2021-01-05,15139,28,0,0,314,15481
2021-01-06,12810,19,0,21,678,13528
2021-01-07,16684,5,0,4,397,17090
2021-01-08,17588,39,0,31,670,18328
2021-01-09,17040,24,0,0,452,17516
2021-01-10,16616,35,0,50,923,17624
2021-01-11,18644,25,0,6,560,19235
2021-01-12,14544,21,0,0,240,14805
2021-01-13,15220,13,0,57,413,15703
2021-01-14,15138,0,0,6,242,15386
2021-01-15,17948,18,0,7,551,18524
2021-01-16,12556,18,0,4,339,12917
2021-01-17,12130,10,0,0,524,12664
2021-01-18,17250,47,0,37,397,17731
2021-01-19,16656,30,0,8,175,16869
2021-01-20,16887,8,0,26,367,17288
2021-01-21,17427,8,0,0,195,17630
2021-01-22,18552,0,0,0,298,18850
2021-01-23,13292,15,0,0,222,13529
2021-01-24,11689,12,0,30,425,12156
2021-01-25,18391,9,0,0,308,18708
2021-01-26,17081,18,0,38,215,17352
2021-01-27,19123,13,0,36,379,19551
2021-01-28,19893,8,0,0,132,20033
2021-01-29,18907,9,0,42,374,19332
2021-01-30,13610,12,0,0,170,13792
2021-01-31,13176,14,0,43,337,13570
2021-02-01,19774,8,0,8,380,20170
2021-02-02,18552,16,0,0,116,18684
2021-02-03,17811,26,0,35,322,18194
2021-02-04,19678,14,0,8,155,19855
2021-02-05,20508,6,0,1,401,20916
2021-02-06,14845,10,0,6,156,15017
2021-02-07,14627,20,0,33,315,14995
2021-02-08,18893,16,0,0,381,19290
2021-02-09,19737,11,0,0,198,19946
2021-02-10,18982,11,0,25,233,19251
2021-02-11,19256,20,0,0,219,19495
2021-02-12,20866,19,0,0,372,21257
2021-02-13,14074,12,0,0,246,14332
2021-02-14,15073,6,0,31,390,15500
2021-02-15,21771,3,0,18,364,22156
2021-02-16,19081,15,0,10,152,19258
2021-02-17,19917,12,0,58,402,20389
2021-02-18,20482,18,0,16,229,20745
2021-02-19,22743,7,0,15,378,23143
2021-02-20,16677,17,0,0,226,16920
2021-02-21,17616,18,0,30,402,18066
2021-02-22,23089,4,0,0,405,23498
2021-02-23,20592,24,0,25,227,20868
2021-02-24,20847,7,0,28,311,21193
2021-02-25,21154,17,0,14,202,21387
2021-02-26,23185,11,0,0,376,23572
2021-02-27,16365,19,0,0,261,16645
2021-02-28,18667,13,0,38,490,19208
2021-03-01,23691,10,0,4,441,24146
2021-03-02,20788,11,0,1,194,20994
2021-03-03,21248,16,0,25,382,21671
2021-03-04,21887,6,0,20,263,22176
2021-03-05,22701,23,0,6,354,23084
2021-03-06,16461,14,0,7,231,16713
2021-03-07,17602,15,0,48,467,18132
2021-03-08,24111,6,0,0,383,24500
2021-03-09,19406,26,0,0,151,19583
2021-03-10,20445,10,0,71,430,20956
2021-03-11,20194,12,0,8,273,20487
2021-03-12,22205,7,0,0,347,22559
2021-03-13,13415,2,0,31,292,13740
2021-03-14,12035,14,0,26,417,12492
2021-03-15,22127,7,0,28,377,22539
2021-03-16,19820,1,0,6,198,20025
2021-03-17,19651,10,0,22,324,20007
2021-03-18,20645,8,0,17,228,20898
2021-03-19,21672,6,0,9,328,22015
2021-03-20,15185,10,0,0,294,15489
2021-03-21,16214,11,0,24,346,16595
2021-03-22,22042,13,0,0,382,22437
2021-03-23,19636,23,0,11,204,19874
2021-03-24,20583,17,0,34,369,21003
2021-03-25,20340,10,0,10,201,20561
2021-03-26,22917,14,0,8,350,23289
2021-03-27,19236,5,0,0,278,19519
2021-03-28,17153,11,0,32,452,17648
2021-03-29,22275,9,0,0,369,22653
2021-03-30,21170,7,0,10,249,21436
2021-03-31,23728,16,0,36,383,24163
2021-04-01,29393,14,0,19,581,30007
2021-04-02,26928,18,0,0,465,27411
2021-04-03,15159,6,0,1,366,15532
2021-04-04,12254,1,0,12,255,12522
2021-04-05,32998,33,0,0,873,33904
2021-04-06,30616,34,0,0,319,30969
2021-04-07,24197,29,0,54,622,24902
2021-04-08,24740,1,0,3,477,25221
2021-04-09,27453,22,0,2,551,28028
2021-04-10,26342,36,0,0,623,27001
2021-04-11,26528,57,0,29,1089,27703
2021-04-12,24664,19,0,0,690,25373
2021-04-13,21013,25,0,0,263,21301
2021-04-14,22123,25,0,67,518,22733
2021-04-15,22511,17,0,13,372,22913
2021-04-16,24687,22,0,3,537,25249
2021-04-17,19081,40,0,2,567,19690
2021-04-18,20387,17,0,39,679,21122
2021-04-19,24333,15,0,16,409,24773
2021-04-20,21708,27,0,7,254,21996
2021-04-21,21943,41,0,26,420,22430
2021-04-22,21730,3,0,2,311,22046
2021-04-23,25287,5,0,11,406,25709
2021-04-24,20174,9,0,14,357,20554
2021-04-25,23005,25,0,26,526,23582
2021-04-26,24482,18,0,0,344,24844
2021-04-27,19898,27,0,0,253,20178
2021-04-28,23292,16,0,26,430,23764
2021-04-29,24406,22,0,0,286,24714
2021-04-30,28692,28,0,4,454,29178
2021-05-01,17254,15,0,21,470,17760
2021-05-02,23648,21,0,35,517,24221
2021-05-03,28668,19,0,13,328,29028
2021-05-04,25017,28,0,3,231,25279
2021-05-05,25872,28,0,30,467,26397
2021-05-06,25219,25,0,12,329,25585
2021-05-07,29115,11,0,3,456,29585
2021-05-08,23404,30,0,0,518,23952
2021-05-09,26410,25,0,24,536,26995
2021-05-10,27760,19,0,0,445,28224
2021-05-11,25474,13,0,32,224,25743
2021-05-12,26140,44,0,51,410,26645
2021-05-13,30719,17,0,18,362,31116
2021-05-14,29897,29,0,35,500,30461
2021-05-15,25712,15,0,8,584,26319
2021-05-16,38409,39,0,46,726,39220
2021-05-17,29463,34,0,27,588,30112
2021-05-18,26099,69,0,58,280,26506
2021-05-19,26414,22,0,31,519,26986
2021-05-20,26619,25,0,54,412,27110
2021-05-21,33063,37,0,13,494,33607
2021-05-22,28548,22,0,0,574,29144
2021-05-23,26975,17,0,39,615,27646
2021-05-24,38737,53,0,7,555,39352
2021-05-25,29447,40,0,29,393,29909
2021-05-26,26743,30,0,52,515,27340
2021-05-27,28263,22,0,24,439,28748
2021-05-28,32856,17,0,19,514,33406
2021-05-29,28608,28,0,12,655,29303
2021-05-30,32570,36,0,47,681,33334
2021-05-31,31628,51,0,8,563,32250
2021-06-01,28514,41,0,2,449,29006
2021-06-02,38732,36,0,27,770,39565
2021-06-03,39217,12,12,25,670,39936
2021-06-04,35116,24,4,35,553,35732
2021-06-05,35516,35,13,148,748,36460
2021-06-06,50773,41,39,178,984,52015
2021-06-07,36980,18,0,13,642,37653
2021-06-08,32101,27,0,17,503,32648
2021-06-09,32053,37,0,37,661,32788
2021-06-10,33160,41,0,23,495,33719
2021-06-11,40215,37,0,9,713,40974
2021-06-12,34854,24,0,7,669,35554
2021-06-13,38974,48,0,31,1006,40059
2021-06-14,37128,30,0,7,553,37718
2021-06-15,33729,61,0,9,498,34297
2021-06-16,35796,31,0,90,878,36795
2021-06-17,36573,50,0,4,713,37340
2021-06-18,41556,35,0,2,851,42444
2021-06-19,44919,35,0,4,1009,45967
2021-06-20,52674,56,0,31,1310,54071
2021-06-21,43600,35,0,25,814,44474
2021-06-22,41511,47,0,33,747,42338
2021-06-23,39261,51,0,29,970,40311
2021-06-24,43268,43,0,29,783,44123
2021-06-25,44188,34,0,6,781,45009
2021-06-26,43045,40,0,10,1025,44120
2021-06-27,51899,47,0,42,1656,53644
2021-06-28,42971,29,0,7,1722,44729
2021-06-29,39083,58,0,28,686,39855
2021-06-30,43107,56,0,3,924,44090
2021-07-01,42418,33,0,52,1018,43521
2021-07-02,49908,50,0,15,999,50972
2021-07-03,49171,36,0,26,1003,50236
2021-07-04,53088,46,0,75,1412,54621
2021-07-05,43275,27,0,26,941,44269
2021-07-06,40149,38,0,57,899,41143
2021-07-07,39258,41,0,36,908,40243
2021-07-08,45397,30,0,30,945,46402
2021-07-09,54977,37,0,22,908,55944
2021-07-10,53930,40,0,12,993,54975
2021-07-11,52289,45,0,55,1520,53909
2021-07-12,48284,44,0,34,985,49347
2021-07-13,45733,14,0,46,910,46703
2021-07-14,49373,51,0,7,1000,50431
2021-07-15,50219,83,1,55,966,51324
2021-07-16,59264,72,0,30,1155,60521
2021-07-17,52680,28,0,3,1141,53852
2021-07-18,60208,64,0,59,1658,61989
2021-07-19,52388,47,6,63,1215,53719
2021-07-20,50550,61,0,58,1023,51692
2021-07-21,50146,45,0,38,1339,51568
2021-07-22,56572,64,3,47,1084,57770
2021-07-23,58028,64,0,31,1459,59582
2021-07-24,64044,74,0,18,1289,65425
2021-07-25,63957,59,0,77,1996,66089
2021-07-26,53944,47,0,32,1162,55185
2021-07-27,46695,40,0,47,1115,47897
2021-07-28,50755,56,3,14,1224,52052
2021-07-29,58511,54,0,44,1057,59666
2021-07-30,69957,48,0,16,1593,71614
2021-07-31,72911,98,0,47,1375,74431
2021-08-01,72107,57,0,80,2047,74291
2021-08-02,69983,76,0,54,1842,71955
2021-08-03,60174,88,0,68,1337,61667
2021-08-04,60241,52,0,2,1579,61874
2021-08-05,70032,60,0,32,1367,71491
2021-08-06,67238,38,0,44,1665,68985
2021-08-07,73323,75,0,48,1547,74993
2021-08-08,72857,85,0,66,1888,74896
2021-08-09,66549,64,0,47,1659,68319
2021-08-10,62205,26,5,42,1264,63542
2021-08-11,63897,70,0,47,1432,65446
2021-08-12,64625,68,0,35,1228,65956
2021-08-13,74495,82,8,27,1692,76304
2021-08-14,77861,97,10,38,1684,79690
2021-08-15,74004,96,0,38,2125,76263
2021-08-16,62633,49,8,27,1907,64624
2021-08-17,56138,75,10,32,1608,57863
2021-08-18,57903,68,4,14,1804,59793
2021-08-19,60272,44,10,58,1466,61850
2021-08-20,72038,74,11,10,1807,73940
2021-08-21,74786,58,0,41,1659,76544
2021-08-22,71311,91,0,54,2059,73515
2021-08-23,63964,65,0,27,1690,65746
2021-08-24,55279,54,0,36,1521,56890
2021-08-25,60477,102,5,12,1794,62390
2021-08-26,58610,53,0,67,1647,60377
2021-08-27,70158,74,0,33,2001,72266
2021-08-28,65776,90,0,24,1651,67541
2021-08-29,63433,98,0,79,2103,65713
2021-08-30,61804,47,0,42,1729,63622
2021-08-31,53567,72,0,61,1478,55178
2021-09-01,48547,56,0,0,2087,50690
2021-09-02,55540,85,0,72,1814,57511
2021-09-03,70315,52,0,54,2172,72593
2021-09-04,62699,50,0,20,1869,64638
2021-09-05,54550,70,0,62,2139,56821
2021-09-06,53190,62,0,34,1842,55128
2021-09-07,45512,66,0,60,1471,47109
2021-09-08,50991,36,0,6,1603,52636
2021-09-09,48079,57,0,56,1623,49815
2021-09-10,56357,76,0,20,2108,58561
2021-09-11,60384,65,0,25,1581,62055
2021-09-12,58589,69,0,55,1831,60544
2021-09-13,47755,53,0,82,1658,49548
2021-09-14,47080,62,0,60,1468,48670
2021-09-15,43617,54,0,45,1530,45246
2021-09-16,51400,53,0,112,1673,53238
2021-09-17,52769,88,0,29,1938,54824
2021-09-18,54246,52,0,36,1670,56004
2021-09-19,49280,64,0,63,1792,51199
2021-09-20,50825,55,0,19,1934,52833
2021-09-21,42326,56,0,69,1546,43997
2021-09-22,44609,60,0,16,1694,46379
2021-09-23,43812,42,0,77,1684,45615
2021-09-24,51583,41,0,14,2058,53696
2021-09-25,53978,75,0,5,1541,55599
2021-09-26,54101,65,0,41,1814,56021
2021-09-27,41165,47,0,7,1887,43106
2021-09-28,40644,35,0,112,1633,42424
2021-09-29,38732,74,0,10,1597,40413
2021-09-30,41810,52,2,39,1691,43594
2021-10-01,44421,60,1,71,2020,46573
2021-10-02,47146,27,0,21,1497,48691
2021-10-03,45743,58,0,92,1878,47771
2021-10-04,41868,63,0,17,1843,43791
2021-10-05,35986,58,0,0,1484,37528
2021-10-06,37362,26,1,29,1312,38730
2021-10-07,36862,22,0,0,1893,38777
2021-10-08,47957,50,0,61,2309,50377
2021-10-09,48730,40,0,16,1550,50336
2021-10-10,42509,16,0,51,1888,44464
2021-10-11,40457,15,0,21,1908,42401
2021-10-12,40590,51,16,15,1481,42153
2021-10-13,38215,8,0,77,1513,39813
2021-10-14,37474,25,0,0,1758,39257
2021-10-15,47195,65,0,0,2234,49494
2021-10-16,49492,44,0,6,1773,51315
2021-10-17,44434,23,0,35,1891,46383
2021-10-18,39893,42,0,27,1950,41912
2021-10-19,38647,44,0,0,1578,40269
2021-10-20,38717,46,0,74,1298,40135
2021-10-21,39598,36,0,26,1754,41414
2021-10-22,43265,51,1,23,1955,45295
2021-10-23,47833,49,0,4,1750,49636
2021-10-24,43334,33,1,100,2041,45509
2021-10-25,41009,31,0,56,1913,43009
2021-10-26,39001,12,0,36,1492,40541
2021-10-27,40615,25,0,61,1465,42166
2021-10-28,45492,30,0,36,1417,46975
2021-10-29,58344,53,0,5,2331,60733
2021-10-30,67919,33,0,10,2281,70243
2021-10-31,53801,44,0,29,1351,55225
2021-11-01,56140,54,0,8,1419,57621
2021-11-02,48755,42,0,10,1382,50189
2021-11-03,39840,27,0,33,1325,41225
2021-11-04,37667,54,0,32,1400,39153
2021-11-05,41667,50,0,1,1241,42959
2021-11-06,40702,44,0,6,1096,41848
2021-11-07,36457,34,0,68,1467,38026
2021-11-08,35572,56,0,2,1606,37236
2021-11-09,33246,54,0,0,1007,34307
2021-11-10,34900,55,0,64,1084,36103
2021-11-11,35090,21,0,38,1156,36305
2021-11-12,39782,46,0,0,1335,41163
2021-11-13,41230,80,0,0,1207,42517
2021-11-14,37461,59,0,7,1594,39121
2021-11-15,35524,30,0,11,1776,37341
2021-11-16,32270,41,0,0,1194,33505
2021-11-17,41328,62,0,38,1691,43119
2021-11-18,45507,61,0,45,2004,47617
2021-11-19,37865,32,0,17,1360,39274
2021-11-20,37564,38,0,7,1234,38843
2021-11-21,39254,37,0,39,1339,40669
2021-11-22,34628,20,0,1,1424,36073
2021-11-23,31666,13,0,28,836,32543
2021-11-24,34308,30,0,45,906,35289
2021-11-25,36464,24,0,29,1005,37522
2021-11-26,37858,40,0,1,1125,39024
2021-11-27,33649,43,0,0,977,34669
2021-11-28,32764,49,0,33,1185,34031
2021-11-29,35141,44,0,2,1269,36456
2021-11-30,32721,39,0,3,950,33713
2021-12-01,31941,44,0,28,1094,33107
2021-12-02,34081,47,0,10,1095,35233
2021-12-03,40597,52,0,6,1346,42001
2021-12-04,38117,46,0,3,1153,39319
2021-12-05,29465,16,0,85,1194,30760
2021-12-06,34242,30,0,0,1278,35550
2021-12-07,34107,33,0,20,999,35159
2021-12-08,35815,38,0,33,1052,36938
2021-12-09,32248,41,0,35,1236,33560
2021-12-10,39476,43,0,10,1347,40876
2021-12-11,40589,92,0,0,1251,41932
2021-12-12,33540,79,0,48,1210,34877
2021-12-13,36362,60,0,2,1141,37565
2021-12-14,35275,38,0,0,750,36063
2021-12-15,38756,106,0,30,836,39728
2021-12-16,38692,57,0,61,1012,39822
2021-12-17,45320,42,0,10,964,46336
2021-12-18,53018,69,0,0,1130,54217
2021-12-19,44328,82,0,45,987,45442
2021-12-20,42021,56,0,6,1133,43216
2021-12-21,41509,46,0,5,1015,42575
2021-12-22,49407,106,0,28,1236,50777
2021-12-23,60441,74,0,35,1535,62085
2021-12-24,46089,52,0,2,1025,47168
2021-12-25,24072,24,0,0,215,24311
2021-12-26,43605,109,0,20,1623,45357
2021-12-27,49111,121,0,0,2409,51641
2021-12-28,46795,74,0,31,2010,48910
2021-12-29,45249,95,0,24,2411,47779
2021-12-30,54134,60,0,34,2211,56439
2021-12-31,41424,77,0,0,1267,42768
2022-01-01,28270,55,0,0,1108,29433
2022-01-02,62591,136,0,38,2196,64961
2022-01-03,46021,63,0,18,2645,48747
2022-01-04,44411,79,0,2,2165,46657
2022-01-05,46979,58,0,13,1875,48925
2022-01-06,44989,109,0,0,2018,47116
2022-01-07,43402,85,0,30,1885,45402
2022-01-08,49471,116,0,0,1803,51390
2022-01-09,52319,98,0,50,2660,55127
2022-01-10,40573,42,0,0,1635,42250
2022-01-11,32118,22,0,0,761,32901
2022-01-12,33382,35,0,24,713,34154
2022-01-13,35752,40,0,54,942,36788
2022-01-14,38057,30,0,0,1107,39194
2022-01-15,40215,39,0,1,1072,41327
2022-01-16,37346,50,0,37,1398,38831
2022-01-17,35245,36,0,0,1169,36450
2022-01-18,32833,35,0,0,544,33412
2022-01-19,32027,32,0,30,711,32800
2022-01-20,33665,28,0,19,872,34584
2022-01-21,37575,67,0,4,952,38598
2022-01-22,40505,24,0,0,990,41519
2022-01-23,31743,52,0,29,1112,32936
2022-01-24,32960,27,0,8,1014,34009
2022-01-25,30902,55,0,52,557,31566
2022-01-26,31569,20,0,21,586,32196
2022-01-27,33032,33,0,43,895,34003
2022-01-28,37844,30,0,2,961,38837
2022-01-29,38418,39,0,4,850,39311
2022-01-30,33620,41,0,33,1178,34872
2022-01-31,32899,33,0,0,1023,33955
2022-02-01,32818,29,0,0,884,33731
2022-02-02,33546,58,0,20,624,34248
2022-02-03,36927,48,0,0,883,37858
2022-02-04,39821,34,0,6,1247,41108
2022-02-05,43685,62,0,7,954,44708
2022-02-06,37038,49,0,41,1206,38334
2022-02-07,36245,35,0,0,1271,37551
2022-02-08,30530,59,0,32,813,31434
2022-02-09,37304,54,0,35,686,38079
2022-02-10,36924,48,0,7,1069,38048
2022-02-11,42360,61,0,0,1449,43870
2022-02-12,47946,68,0,0,1213,49227
2022-02-13,40446,105,0,40,1420,42011
2022-02-14,38935,51,0,6,1266,40258
2022-02-15,36477,60,0,0,1168,37705
2022-02-16,36344,36,0,37,1028,37445
2022-02-17,40309,46,0,12,1303,41670
2022-02-18,46368,99,0,3,1985,48455
2022-02-19,54941,66,0,2,1995,57004
2022-02-20,44986,55,0,52,1696,46789
2022-02-21,44516,44,0,16,1873,46449
2022-02-22,39455,42,0,27,1409,40933
2022-02-23,44322,26,0,34,959,45341
2022-02-24,43817,26,0,5,1415,45263
2022-02-25,49990,64,0,6,1680,51740
2022-02-26,47481,61,0,0,1210,48752
2022-02-27,42171,43,0,46,1494,43754
2022-02-28,39321,25,0,0,1816,41162
2022-03-01,39365,26,0,0,1347,40738
2022-03-02,34989,47,0,49,1081,36166
2022-03-03,38734,16,2,7,1368,40127
2022-03-04,44916,19,0,1,1883,46819
2022-03-05,49736,65,0,0,1579,51380
2022-03-06,38780,85,0,36,1821,40722
2022-03-07,41514,34,10,0,1930,43488
2022-03-08,34962,24,0,27,1214,36227
2022-03-09,34549,36,0,39,1078,35702
2022-03-10,38627,36,0,13,1392,40068
2022-03-11,44452,39,0,0,1825,46316
2022-03-12,45648,25,0,0,1354,47027
2022-03-13,42920,72,0,77,1764,44833
2022-03-14,39018,42,0,3,1835,40898
2022-03-15,37710,34,0,5,1160,38909
2022-03-16,35395,25,0,31,1250,36701
2022-03-17,38682,34,0,8,1456,40180
2022-03-18,42462,46,0,2,1990,44500
2022-03-19,50136,7,0,0,1349,51492
2022-03-20,43182,35,0,49,1752,45018
2022-03-21,38041,35,0,2,1717,39795
2022-03-22,33903,35,0,36,1485,35459
2022-03-23,36275,19,0,58,1314,37666
2022-03-24,37302,37,0,5,1606,38950
2022-03-25,45939,52,0,7,1952,47950
2022-03-26,46911,77,0,0,1518,48506
2022-03-27,46519,30,0,46,2482,49077
2022-03-28,36078,32,0,0,2115,38225
2022-03-29,34516,30,0,4,1588,36138
2022-03-30,36276,42,0,36,1700,38054
2022-03-31,38165,23,0,0,1937,40125
2022-04-01,41118,52,0,2,2349,43521
2022-04-02,45790,39,0,1,1959,47789
2022-04-03,39187,68,0,58,2182,41495
2022-04-04,39592,25,0,3,2030,41650
2022-04-05,34315,32,0,35,1604,35986
2022-04-06,37609,27,0,43,1509,39188
2022-04-07,40272,35,0,12,1820,42139
2022-04-08,44945,24,0,3,1875,46847
2022-04-09,54841,39,1,0,1935,56816
2022-04-10,44847,37,0,37,1863,46784
2022-04-11,44187,30,0,6,1847,46070
2022-04-12,43706,21,0,3,1894,45624
2022-04-13,48844,49,1,62,2381,51337
2022-04-14,64971,75,0,32,3602,68680
2022-04-15,64398,47,0,5,3878,68328
2022-04-16,55802,12,1,28,2587,58430
2022-04-17,40436,101,0,81,2192,42810
2022-04-18,86747,119,0,135,3746,90747
2022-04-19,58894,91,1,28,3653,62667
2022-04-20,53280,38,1,80,3379,56778
2022-04-21,50770,80,0,12,3639,54501
2022-04-22,55772,52,0,2,2959,58785
2022-04-23,59187,32,1,5,2552,61777
2022-04-24,53783,12,0,45,3305,57145
2022-04-25,48793,61,0,1,3051,51906
2022-04-26,43491,18,0,32,2656,46197
2022-04-27,40550,51,0,65,2157,42823
2022-04-28,45550,20,0,7,2478,48055
2022-04-29,53329,49,0,12,2538,55928
2022-04-30,61173,47,0,65,2242,63527
2022-05-01,49100,63,0,85,2434,51682
2022-05-02,49762,39,0,13,2440,52254
2022-05-03,43287,39,0,36,2164,45526
2022-05-04,41714,45,0,63,1951,43773
2022-05-05,46095,56,1,5,2507,48664
2022-05-06,55037,28,0,2,2444,57511
2022-05-07,57224,40,0,20,2223,59507
2022-05-08,52501,26,0,45,2724,55296
2022-05-09,45251,36,0,8,2895,48190
2022-05-10,44235,11,0,5,2568,46819
2022-05-11,45086,38,0,60,2195,47379
2022-05-12,47002,82,0,18,2427,49529
2022-05-13,50982,79,0,14,2563,53638
2022-05-14,61027,97,1,35,2271,63431
2022-05-15,58396,78,0,70,2700,61244
2022-05-16,48315,52,0,20,2690,51077
2022-05-17,43091,61,0,112,2391,45655
2022-05-18,43753,58,0,6,2077,45894
2022-05-19,45931,54,0,183,2388,48556
2022-05-20,52956,118,0,64,2490,55628
2022-05-21,59122,123,0,86,2131,61462
2022-05-22,58303,70,0,53,2511,60937
2022-05-23,48509,63,0,15,2586,51173
2022-05-24,44289,40,0,36,1955,46320
2022-05-25,46057,56,0,147,2081,48341
2022-05-26,58090,26,0,74,2727,60917
2022-05-27,58372,36,1,33,3449,61891
2022-05-28,59957,35,0,31,2393,62416
2022-05-29,61019,62,0,68,2174,63323
2022-05-30,59567,37,9,100,2275,61988
2022-05-31,41769,50,0,89,2536,44444
2022-06-01,45050,40,0,13,2404,47507
2022-06-02,46988,12,0,57,2353,49410
2022-06-03,52049,25,0,12,2362,54448
2022-06-04,60222,42,0,35,1885,62184
2022-06-05,63764,56,1,73,2152,66046
2022-06-06,69599,50,0,36,2707,72392
2022-06-07,54544,11,0,50,2586,57191
2022-06-08,44877,57,0,32,2215,47181
2022-06-09,50278,35,0,31,2280,52624
2022-06-10,55203,33,0,21,2773,58030
2022-06-11,61727,17,1,47,2083,63875
2022-06-12,60847,71,0,72,2572,63562
2022-06-13,55862,46,1,50,2748,58707
2022-06-14,45766,87,0,96,2568,48517
2022-06-15,55945,38,0,31,3102,59116
2022-06-16,77085,53,0,151,3842,81131
2022-06-17,63008,15,1,41,2728,65793
2022-06-18,61593,23,0,47,2330,63993
2022-06-19,73785,16,0,91,2735,76627
2022-06-20,51363,49,0,54,2790,54256
2022-06-21,52361,35,0,219,2476,55091
2022-06-22,64575,57,1,48,3495,68176
2022-06-23,53536,20,0,60,2941,56557
2022-06-24,58653,58,0,61,2617,61389
2022-06-25,62970,45,1,8,1812,64836
2022-06-26,73863,45,0,124,2649,76681
2022-06-27,58624,35,0,41,2746,61446
2022-06-28,45992,51,0,146,2496,48685
2022-06-29,49867,32,1,18,2071,51989
2022-06-30,49638,33,0,74,2181,51926
2022-07-01,57989,28,0,30,2334,60381
2022-07-02,60642,124,1,57,1950,62774
2022-07-03,66365,76,0,64,2578,69083
2022-07-04,57593,37,0,34,2654,60318
2022-07-05,48279,42,0,63,1663,50047
2022-07-06,63471,91,0,31,2012,65605
2022-07-07,53623,52,0,34,1602,55311
2022-07-08,71430,99,1,92,2215,73837
2022-07-09,67846,70,1,60,1755,69732
2022-07-10,62236,139,0,89,2271,64735
2022-07-11,56939,80,0,54,2081,59154
2022-07-12,63206,92,0,111,1965,65374
2022-07-13,56780,83,1,50,1650,58564
2022-07-14,62046,70,0,53,2167,64336
2022-07-15,69839,129,1,79,2179,72227
2022-07-16,72698,122,0,65,1954,74839
2022-07-17,66858,74,0,65,2185,69182
2022-07-18,55171,99,0,75,2385,57730
2022-07-19,53142,53,0,89,2287,55571
2022-07-20,63802,36,0,108,2177,66123
2022-07-21,55196,22,0,63,1909,57190
2022-07-22,60642,122,0,51,2592,63407
2022-07-23,79734,259,13,78,1820,81904
2022-07-24,65320,70,0,146,2244,67780
2022-07-25,60445,23,0,51,2291,62810
2022-07-26,57299,42,0,105,2286,59732
2022-07-27,57969,62,0,78,1791,59900
2022-07-28,60921,51,0,88,2036,63096
2022-07-29,77658,57,0,71,2254,80040
2022-07-30,79167,197,1,86,2004,81455
2022-07-31,82674,121,0,111,2384,85290
2022-08-01,69146,39,0,109,2677,71971
2022-08-02,69422,21,0,79,2509,72031
2022-08-03,64233,126,0,81,2457,66897
2022-08-04,69786,132,0,98,2580,72596
2022-08-05,85771,129,0,116,2862,88878
2022-08-06,79290,99,0,113,2184,81686
2022-08-07,75881,156,0,65,2600,78702
2022-08-08,69926,120,0,81,2631,72758
2022-08-09,63629,126,0,68,2530,66353
2022-08-10,72320,63,1,13,1956,74353
2022-08-11,68558,86,0,58,2095,70797
2022-08-12,84564,153,0,46,2648,87411
2022-08-13,81648,117,0,159,2411,84335
2022-08-14,82313,129,0,83,2558,85083
2022-08-15,75726,184,0,61,2489,78460
2022-08-16,65748,95,0,117,2696,68656
2022-08-17,64242,136,1,68,2749,67196
2022-08-18,64681,77,0,60,2396,67214
2022-08-19,68111,226,0,57,2433,70827
2022-08-20,80920,167,0,77,2286,83450
2022-08-21,73716,139,0,93,2815,76763
2022-08-22,72363,94,0,78,2844,75379
2022-08-23,52867,126,0,118,2784,55895
2022-08-24,55954,106,0,74,2498,58632
2022-08-25,62936,36,0,178,2899,66049
2022-08-26,74977,98,0,95,2330,77500
2022-08-27,69465,102,39,135,2355,72096
2022-08-28,74610,106,0,63,2697,77476
2022-08-29,58655,104,0,72,2632,61463
2022-08-30,58780,57,0,164,2233,61234
2022-08-31,41349,75,0,88,3178,44690
2022-09-01,57219,154,0,190,3163,60726
2022-09-02,59161,80,0,104,2808,62153
2022-09-03,73708,189,0,90,2627,76614
2022-09-04,56996,97,0,155,3007,60255
2022-09-05,51376,66,0,15,2890,54347
2022-09-06,46821,120,0,98,2649,49688
2022-09-07,51007,125,0,24,2617,53773
2022-09-08,52840,64,1,187,2698,55790
2022-09-09,55421,70,0,39,2732,58262
2022-09-10,60422,87,0,81,2094,62684
2022-09-11,64879,118,0,266,2671,67934
2022-09-12,49625,90,0,19,2876,52610
2022-09-13,42958,134,0,153,2879,46124
2022-09-14,41724,53,0,60,2887,44724
2022-09-15,54819,205,0,198,2840,58062
2022-09-16,51266,77,0,18,2544,53905
2022-09-17,62151,88,0,23,2068,64330
2022-09-18,53084,162,0,145,2682,56073
2022-09-19,51449,162,0,10,3159,54780
2022-09-20,43942,105,0,478,3062,47587
2022-09-21,46046,34,0,21,2960,49061
2022-09-22,45889,103,0,219,3359,49570
2022-09-23,57144,76,0,27,3475,60722
2022-09-24,64299,89,0,43,2262,66693
2022-09-25,59337,554,0,126,2843,62860
2022-09-26,47076,124,0,63,3064,50327
2022-09-27,42425,65,0,69,2700,45259
2022-09-28,42396,64,0,87,2518,45065
2022-09-29,45209,106,0,118,2873,48306
2022-09-30,55554,151,15,80,2888,58688
2022-10-01,59140,64,0,41,2448,61693
2022-10-02,52556,93,0,225,2917,55791
2022-10-03,49605,94,0,64,2954,52717
2022-10-04,40390,197,0,208,3012,43807
2022-10-05,42026,199,0,4,2954,45183
2022-10-06,42436,82,0,67,3060,45645
2022-10-07,54852,119,1,139,3196,58307
2022-10-08,62264,46,0,57,2722,65089
2022-10-09,54964,55,0,55,3089,58163
2022-10-10,40600,96,0,38,3147,43881
2022-10-11,39650,25,0,91,2710,42476
2022-10-12,40050,85,0,31,2547,42713
2022-10-13,42443,123,0,57,2930,45553
2022-10-14,49175,97,0,7,3363,52642
2022-10-15,62857,94,0,40,2868,65859
2022-10-16,52649,104,0,106,2964,55823
2022-10-17,43562,108,1,15,2986,46672
2022-10-18,41395,117,0,74,2728,44314
2022-10-19,42665,61,14,13,3078,45831
2022-10-20,41349,75,0,88,3178,44690
2022-10-21,50261,87,0,96,2999,53443
2022-10-22,56524,102,0,49,3082,59757
2022-10-23,51806,123,0,89,2957,54975
2022-10-24,42938,95,0,42,3260,46335
2022-10-25,39401,71,0,29,2820,42321
2022-10-26,42840,71,0,18,2604,45533
2022-10-27,47158,146,0,207,2517,50028
2022-10-28,62467,143,0,43,3084,65737
2022-10-29,80028,83,1,53,3102,83267
2022-10-30,63002,105,0,45,1747,64899
2022-10-31,59491,58,0,5,1954,61508
2022-11-01,60806,86,0,28,2190,63110
2022-11-02,51624,53,0,51,1989,53717
2022-11-03,42630,87,0,33,1750,44500
2022-11-04,45905,81,0,5,2158,48149
